year,vcnaics4,firms,estabs,emp,denom,estabs_entry,estabs_entry_rate,estabs_exit,estabs_exit_rate,job_creation,job_creation_births,job_creation_continuers,job_creation_rate_births,job_creation_rate,job_destruction,job_destruction_deaths,job_destruction_continuers,job_destruction_rate_deaths,job_destruction_rate,net_job_creation,net_job_creation_rate,reallocation_rate,firmdeath_firms,firmdeath_estabs,firmdeath_emp
1978,1131,193,200,3067,2948,42,21.483,33,16.880,1040,401,639,13.605,35.284,785,474,311,16.081,26.633,255,8.651,53.265,22,22,37
1978,1132,84,100,1745,1762,12,11.707,17,16.585,537,103,434,5.847,30.485,588,42,546,2.384,33.381,-51,-2.895,60.971,10,10,25
1978,1133,12079,12196,98382,93837,2382,19.806,2043,16.987,27106,9682,17424,10.318,28.886,17968,7320,10648,7.801,19.148,9138,9.738,38.296,1521,1524,5347
1978,1141,1504,1540,10486,9559,383,25.008,366,23.898,4434,1803,2631,18.862,46.386,2597,1253,1344,13.108,27.168,1837,19.217,54.336,272,272,799
1978,1142,147,147,694,650,34,23.368,31,21.306,304,130,174,20.015,46.805,213,71,142,10.931,32.794,91,14.011,65.589,25,25,64
1978,1151,4165,4602,53995,53660,696,14.853,864,18.438,18215,6296,11919,11.733,33.946,17836,6960,10876,12.971,33.239,379,0.706,66.478,562,584,4520
1978,1152,1585,1607,9681,9400,313,19.873,249,15.810,2597,1031,1566,10.968,27.628,2061,871,1190,9.266,21.926,536,5.702,43.851,203,203,646
1978,1153,613,627,7745,6984,149,24.833,95,15.833,3124,1124,2000,16.095,44.734,1649,677,972,9.694,23.613,1475,21.121,47.226,75,75,609
1978,2111,5258,7004,120136,117269,905,12.990,831,11.928,29725,9942,19783,8.478,25.348,23873,11834,12039,10.091,20.357,5852,4.990,40.715,391,402,1637
1978,2121,3317,4073,188312,204182,906,22.937,660,16.709,35064,13858,21206,6.787,17.173,66479,13930,52549,6.822,32.559,-31415,-15.386,34.346,435,440,5718
1978,2122,475,654,77624,82128,142,22.016,124,19.225,12060,3793,8267,4.618,14.684,20780,10124,10656,12.327,25.302,-8720,-10.618,29.369,61,62,2691
1978,2123,3666,5161,106759,105252,424,8.144,515,9.891,18545,5248,13297,4.986,17.620,15558,5520,10038,5.245,14.782,2987,2.838,29.563,241,246,1656
1978,2131,6708,7817,215802,201418,1571,20.764,1069,14.129,69769,24668,45101,12.247,34.639,41628,18588,23040,9.229,20.667,28141,13.971,41.335,621,633,5010
1978,2211,1463,5477,490178,476670,321,5.935,185,3.420,61271,16067,45204,3.371,12.854,34398,6355,28043,1.333,7.216,26873,5.638,14.433,14,14,204
1978,2212,488,2255,134661,133921,154,6.883,119,5.318,13461,2181,11280,1.629,10.051,12105,3735,8370,2.789,9.039,1356,1.013,18.078,24,24,110
1978,2213,3817,4127,33677,32899,453,11.235,263,6.523,6229,1467,4762,4.459,18.934,4663,2361,2302,7.177,14.174,1566,4.760,28.348,177,179,1506
1978,2361,103411,103759,601828,541726,28783,29.489,16477,16.881,253239,113446,139793,20.942,46.747,133078,63617,69461,11.743,24.566,120161,22.181,49.131,12812,12818,48092
1978,2362,31372,31925,574094,541269,6025,19.604,3642,11.850,172091,39652,132439,7.326,31.794,106982,25908,81074,4.787,19.765,65109,12.029,39.530,2734,2736,16288
1978,2371,12953,13251,311443,292760,1843,14.162,1368,10.512,94886,18751,76135,6.405,32.411,56238,15976,40262,5.457,19.210,38648,13.201,38.419,1027,1030,9119
1978,2372,7341,7485,64792,60011,2024,28.241,1388,19.367,26572,11567,15005,19.275,44.279,16877,8359,8518,13.929,28.123,9695,16.155,56.246,1013,1018,4548
1978,2373,10568,10876,219594,213822,1241,11.483,1103,10.206,55897,10135,45762,4.740,26.142,44138,9563,34575,4.472,20.642,11759,5.499,41.285,812,814,5627
1978,2379,4272,4340,106805,104877,889,20.876,726,17.048,30999,8396,22603,8.006,29.557,27618,6344,21274,6.049,26.334,3381,3.224,52.667,522,522,2506
1978,2381,65840,66250,531078,488404,13697,21.566,8222,12.945,188074,59571,128503,12.197,38.508,102883,37309,65574,7.639,21.065,85191,17.443,42.130,6342,6342,28383
1978,2382,91212,92902,879807,834661,14975,16.609,9498,10.534,232753,59985,172768,7.187,27.886,142057,47846,94211,5.732,17.020,90696,10.866,34.039,7563,7566,32101
1978,2383,68651,69027,485277,447178,15609,23.545,10142,15.299,175688,61354,114334,13.720,39.288,99333,39924,59409,8.928,22.213,76355,17.075,44.427,7835,7837,29978
1978,2389,31984,32171,321209,297928,6752,21.867,4164,13.486,106371,38865,67506,13.045,35.704,59267,18624,40643,6.251,19.893,47104,15.811,39.786,3188,3189,13393
1978,3111,1509,2183,59325,58841,140,6.369,170,7.734,7643,1807,5836,3.071,12.989,6664,2462,4202,4.184,11.326,979,1.664,22.651,86,91,805
1978,3112,557,905,80587,79980,44,4.833,55,6.041,5789,1047,4742,1.309,7.238,4536,1383,3153,1.729,5.671,1253,1.567,11.343,32,32,582
1978,3113,1234,1641,95625,96763,199,12.149,193,11.783,10782,1698,9084,1.755,11.143,13372,4594,8778,4.748,13.819,-2590,-2.677,22.285,114,115,731
1978,3114,1361,1885,191118,188987,104,5.452,149,7.811,24034,3848,20186,2.036,12.717,19924,7218,12706,3.819,10.543,4110,2.175,21.085,81,81,2504
1978,3115,2473,3301,156232,156631,132,3.927,253,7.526,15165,2355,12810,1.504,9.682,16097,5856,10241,3.739,10.277,-932,-0.595,19.364,173,178,3055
1978,3116,4801,5452,333158,328970,372,6.695,580,10.439,40589,9650,30939,2.933,12.338,32292,12142,20150,3.691,9.816,8297,2.522,19.632,389,398,5719
1978,3117,658,790,45184,42582,55,6.918,65,8.176,11146,1597,9549,3.750,26.176,6058,2422,3636,5.688,14.227,5088,11.949,28.454,41,41,836
1978,3118,8115,9700,309068,303267,1188,12.317,1078,11.177,43525,12531,30994,4.132,14.352,31635,13436,18199,4.430,10.431,11890,3.921,20.863,741,757,6965
1978,3119,2132,2521,117220,113693,218,8.635,225,8.913,19109,5816,13293,5.116,16.808,11970,4487,7483,3.947,10.528,7139,6.279,21.057,156,157,2482
1978,3121,2365,2996,184342,181938,165,5.460,217,7.181,22627,3808,18819,2.093,12.437,17603,7142,10461,3.926,9.675,5024,2.761,19.351,133,134,2284
1978,3122,148,217,47770,48377,13,5.752,31,13.717,2964,278,2686,0.575,6.127,4010,1200,2810,2.481,8.289,-1046,-2.162,12.254,12,12,119
1978,3131,505,755,128427,129078,53,7.048,47,6.250,9584,1215,8369,0.941,7.425,10881,4192,6689,3.248,8.430,-1297,-1.005,14.850,29,30,657
1978,3132,1803,2272,367704,374030,158,6.870,214,9.304,22561,3345,19216,0.894,6.032,34731,14092,20639,3.768,9.286,-12170,-3.254,12.064,147,147,4809
1978,3133,3223,3627,157078,155779,323,9.102,166,4.678,18507,4147,14360,2.662,11.880,15782,5098,10684,3.273,10.131,2725,1.749,20.262,95,95,2003
1978,3141,4629,4909,138281,130905,674,13.969,506,10.487,27484,8489,18995,6.485,20.995,12854,4878,7976,3.726,9.819,14630,11.176,19.639,401,401,2364
1978,3149,3298,3430,133422,130586,412,12.193,310,9.174,23371,5365,18006,4.108,17.897,17434,6311,11123,4.833,13.351,5937,4.546,26.701,234,234,3595
1978,3151,1430,1559,143192,141296,143,9.146,152,9.722,20102,4249,15853,3.007,14.227,16427,6562,9865,4.644,11.626,3675,2.601,23.252,111,113,2826
1978,3152,13755,15735,1029580,1020127,2153,13.730,2045,13.041,163168,55819,107349,5.472,15.995,144630,64894,79736,6.361,14.178,18538,1.817,28.355,1536,1548,37212
1978,3159,1582,1686,65070,62865,169,10.093,146,8.719,10502,3176,7326,5.052,16.706,6074,1753,4321,2.789,9.662,4428,7.044,19.324,126,126,1305
1978,3161,428,473,23221,22968,42,8.955,34,7.249,2964,646,2318,2.813,12.905,2472,983,1489,4.280,10.763,492,2.142,21.526,20,20,84
1978,3162,550,827,158275,159989,54,6.514,58,6.996,15456,2907,12549,1.817,9.661,19126,5106,14020,3.191,11.955,-3670,-2.294,19.321,29,32,1055
1978,3169,1423,1491,69209,67387,160,10.667,178,11.867,13347,4497,8850,6.673,19.807,9941,4326,5615,6.420,14.752,3406,5.054,29.504,143,143,2363
1978,3211,5597,6183,164426,160523,709,11.459,718,11.604,26533,8350,18183,5.202,16.529,18691,6813,11878,4.244,11.644,7842,4.885,23.288,527,528,4377
1978,3212,1034,1303,98105,95266,200,15.943,103,8.210,12637,3102,9535,3.256,13.265,6962,3224,3738,3.384,7.308,5675,5.957,14.616,59,61,1357
1978,3219,8334,9140,312765,296619,1133,12.549,910,10.079,63998,13947,50051,4.702,21.576,31894,13266,18628,4.472,10.753,32104,10.823,21.505,657,661,6569
1978,3221,360,745,212187,211715,66,9.103,26,3.586,10248,3315,6933,1.566,4.840,9325,2463,6862,1.163,4.405,923,0.436,8.809,6,6,434
1978,3222,3471,5043,408323,402439,425,8.591,233,4.710,41149,9183,31966,2.282,10.225,28904,10416,18488,2.588,7.182,12245,3.043,14.364,133,134,2622
1978,3231,29487,30810,602461,584991,3604,11.891,2600,8.579,87846,19544,68302,3.341,15.017,53062,23247,29815,3.974,9.071,34784,5.946,18.141,1947,1954,11640
1978,3241,1261,2057,148540,147206,176,8.598,156,7.621,12876,2693,10183,1.829,8.747,10147,2608,7539,1.772,6.893,2729,1.854,13.786,62,63,880
1978,3251,1006,2099,271466,268231,150,7.174,134,6.408,21054,2708,18346,1.010,7.849,14421,4449,9972,1.659,5.376,6633,2.473,10.753,48,48,1359
1978,3252,425,669,167443,166160,54,8.194,34,5.159,12015,2348,9667,1.413,7.231,9554,4521,5033,2.721,5.750,2461,1.481,11.500,12,12,272
1978,3253,772,1177,56162,55918,100,8.475,106,8.983,6297,1518,4779,2.715,11.261,5837,1670,4167,2.987,10.438,460,0.823,20.877,45,45,385
1978,3254,912,1130,152001,150366,82,7.199,100,8.780,11764,1329,10435,0.884,7.824,8388,2642,5746,1.757,5.578,3376,2.245,11.157,61,61,1166
1978,3255,1615,2073,79218,78228,135,6.509,137,6.606,8737,1698,7039,2.171,11.169,6718,2137,4581,2.732,8.588,2019,2.581,17.175,84,85,679
1978,3256,2055,2310,115546,113063,194,8.396,195,8.440,14666,2185,12481,1.933,12.972,9718,3226,6492,2.853,8.595,4948,4.376,17.190,130,132,898
1978,3259,1728,2208,99974,98701,212,9.654,188,8.561,11265,2606,8659,2.640,11.413,8596,2058,6538,2.085,8.709,2669,2.704,17.418,126,126,1055
1978,3261,8176,9525,486728,463564,1162,12.444,787,8.428,87791,18036,69755,3.891,18.938,41262,15538,25724,3.352,8.901,46529,10.037,17.802,551,554,7535
1978,3262,1737,2110,234941,233388,182,8.683,154,7.347,18613,3235,15378,1.386,7.975,15909,3308,12601,1.417,6.817,2704,1.159,13.633,101,101,1075
1978,3271,1335,1647,99392,97363,181,11.037,167,10.183,12539,1781,10758,1.829,12.879,8443,2904,5539,2.983,8.672,4096,4.207,17.343,116,116,1175
1978,3272,1309,1599,185511,180313,200,12.747,140,8.923,18096,2207,15889,1.224,10.036,7827,1347,6480,0.747,4.341,10269,5.695,8.682,98,99,784
1978,3273,7647,9491,190871,184798,754,7.956,727,7.671,35538,7767,27771,4.203,19.231,23455,7181,16274,3.886,12.692,12083,6.539,25.385,483,494,3357
1978,3274,291,387,17345,16696,59,15.608,41,10.847,2123,598,1525,3.582,12.716,790,436,354,2.611,4.732,1333,7.984,9.464,27,27,62
1978,3279,2189,2526,98132,95465,271,10.870,205,8.223,13229,2456,10773,2.573,13.858,7937,2264,5673,2.372,8.314,5292,5.543,16.628,143,143,986
1978,3311,437,531,418840,421969,65,12.346,56,10.636,21281,4400,16881,1.043,5.043,28003,2698,25305,0.639,6.636,-6722,-1.593,10.087,36,36,237
1978,3312,490,659,94557,92306,43,6.626,23,3.544,8888,747,8141,0.809,9.629,4283,704,3579,0.763,4.640,4605,4.989,9.280,13,13,250
1978,3313,273,434,110311,106779,25,5.780,22,5.087,12237,918,11319,0.860,11.460,5338,2497,2841,2.338,4.999,6899,6.461,9.998,11,11,680
1978,3314,841,1068,125318,126062,90,8.487,75,7.072,9933,1405,8528,1.115,7.879,11598,3495,8103,2.772,9.200,-1665,-1.321,15.759,51,51,540
1978,3315,2822,3156,314926,304781,196,6.213,193,6.118,37410,6525,30885,2.141,12.274,17283,5035,12248,1.652,5.671,20127,6.604,11.341,137,138,2477
1978,3321,2862,3071,157261,151449,250,8.213,196,6.439,22268,5490,16778,3.625,14.703,10806,3629,7177,2.396,7.135,11462,7.568,14.270,132,132,1598
1978,3322,1137,1241,94170,90696,95,7.655,95,7.655,13281,2303,10978,2.539,14.644,6266,3133,3133,3.454,6.909,7015,7.735,13.818,73,73,1652
1978,3323,9346,10131,352585,341126,997,9.975,724,7.244,64584,11789,52795,3.456,18.933,41909,15489,26420,4.541,12.285,22675,6.647,24.571,518,523,8746
1978,3324,1347,1755,172686,171118,115,6.602,89,5.109,16408,3352,13056,1.959,9.589,13636,3798,9838,2.220,7.969,2772,1.620,15.938,50,51,987
1978,3325,893,973,92070,89303,83,8.673,51,5.329,11675,1925,9750,2.156,13.073,6421,1586,4835,1.776,7.190,5254,5.883,14.380,30,30,261
1978,3326,1499,1677,67068,65366,153,9.262,103,6.235,10438,2019,8419,3.089,15.969,6923,3236,3687,4.951,10.591,3515,5.377,21.182,65,65,896
1978,3327,18471,18766,314135,294612,2272,12.737,416,2.332,61690,13075,48615,4.438,20.939,22568,6827,15741,2.317,7.660,39122,13.279,15.320,205,205,3412
1978,3328,5301,5578,124209,117388,460,8.346,327,5.933,23654,4440,19214,3.782,20.150,10176,3200,6976,2.726,8.669,13478,11.482,17.337,257,258,2002
1978,3329,4612,5106,371267,360557,591,11.805,392,7.830,47616,9237,38379,2.562,13.206,25704,6825,18879,1.893,7.129,21912,6.077,14.258,272,273,3760
1978,3331,2853,3268,384626,377552,361,11.187,279,8.646,47994,6404,41590,1.696,12.712,33850,6498,27352,1.721,8.966,14144,3.746,17.931,186,186,2532
1978,3332,3501,3744,190115,183012,269,7.181,273,7.288,28371,8210,20161,4.486,15.502,14373,5710,8663,3.120,7.854,13998,7.649,15.707,171,171,1457
1978,3333,1988,2098,162628,158219,174,8.367,137,6.588,20981,4102,16879,2.593,13.261,12184,3999,8185,2.528,7.701,8797,5.560,15.401,76,76,475
1978,3334,1651,1874,187322,180345,282,15.533,165,9.088,26272,4795,21477,2.659,14.568,12267,4096,8171,2.271,6.802,14005,7.766,13.604,115,115,1209
1978,3335,9383,9769,280747,269760,844,8.781,530,5.514,41008,6134,34874,2.274,15.202,19080,7088,11992,2.628,7.073,21928,8.129,14.146,411,411,2699
1978,3336,671,806,194228,191078,38,4.697,44,5.439,15691,993,14698,0.520,8.212,9074,906,8168,0.474,4.749,6617,3.463,9.498,26,26,202
1978,3339,5399,5871,354624,341828,501,8.642,353,6.089,52718,12808,39910,3.747,15.422,27186,8372,18814,2.449,7.953,25532,7.469,15.906,233,235,2568
1978,3341,775,899,210358,199140,178,20.904,83,9.748,39148,8214,30934,4.125,19.659,16929,3389,13540,1.702,8.501,22219,11.158,17.002,44,45,1881
1978,3342,1526,1666,242927,233482,209,12.571,202,12.150,35621,4996,30625,2.140,15.256,16640,5463,11177,2.340,7.127,18981,8.130,14.254,140,140,1969
1978,3343,528,559,69519,68526,82,14.801,72,12.996,9900,1446,8454,2.110,14.447,8120,1303,6817,1.901,11.850,1780,2.598,23.699,49,49,416
1978,3344,3184,3567,383553,371705,493,14.102,351,10.040,60004,10022,49982,2.696,16.143,36770,11178,25592,3.007,9.892,23234,6.251,19.785,253,254,3092
1978,3345,3294,3747,504627,486810,364,9.792,305,8.204,63920,9200,54720,1.890,13.130,28459,8690,19769,1.785,5.846,35461,7.284,11.692,201,201,3351
1978,3346,607,632,27550,25863,115,18.504,94,15.125,6316,1004,5312,3.882,24.421,2969,932,2037,3.604,11.480,3347,12.942,22.960,62,62,266
1978,3351,1224,1342,90617,87760,126,9.428,115,8.605,12474,1693,10781,1.929,14.214,6603,2414,4189,2.751,7.524,5871,6.690,15.048,84,84,803
1978,3352,371,484,154178,149370,43,9.034,27,5.672,18460,1970,16490,1.319,12.359,8906,1366,7540,0.915,5.962,9554,6.396,11.925,9,10,126
1978,3353,1871,2314,293222,283477,235,10.405,124,5.490,35505,6714,28791,2.368,12.525,15766,4544,11222,1.603,5.562,19739,6.963,11.123,81,81,959
1978,3359,1616,2015,215752,209861,188,9.400,158,7.900,28694,5837,22857,2.781,13.673,16716,5151,11565,2.454,7.965,11978,5.708,15.931,90,90,1398
1978,3361,153,209,315238,307686,37,17.703,37,17.703,41211,13686,27525,4.448,13.394,24807,16068,8739,5.222,8.062,16404,5.331,16.125,28,28,234
1978,3362,2000,2226,150188,146160,255,11.463,252,11.328,23343,4530,18813,3.099,15.971,15688,4512,11176,3.087,10.733,7655,5.237,21.467,181,181,1782
1978,3363,3742,4451,763341,751538,508,10.346,1426,29.043,68656,10198,58458,1.357,9.135,45017,14092,30925,1.875,5.990,23639,3.145,11.980,1140,1140,8059
1978,3364,1002,1193,565574,553943,100,8.379,101,8.463,52038,3166,48872,0.572,9.394,28054,4979,23075,0.899,5.064,23984,4.330,10.129,67,67,1881
1978,3365,161,225,62387,57369,12,5.333,12,5.333,16398,9542,6856,16.633,28.583,6505,423,6082,0.737,11.339,9893,17.245,22.678,9,9,250
1978,3366,1070,1163,202773,202794,156,13.672,112,9.816,23247,3624,19623,1.787,11.463,23882,2559,21323,1.262,11.777,-635,-0.313,22.927,84,84,1442
1978,3369,442,456,34024,31869,68,15.044,60,13.274,6671,633,6038,1.986,20.933,2473,1360,1113,4.268,7.760,4198,13.173,15.520,50,50,509
1978,3371,11883,12456,400054,379507,1896,15.567,1344,11.034,73279,18385,54894,4.844,19.309,32347,14654,17693,3.861,8.523,40932,10.786,17.047,1032,1034,8511
1978,3372,2151,2254,110524,106511,259,11.627,206,9.248,17458,4054,13404,3.806,16.391,9329,3229,6100,3.032,8.759,8129,7.632,17.517,157,157,1388
1978,3379,1103,1249,40045,38652,90,7.191,95,7.591,6342,868,5474,2.246,16.408,3467,1427,2040,3.692,8.970,2875,7.438,17.940,68,68,865
1978,3391,8437,8987,210913,204622,1351,15.481,831,9.522,34780,9573,25207,4.678,16.997,22021,7278,14743,3.557,10.762,12759,6.235,21.524,614,616,3418
1978,3399,14965,15654,478932,464973,1927,12.421,1646,10.610,81174,16868,64306,3.628,17.458,53598,18838,34760,4.051,11.527,27576,5.931,23.054,1269,1271,9876
1978,4231,17465,20888,247580,239852,2454,11.889,1959,9.491,47495,14107,33388,5.882,19.802,32037,14372,17665,5.992,13.357,15458,6.445,26.714,1277,1300,6355
1978,4232,6199,7223,80702,77185,1064,15.095,715,10.144,18811,5403,13408,7.000,24.371,11703,5428,6275,7.033,15.162,7108,9.209,30.325,479,483,1799
1978,4233,6642,8346,106988,101795,1195,14.664,801,9.829,24682,7345,17337,7.215,24.247,14181,6440,7741,6.326,13.931,10501,10.316,27.862,505,509,2519
1978,4234,15294,21452,369551,348876,3402,16.483,1776,8.605,82149,32721,49428,9.379,23.547,41691,19326,22365,5.540,11.950,40458,11.597,23.900,1024,1054,5852
1978,4235,5497,8018,127998,123857,951,12.070,673,8.542,24537,7097,17440,5.730,19.811,16273,7059,9214,5.699,13.139,8264,6.672,26.277,369,379,2317
1978,4236,11608,16406,203750,194754,2283,14.194,1640,10.196,47072,17329,29743,8.898,24.170,28871,13584,15287,6.975,14.824,18201,9.346,29.649,946,966,4178
1978,4237,9414,12112,131427,127052,1449,12.194,991,8.340,25530,7809,17721,6.146,20.094,16769,7711,9058,6.069,13.199,8761,6.896,26.397,625,646,3623
1978,4238,40714,53177,599186,576493,6158,11.824,3963,7.610,120803,41601,79202,7.216,20.955,75289,30696,44593,5.325,13.060,45514,7.895,26.120,2438,2479,12988
1978,4239,17900,19613,202981,197647,2999,15.560,2320,12.037,46503,14268,32235,7.219,23.528,35880,14901,20979,7.539,18.154,10623,5.375,36.307,1637,1654,6945
1978,4241,5948,8427,120223,117683,905,10.919,628,7.577,21449,5944,15505,5.051,18.226,16283,7122,9161,6.052,13.836,5166,4.390,27.673,382,386,2946
1978,4242,2384,3130,86026,83486,424,13.588,405,12.979,17702,6329,11373,7.581,21.204,12669,6913,5756,8.280,15.175,5033,6.029,30.350,227,243,2719
1978,4243,7998,8776,89369,88642,1508,17.440,1250,14.456,24322,8476,15846,9.562,27.438,23072,11621,11451,13.110,26.028,1250,1.410,52.057,895,902,4769
1978,4244,25688,31585,530904,517761,3713,11.820,3367,10.719,104107,31362,72745,6.057,20.107,77231,37075,40156,7.161,14.916,26876,5.191,29.833,2285,2316,17472
1978,4245,8724,11889,108529,106651,848,7.119,892,7.489,22356,5711,16645,5.355,20.962,18714,7812,10902,7.325,17.547,3642,3.415,35.094,557,573,4168
1978,4246,5172,7790,94465,92538,1090,14.367,684,9.015,19298,6588,12710,7.119,20.854,15581,6086,9495,6.577,16.837,3717,4.017,33.675,365,367,1881
1978,4247,11906,15992,146842,144234,1565,9.770,1618,10.101,32022,9638,22384,6.682,22.201,26623,11573,15050,8.024,18.458,5399,3.743,36.917,891,908,4406
1978,4248,4848,5974,120150,118646,432,7.186,508,8.450,20276,5533,14743,4.663,17.090,17496,10063,7433,8.482,14.746,2780,2.343,29.493,338,343,6537
1978,4249,16322,19833,201650,197703,2596,13.242,2140,10.916,40323,13470,26853,6.813,20.396,32194,14489,17705,7.329,16.284,8129,4.112,32.568,1443,1461,7103
1978,4251,23310,25747,258129,248984,3458,13.772,2181,8.686,54404,18378,36026,7.381,21.850,36210,15014,21196,6.030,14.543,18194,7.307,29.086,1421,1425,6941
1978,4411,41161,42300,866930,836426,4194,9.964,3776,8.971,132596,39622,92974,4.737,15.853,71511,28441,43070,3.400,8.550,61085,7.303,17.099,3070,3088,21695
1978,4412,12617,13050,82034,78321,1984,15.469,1535,11.968,21168,8221,12947,10.497,27.027,13682,5875,7807,7.501,17.469,7486,9.558,34.938,1216,1221,4516
1978,4413,40497,55334,392484,376634,6643,12.240,4520,8.328,83460,31942,51518,8.481,22.159,51715,21674,30041,5.755,13.731,31745,8.429,27.462,2842,2970,12447
1978,4421,23216,26772,212843,205124,3465,13.100,2821,10.665,47038,18818,28220,9.174,22.932,31653,14841,16812,7.235,15.431,15385,7.500,30.862,1941,1982,8018
1978,4422,17992,20263,116113,108572,3961,20.245,2566,13.115,33621,14611,19010,13.457,30.967,18603,9055,9548,8.340,17.134,15018,13.832,34.269,1815,1868,5651
1978,4431,28411,38066,210506,198389,6007,16.119,4408,11.828,56991,25447,31544,12.827,28.727,32947,16275,16672,8.204,16.607,24044,12.120,33.215,2858,2931,9753
1978,4441,54431,68382,630412,600327,7499,11.165,5070,7.548,131807,46122,85685,7.683,21.956,71551,28395,43156,4.730,11.919,60256,10.037,23.837,3473,3511,15234
1978,4442,15461,18849,137561,133539,2274,12.258,1677,9.040,31206,12069,19137,9.038,23.369,23310,8335,14975,6.242,17.456,7896,5.913,34.911,1144,1159,4299
1978,4451,63245,94193,1500482,1459862,11788,12.532,11535,12.263,290186,122083,168103,8.363,19.878,208710,90692,118018,6.212,14.297,81476,5.581,28.593,7626,7747,38249
1978,4452,22473,27624,164043,157393,4475,16.265,4252,15.455,47199,22106,25093,14.045,29.988,34039,17672,16367,11.228,21.627,13160,8.361,43.254,3074,3118,12187
1978,4453,28815,34004,166422,155088,3985,11.752,3796,11.195,47211,13932,33279,8.983,30.441,24620,11284,13336,7.276,15.875,22591,14.567,31.750,2694,2732,7702
1978,4461,44180,59791,525797,515428,6924,11.795,4751,8.093,99241,38908,60333,7.549,19.254,79016,35228,43788,6.835,15.330,20225,3.924,30.660,2865,2938,13988
1978,4471,124389,162658,938140,905936,22548,13.682,26839,16.285,264149,105682,158467,11.666,29.158,199924,104699,95225,11.557,22.068,64225,7.089,44.136,18371,18668,63752
1978,4481,59541,90345,753314,734341,13613,15.285,11049,12.406,183964,77530,106434,10.558,25.052,145600,69761,75839,9.500,19.827,38364,5.224,39.655,6534,6821,31099
1978,4482,11369,29753,159345,151624,3617,12.293,2956,10.047,39707,16628,23079,10.967,26.188,24522,11433,13089,7.540,16.173,15185,10.015,32.346,1140,1233,4430
1978,4483,16118,22058,127670,122228,3223,14.987,2118,9.849,31727,14041,17686,11.488,25.957,20973,8782,12191,7.185,17.159,10754,8.798,34.318,1219,1295,4689
1978,4511,30234,37713,219845,211267,7050,19.121,5363,14.546,60812,28353,32459,13.420,28.784,43538,21359,22179,10.110,20.608,17274,8.176,41.216,3644,3702,13091
1978,4512,7251,9666,59904,55236,1847,19.743,1225,13.095,19605,8338,11267,15.095,35.493,10301,4637,5664,8.395,18.649,9304,16.844,37.298,836,850,3005
1978,4522,550,6126,1119981,1087813,515,8.552,307,5.098,162657,55536,107121,5.105,14.953,100122,25832,74290,2.375,9.204,62535,5.749,18.408,38,46,3208
1978,4523,16736,32750,817953,811807,3095,9.370,3656,11.069,123628,46327,77301,5.707,15.229,111862,41529,70333,5.116,13.779,11766,1.449,27.559,2050,2106,8358
1978,4531,18511,19611,97468,91958,2979,15.526,2132,11.111,27497,8854,18643,9.628,29.902,16497,8671,7826,9.429,17.940,11000,11.962,35.880,1618,1659,4847
1978,4532,20140,23548,134052,125888,4730,20.825,3061,13.477,39515,17232,22283,13.688,31.389,23230,11457,11773,9.101,18.453,16285,12.936,36.906,2231,2258,6376
1978,4533,6938,8101,36692,34521,1450,18.229,1157,14.545,11469,4832,6637,13.997,33.224,7097,3422,3675,9.913,20.559,4372,12.665,41.118,816,819,1996
1978,4539,20426,24218,106401,101128,4478,18.838,3584,15.077,33308,15073,18235,14.905,32.937,22691,11639,11052,11.509,22.438,10617,10.499,44.876,2435,2494,7969
1978,4541,4732,6430,88705,88856,1080,17.254,739,11.806,20755,8323,12432,9.367,23.358,20724,11792,8932,13.271,23.323,31,0.035,46.646,431,436,3192
1978,4542,4341,5432,74052,72119,642,11.878,588,10.879,13332,4042,9290,5.605,18.486,9607,4130,5477,5.727,13.321,3725,5.165,26.642,374,377,2019
1978,4543,18036,23747,201537,202069,2381,10.018,2422,10.190,38417,11606,26811,5.744,19.012,39359,13997,25362,6.927,19.478,-942,-0.466,38.024,1668,1682,7184
1978,4811,942,2203,272035,261035,260,11.778,269,12.186,41792,4461,37331,1.709,16.010,19511,3149,16362,1.206,7.474,22281,8.536,14.949,97,98,977
1978,4812,300,425,5500,4972,94,22.651,74,17.831,2140,437,1703,8.789,43.041,1116,884,232,17.780,22.446,1024,20.595,44.891,42,42,206
1978,4831,465,729,38006,37577,100,13.736,98,13.462,8610,2698,5912,7.180,22.913,7605,4579,3026,12.186,20.238,1005,2.675,40.477,50,58,1387
1978,4832,439,510,16066,15824,55,10.721,61,11.891,3721,1984,1737,12.538,23.515,3257,1098,2159,6.939,20.583,464,2.932,41.165,35,40,977
1978,4841,20764,25644,526147,500441,4897,19.480,3886,15.458,129287,42208,87079,8.434,25.835,77644,31585,46059,6.311,15.515,51643,10.319,31.030,2800,2802,11531
1978,4842,38463,41868,519400,501674,7359,17.813,6249,15.126,125263,39417,85846,7.857,24.969,89667,36620,53047,7.300,17.874,35596,7.095,35.747,4753,4761,18382
1978,4851,395,436,22813,22468,34,7.675,48,10.835,3152,479,2673,2.132,14.029,2566,1547,1019,6.885,11.421,586,2.608,22.841,35,35,1395
1978,4852,297,648,28796,28967,126,21.018,29,4.837,4982,2397,2585,8.275,17.199,5300,906,4394,3.128,18.297,-318,-1.098,34.398,18,18,229
1978,4853,6301,6364,78887,80636,1098,17.308,1058,16.677,18065,6692,11373,8.299,22.403,21333,9518,11815,11.804,26.456,-3268,-4.053,44.807,889,893,7129
1978,4854,3805,3957,87574,84195,379,9.563,391,9.866,16668,3737,12931,4.439,19.797,9972,4505,5467,5.351,11.844,6696,7.953,23.688,315,315,2297
1978,4855,355,378,6520,6621,99,27.731,57,15.966,1726,576,1150,8.700,26.069,1907,1478,429,22.323,28.802,-181,-2.734,52.137,41,41,873
1978,4859,854,893,17092,16574,140,15.686,139,15.574,3884,1152,2732,6.951,23.435,2749,1734,1015,10.462,16.587,1135,6.848,33.173,105,106,1043
1978,4861,73,288,11708,10550,51,18.647,22,8.044,4152,2367,1785,22.436,39.355,1738,559,1179,5.299,16.474,2414,22.882,32.948,D,D,D
1978,4862,198,910,48731,46058,112,12.771,46,5.245,8567,4179,4388,9.073,18.601,3307,1739,1568,3.776,7.180,5260,11.421,14.360,7,7,56
1978,4869,64,259,6927,6821,33,12.766,32,12.379,1363,536,827,7.859,19.984,1209,887,322,13.005,17.726,154,2.258,35.452,4,4,66
1978,4871,150,153,1746,1637,37,25.342,23,15.753,538,162,376,9.899,32.875,328,144,184,8.799,20.043,210,12.832,40.086,20,20,139
1978,4872,741,748,9863,9087,127,16.979,127,16.979,3215,635,2580,6.988,35.382,1608,658,950,7.242,17.697,1607,17.686,35.393,99,99,348
1978,4879,46,52,395,352,13,26.804,6,12.371,137,47,90,13.352,38.920,50,20,30,5.682,14.205,87,24.716,28.409,3,3,5
1978,4881,1879,2313,47614,47313,352,15.466,278,12.214,10378,3067,7311,6.482,21.935,9521,5706,3815,12.060,20.124,857,1.811,40.247,190,190,741
1978,4882,255,309,15517,15553,44,14.426,36,11.803,2169,571,1598,3.671,13.946,2241,500,1741,3.215,14.409,-72,-0.463,27.893,24,24,236
1978,4883,1865,2303,119576,106810,326,14.308,277,12.157,49596,21818,27778,20.427,46.434,24578,6753,17825,6.322,23.011,25018,23.423,46.022,185,185,1853
1978,4884,2216,2838,45637,44830,472,17.024,341,12.299,9250,2457,6793,5.481,20.634,7609,4021,3588,8.970,16.973,1641,3.661,33.946,217,222,2606
1978,4885,3368,5020,70765,67813,810,16.725,456,9.416,15733,4856,10877,7.161,23.201,9695,3527,6168,5.201,14.297,6038,8.904,28.594,239,246,1038
1978,4889,303,312,5151,4874,63,20.792,45,14.851,1554,487,1067,9.993,31.887,1034,266,768,5.458,21.217,520,10.670,42.434,33,33,164
1978,4921,1063,1495,51242,49670,312,21.188,267,18.132,9922,2329,7593,4.689,19.976,6946,1506,5440,3.032,13.984,2976,5.992,27.969,192,192,764
1978,4922,923,923,5287,5036,239,25.066,300,31.463,1825,792,1033,15.727,36.239,1328,877,451,17.415,26.370,497,9.869,52.740,267,267,796
1978,4931,5473,8580,373385,364013,830,9.787,632,7.452,68820,16837,51983,4.625,18.906,50209,11821,38388,3.247,13.793,18611,5.113,27.586,249,250,1568
1978,5111,12879,14286,564633,551343,1638,11.607,1291,9.148,65577,13485,52092,2.446,11.894,39320,14482,24838,2.627,7.132,26257,4.762,14.263,983,987,7583
1978,5112,2538,3139,53142,49522,1000,34.758,476,16.545,19234,8461,10773,17.085,38.839,12141,7152,4989,14.442,24.516,7093,14.323,49.033,233,235,1388
1978,5121,7895,13263,179749,180026,2112,15.865,2211,16.608,51384,19427,31957,10.791,28.543,51427,27261,24166,15.143,28.566,-43,-0.024,57.085,1112,1198,9856
1978,5122,971,973,7723,7425,272,30.273,123,13.689,2445,968,1477,13.037,32.929,1842,964,878,12.983,24.808,603,8.121,49.616,86,86,411
1978,5151,5169,6058,170970,163635,566,9.490,378,6.338,29185,9168,20017,5.603,17.835,14580,5406,9174,3.304,8.910,14605,8.925,17.820,275,280,3351
1978,5152,3,3,16,15,D,D,0,0.000,3,D,D,D,20.690,0,0,D,0.000,0.000,3,20.690,0.000,0,0,0
1978,5173,1877,14347,920704,898451,572,3.984,590,4.110,143236,10148,133088,1.130,15.943,97896,4779,93117,0.532,10.896,45340,5.046,21.792,88,89,1061
1978,5174,478,774,20748,19644,116,15.750,41,5.567,4216,1620,2596,8.247,21.462,2001,881,1120,4.485,10.186,2215,11.276,20.373,28,28,209
1978,5179,829,1883,55297,53278,238,13.070,114,6.260,11160,1931,9229,3.624,20.947,7142,1326,5816,2.489,13.405,4018,7.542,26.811,70,72,356
1978,5182,4500,5962,165957,158145,1141,19.783,752,13.039,42875,16555,26320,10.468,27.111,27289,13615,13674,8.609,17.256,15586,9.856,34.511,400,410,4365
1978,5191,1916,2296,25397,26154,262,11.736,135,6.047,4757,1277,3480,4.883,18.188,6125,4582,1543,17.519,23.419,-1368,-5.231,36.377,93,93,3667
1978,5211,20,50,23489,23807,0,0.000,0,0.000,1081,0,1081,0.000,4.541,1697,0,1697,0.000,7.128,-616,-2.588,9.082,0,0,0
1978,5221,20746,57514,1550563,1503863,3578,6.350,1246,2.211,218701,45267,173434,3.010,14.543,124985,20973,104012,1.395,8.311,93716,6.232,16.622,332,335,5585
1978,5222,24152,43737,322275,311059,3993,9.218,3151,7.274,69994,26104,43890,8.392,22.502,47465,19330,28135,6.214,15.259,22529,7.243,30.518,1251,1268,4803
1978,5223,2454,2718,30935,28690,643,25.211,308,12.076,8318,2976,5342,10.373,28.993,3836,2375,1461,8.278,13.371,4482,15.622,26.741,207,208,1228
1978,5231,3790,7226,152387,156391,1063,14.896,883,12.374,29710,7813,21897,4.996,18.997,37400,14502,22898,9.273,23.914,-7690,-4.917,37.995,383,446,4824
1978,5232,87,96,3907,3880,20,21.277,16,17.021,397,63,334,1.624,10.233,342,58,284,1.495,8.816,55,1.418,17.631,12,12,49
1978,5239,8292,8594,66676,64629,1763,21.091,1293,15.468,18031,6785,11246,10.498,27.899,13693,5356,8337,8.287,21.187,4338,6.712,42.374,1030,1031,3253
1978,5241,5911,27060,1141135,1113113,2190,8.086,2241,8.274,178550,40118,138432,3.604,16.041,121180,47392,73788,4.258,10.887,57370,5.154,21.773,258,264,2815
1978,5242,82266,86038,807627,770156,11858,14.190,6910,8.269,154392,38179,116213,4.957,20.047,79473,24526,54947,3.185,10.319,74919,9.728,20.638,5161,5170,14604
1978,5259,564,770,6770,6755,53,6.739,86,10.935,1250,243,1007,3.598,18.506,1191,428,763,6.337,17.633,59,0.873,35.265,49,49,253
1978,5311,104923,106773,491968,476886,15184,14.243,14856,13.935,128552,54745,73807,11.480,26.957,97700,51805,45895,10.863,20.487,30852,6.469,40.974,12203,12210,35502
1978,5312,28210,29060,152312,140549,6416,23.299,3371,12.241,50748,21350,29398,15.190,36.107,27084,10690,16394,7.606,19.270,23664,16.837,38.540,2581,2582,7107
1978,5313,18557,19105,161303,151413,4083,22.472,2211,12.169,47320,17494,29826,11.554,31.252,27409,11965,15444,7.902,18.102,19911,13.150,36.204,1580,1587,6505
1978,5321,5234,7853,76345,75210,1762,23.506,1048,13.981,24462,12400,12062,16.487,32.525,21932,8044,13888,10.695,29.161,2530,3.364,58.322,618,628,2440
1978,5322,7703,8913,77587,73105,1901,22.208,1195,13.960,23953,9617,14336,13.155,32.765,14843,6984,7859,9.553,20.304,9110,12.462,40.608,825,839,4322
1978,5323,1772,1918,14212,12952,398,22.007,179,9.898,4564,1747,2817,13.488,35.238,2060,923,1137,7.126,15.905,2504,19.333,31.810,115,116,473
1978,5324,3202,3505,38696,37520,681,20.271,390,11.609,9906,3310,6596,8.822,26.402,7542,3485,4057,9.288,20.101,2364,6.301,40.203,254,255,1934
1978,5331,836,962,12025,12245,188,20.215,124,13.333,3956,1470,2486,12.005,32.308,4465,1829,2636,14.937,36.465,-509,-4.157,64.617,84,84,310
1978,5411,95725,98457,473990,458803,13454,14.017,8502,8.858,109642,41918,67724,9.136,23.897,79905,48519,31386,10.575,17.416,29737,6.481,34.832,6159,6207,41119
1978,5412,37928,40574,280367,263082,7671,19.837,3863,9.990,70847,29257,41590,11.121,26.930,36147,17861,18286,6.789,13.740,34700,13.190,27.480,2685,2708,11059
1978,5413,35497,38927,489919,462349,7229,19.411,3860,10.365,124548,43255,81293,9.355,26.938,69374,25929,43445,5.608,15.005,55174,11.933,30.009,2522,2542,11129
1978,5414,8852,9085,67514,63506,2014,23.341,1101,12.760,19714,7857,11857,12.372,31.043,11754,5659,6095,8.911,18.509,7960,12.534,37.017,863,866,3669
1978,5415,1685,2071,22726,19284,1208,74.201,322,19.779,11211,6984,4227,36.217,58.138,4481,2754,1727,14.282,23.237,6730,34.900,46.475,203,206,1447
1978,5416,13714,14336,135632,130469,3266,23.577,2299,16.596,45103,16162,28941,12.388,34.570,34511,16562,17949,12.694,26.452,10592,8.118,52.903,1640,1651,9655
1978,5417,4402,5459,352868,342075,769,14.283,619,11.497,55329,19360,35969,5.660,16.175,33804,6885,26919,2.013,9.882,21525,6.292,19.764,373,375,1913
1978,5418,16996,18656,227243,219617,3146,17.288,2230,12.254,55435,19374,36061,8.822,25.242,40087,16626,23461,7.570,18.253,15348,6.989,36.506,1649,1653,9418
1978,5419,20974,22520,167384,156279,3588,16.493,2058,9.460,42940,13319,29621,8.523,27.477,20764,8805,11959,5.634,13.287,22176,14.190,26.573,1398,1543,6197
1978,5511,18993,36128,2428735,2362628,3944,11.034,3177,8.888,524500,138903,385597,5.879,22.200,391529,97797,293732,4.139,16.572,132971,5.628,33.144,400,431,4528
1978,5611,5108,5289,61291,57937,980,18.635,920,17.494,19569,6632,12937,11.447,33.776,12876,5862,7014,10.118,22.224,6693,11.552,44.448,663,667,3528
1978,5612,287,352,16373,16441,41,11.066,78,21.053,5102,833,4269,5.067,31.032,5308,3239,2069,19.701,32.285,-206,-1.253,62.064,28,33,558
1978,5613,8089,10467,457757,416997,2267,22.758,1256,12.609,176129,52932,123197,12.694,42.238,95780,24730,71050,5.931,22.969,80349,19.269,45.938,827,839,10259
1978,5614,13872,15652,164874,155701,2955,19.613,1784,11.841,43436,15621,27815,10.033,27.897,24843,9866,14977,6.337,15.956,18593,11.942,31.911,1318,1334,6096
1978,5615,12830,15163,109663,103214,2854,19.960,1125,7.868,28312,10961,17351,10.620,27.431,15275,5856,9419,5.674,14.799,13037,12.631,29.599,712,730,3370
1978,5616,8231,9836,301811,286808,2440,26.363,1279,13.819,86310,34749,51561,12.116,30.093,56135,22404,33731,7.812,19.572,30175,10.521,39.145,944,955,11773
1978,5617,43018,45393,587071,546554,10960,25.154,7317,16.793,193829,61577,132252,11.266,35.464,113462,44932,68530,8.221,20.760,80367,14.704,41.519,5712,5722,26836
1978,5619,8201,8829,106578,102633,2206,26.793,1015,12.328,30715,12799,17916,12.471,29.927,22530,7077,15453,6.895,21.952,8185,7.975,43.904,761,763,4680
1978,5621,5255,5386,94266,89084,818,15.476,617,11.673,20702,6217,14485,6.979,23.239,10365,4880,5485,5.478,11.635,10337,11.604,23.270,491,491,3349
1978,5622,1568,1895,31777,30123,273,14.753,184,9.943,7038,1876,5162,6.228,23.364,3755,1641,2114,5.448,12.466,3283,10.899,24.931,108,108,573
1978,5629,3439,3609,30463,28923,638,18.012,504,14.229,8786,2705,6081,9.352,30.377,5781,2684,3097,9.280,19.988,3005,10.390,39.975,377,377,1428
1978,6111,13058,13457,363326,351480,835,6.231,721,5.381,49854,7984,41870,2.272,14.184,26232,6158,20074,1.752,7.463,23622,6.721,14.927,564,565,3910
1978,6112,329,375,27268,26252,36,9.959,9,2.490,5361,321,5040,1.223,20.422,3239,967,2272,3.684,12.338,2122,8.083,24.677,4,4,773
1978,6113,1928,2160,731101,670423,113,5.239,107,4.961,168002,5565,162437,0.830,25.059,49474,18405,31069,2.745,7.380,118528,17.680,14.759,31,33,9814
1978,6114,1495,1681,24444,24353,327,20.024,231,14.146,6617,2305,4312,9.465,27.171,6388,4418,1970,18.142,26.231,229,0.940,52.462,152,158,3080
1978,6115,3859,4247,41869,47785,690,16.725,447,10.835,10790,3976,6814,8.321,22.580,22318,17768,4550,37.183,46.705,-11528,-24.125,45.161,322,323,16880
1978,6116,9255,9723,86771,84334,2309,24.824,1466,15.761,29673,12694,16979,15.052,35.185,25199,16180,9019,19.186,29.880,4474,5.305,59.760,1119,1135,14107
1978,6117,773,781,7458,7012,148,19.334,117,15.284,2084,609,1475,8.686,29.723,1144,420,724,5.990,16.316,940,13.407,32.632,74,74,238
1978,6211,139059,142916,747670,715671,15685,11.261,8433,6.054,156017,58230,97787,8.136,21.800,91969,29217,62752,4.082,12.851,64048,8.949,25.701,6535,6564,19721
1978,6212,80896,82058,319029,298057,6775,8.435,3302,4.111,72185,20739,51446,6.958,24.219,29857,9816,20041,3.293,10.017,42328,14.201,20.034,2457,2475,7251
1978,6213,26452,27297,80245,74145,4417,16.979,1851,7.115,24775,10985,13790,14.816,33.414,12016,6478,5538,8.737,16.206,12759,17.208,32.412,1316,1323,5308
1978,6214,3875,4824,76850,72454,879,18.985,491,10.605,20044,7151,12893,9.870,27.664,11426,4436,6990,6.123,15.770,8618,11.894,31.540,266,280,2476
1978,6215,3543,4446,56639,54834,633,14.537,450,10.334,11226,3821,7405,6.968,20.473,7742,3540,4202,6.456,14.119,3484,6.354,28.238,308,312,2286
1978,6216,2035,2606,73511,67548,530,21.523,243,9.868,21959,7722,14237,11.432,32.509,9965,4086,5879,6.049,14.753,11994,17.756,29.505,138,139,1862
1978,6219,1910,2169,40034,39501,417,19.900,270,12.885,11879,4668,7211,11.818,30.073,10765,5550,5215,14.050,27.253,1114,2.820,54.506,168,169,4476
1978,6221,4174,5004,2562685,2484415,166,3.330,128,2.568,233566,26816,206750,1.079,9.401,76270,27363,48907,1.101,3.070,157296,6.331,6.140,73,76,13333
1978,6222,321,385,77441,75609,43,11.622,13,3.514,7109,1143,5966,1.512,9.402,3504,971,2533,1.284,4.634,3605,4.768,9.269,5,5,239
1978,6223,159,195,43101,40723,23,12.202,10,5.305,5967,965,5002,2.370,14.653,1267,557,710,1.368,3.111,4700,11.542,6.223,7,7,297
1978,6231,8401,10911,782829,747612,1008,9.326,802,7.420,152083,54068,98015,7.232,20.343,82039,44750,37289,5.986,10.973,70044,9.369,21.947,526,551,28545
1978,6232,2658,3158,72626,66425,741,25.783,173,6.019,18646,8377,10269,12.611,28.071,6315,1902,4413,2.863,9.507,12331,18.564,19.014,94,96,1314
1978,6233,5969,6674,194841,189433,1073,16.533,705,10.863,42081,15045,27036,7.942,22.214,30594,19428,11166,10.256,16.150,11487,6.064,32.301,434,441,7893
1978,6239,2174,2561,61678,59329,406,16.595,177,7.235,12124,4288,7836,7.228,20.435,7365,2088,5277,3.519,12.414,4759,8.021,24.828,101,103,996
1978,6241,9567,13014,213076,193017,2287,18.443,1060,8.548,65747,17908,47839,9.278,34.063,25961,8128,17833,4.211,13.450,39786,20.613,26.900,432,440,3400
1978,6242,2710,3213,34632,33335,549,17.871,267,8.691,10418,3601,6817,10.802,31.252,7703,1917,5786,5.751,23.108,2715,8.145,46.216,106,106,503
1978,6243,2902,4187,200340,175657,873,21.993,438,11.034,78871,21241,57630,12.092,44.901,29240,10030,19210,5.710,16.646,49631,28.254,33.292,145,152,1876
1978,6244,21626,25050,208337,191943,4354,18.063,2463,10.218,63241,24918,38323,12.982,32.948,30769,12613,18156,6.571,16.030,32472,16.918,32.061,1632,1644,6488
1978,7111,4068,4110,51653,48723,898,22.258,747,18.515,17988,7742,10246,15.890,36.919,12266,4716,7550,9.679,25.175,5722,11.744,50.350,557,559,3080
1978,7112,2021,2111,53712,52760,449,21.581,388,18.649,13129,3150,9979,5.970,24.885,11251,4340,6911,8.226,21.325,1878,3.560,42.650,277,278,1137
1978,7113,1784,1821,24020,22911,408,23.169,288,16.354,7808,3387,4421,14.784,34.080,5629,2340,3289,10.214,24.570,2179,9.511,49.139,212,215,1553
1978,7114,902,914,9707,9306,235,26.996,148,17.002,3516,1936,1580,20.805,37.784,2685,1639,1046,17.613,28.854,831,8.930,57.708,103,103,679
1978,7115,3478,3501,26456,24267,1139,35.728,513,16.092,10933,5036,5897,20.752,45.053,6442,2779,3663,11.452,26.546,4491,18.507,53.093,345,346,1960
1978,7121,1715,1839,29406,27792,221,12.402,107,6.004,5998,1558,4440,5.606,21.582,2681,479,2202,1.724,9.647,3317,11.935,19.294,60,61,285
1978,7131,1420,1515,50022,45140,279,18.569,254,16.905,12959,5053,7906,11.194,28.709,3324,1264,2060,2.800,7.364,9635,21.345,14.728,207,207,843
1978,7132,618,628,15641,14453,125,20.627,81,13.366,3974,1049,2925,7.258,27.497,1557,655,902,4.532,10.773,2417,16.724,21.546,63,63,496
1978,7139,26894,28267,390326,369439,3915,14.156,2694,9.741,91921,31215,60706,8.449,24.881,50305,17610,32695,4.767,13.617,41616,11.265,27.233,2034,2042,12387
1978,7211,28988,32731,944158,901715,4873,14.947,4616,14.158,237977,99947,138030,11.084,26.392,153036,82742,70294,9.176,16.972,84941,9.420,33.943,3378,3415,50313
1978,7212,3265,3475,17626,16142,736,21.977,484,14.452,6267,2912,3355,18.040,38.824,3375,1403,1972,8.692,20.908,2892,17.916,41.816,321,322,922
1978,7213,5833,5888,29978,29698,393,6.550,617,10.283,5817,1076,4741,3.623,19.587,5138,2601,2537,8.758,17.301,679,2.286,34.602,454,454,1708
1978,7223,11895,14362,241508,230001,2747,19.366,2392,16.863,67953,34346,33607,14.933,29.545,44816,21243,23573,9.236,19.485,23137,10.060,38.970,1736,1742,13085
1978,7224,65130,65871,349138,338330,10390,15.611,11760,17.669,108188,52128,56060,15.407,31.977,86748,44000,42748,13.005,25.640,21440,6.337,51.280,9224,9232,34648
1978,7225,173005,219714,3635750,3420513,42559,19.785,33356,15.506,1093162,586822,506340,17.156,31.959,660157,332609,327548,9.724,19.300,433005,12.659,38.600,23121,23592,200043
1978,8111,81066,84258,401825,378008,15730,19.200,11065,13.506,116466,53279,63187,14.095,30.810,68455,33489,34966,8.859,18.109,48011,12.701,36.219,8479,8518,25351
1978,8112,10599,11619,61117,59220,1724,14.815,1760,15.124,13544,4986,8558,8.420,22.871,9695,5240,4455,8.848,16.371,3849,6.500,32.743,1391,1397,3420
1978,8113,16029,17114,126325,120695,2679,16.029,1877,11.231,30730,10100,20630,8.368,25.461,19285,8970,10315,7.432,15.978,11445,9.483,31.957,1445,1449,4712
1978,8114,20696,22307,135071,128775,3919,17.830,3264,14.850,31883,12344,19539,9.586,24.759,19189,9185,10004,7.133,14.901,12694,9.858,29.802,2477,2485,6424
1978,8121,82035,89020,396139,384021,13688,15.496,12312,13.938,102476,46310,56166,12.059,26.685,77883,38601,39282,10.052,20.281,24593,6.404,40.562,9578,9673,28242
1978,8122,17169,19387,108169,106807,1672,8.748,1122,5.871,17837,5834,12003,5.462,16.700,15257,4214,11043,3.945,14.285,2580,2.416,28.569,709,726,2129
1978,8123,33999,39458,334605,332345,4293,10.784,4996,12.550,61112,19258,41854,5.795,18.388,56701,24863,31838,7.481,17.061,4411,1.327,34.122,3641,3739,18015
1978,8129,10897,16471,161645,158679,3577,22.412,2555,16.009,47183,20505,26678,12.922,29.735,40223,16361,23862,10.311,25.349,6960,4.386,50.697,1231,1270,5982
1978,8131,67435,67597,586773,546166,5085,7.692,2103,3.181,127025,19022,108003,3.483,23.258,45929,7991,37938,1.463,8.409,81096,14.848,16.819,1130,1130,3147
1978,8132,6497,7204,114528,106241,1035,14.878,540,7.763,36861,10383,26478,9.773,34.696,20195,4968,15227,4.676,19.009,16666,15.687,38.017,295,303,1806
1978,8133,5926,6847,91825,85518,1224,18.623,675,10.270,29161,8628,20533,10.089,34.099,16488,5421,11067,6.339,19.280,12673,14.819,38.561,340,350,2879
1978,8134,26611,27704,232117,218595,2139,7.814,1479,5.403,52275,9914,42361,4.535,23.914,25026,5095,19931,2.331,11.449,27249,12.466,22.897,947,948,2927
1978,8139,52844,54843,414595,395549,5514,10.259,3324,6.184,97124,20594,76530,5.206,24.554,59367,15122,44245,3.823,15.009,37757,9.545,30.018,2120,2130,9258
1979,1131,203,210,2773,2950,35,16.746,33,15.789,480,161,319,5.459,16.274,849,195,654,6.611,28.785,-369,-12.511,32.548,28,28,158
1979,1132,95,110,1658,1710,18,16.822,12,11.215,434,98,336,5.733,25.388,534,142,392,8.307,31.237,-100,-5.850,50.775,10,10,139
1979,1133,11702,11826,101733,100921,2127,17.997,2112,17.870,24373,9290,15083,9.205,24.151,22759,9396,13363,9.310,22.551,1614,1.599,45.103,1539,1540,6552
1979,1141,1471,1513,10910,10428,296,19.480,309,20.336,4461,1442,3019,13.829,42.781,3476,1293,2183,12.400,33.335,985,9.446,66.670,224,224,895
1979,1142,142,142,600,652,28,19.178,36,24.658,175,88,87,13.507,26.861,268,76,192,11.665,41.136,-93,-14.275,53.722,26,26,52
1979,1151,4073,4444,49171,51551,644,14.260,788,17.449,14377,5795,8582,11.241,27.889,19273,7683,11590,14.904,37.387,-4896,-9.497,55.778,511,554,4732
1979,1152,1679,1701,9732,9734,299,17.856,246,14.691,2381,1007,1374,10.345,24.461,2392,1073,1319,11.023,24.574,-11,-0.113,48.921,191,191,791
1979,1153,672,687,9317,8604,165,24.943,114,17.234,3393,1556,1837,18.085,39.435,2027,749,1278,8.705,23.559,1366,15.876,47.118,89,89,592
1979,2111,5634,7418,128743,124008,1047,14.505,647,8.964,24636,6824,17812,5.503,19.866,15384,5642,9742,4.550,12.406,9252,7.461,24.811,349,353,2112
1979,2121,3109,3881,245942,216549,822,21.227,805,20.788,88896,15198,73698,7.018,41.051,30230,14268,15962,6.589,13.960,58666,27.091,27.920,556,558,6153
1979,2122,460,641,79847,78747,96,14.815,110,16.975,11396,2216,9180,2.814,14.472,9157,2950,6207,3.746,11.628,2239,2.843,23.257,65,65,344
1979,2123,3667,5166,117401,112313,496,9.625,470,9.121,22488,6109,16379,5.439,20.023,12345,4530,7815,4.033,10.992,10143,9.031,21.983,234,239,1718
1979,2131,7314,8485,247775,233658,1729,21.189,1079,13.223,71336,23313,48023,9.977,30.530,42526,18216,24310,7.796,18.200,28810,12.330,36.400,665,670,8774
1979,2211,1516,5515,515913,505598,249,4.526,223,4.053,48420,16912,31508,3.345,9.577,28075,4791,23284,0.948,5.553,20345,4.024,11.106,26,26,140
1979,2212,531,2307,133265,132425,111,4.847,77,3.362,9006,2999,6007,2.265,6.801,7433,1783,5650,1.346,5.613,1573,1.188,11.226,23,23,258
1979,2213,3998,4309,34558,33988,429,10.173,245,5.810,5106,1676,3430,4.931,15.023,3981,1491,2490,4.387,11.713,1125,3.310,23.426,164,164,499
1979,2361,109200,109543,658867,628520,26887,25.324,20146,18.975,247921,109190,138731,17.373,39.445,187692,80688,107004,12.838,29.863,60229,9.583,59.725,15793,15793,62438
1979,2362,34615,35178,667339,626919,6162,18.032,4151,12.147,202823,40556,162267,6.469,32.352,122353,28946,93407,4.617,19.517,80470,12.836,39.033,3124,3124,21811
1979,2371,13523,13824,329410,322103,1648,12.043,1369,10.004,79704,13779,65925,4.278,24.745,64340,14311,50029,4.443,19.975,15364,4.770,39.950,1056,1056,7942
1979,2372,6992,7145,67024,62565,2081,30.592,1396,20.522,26203,13210,12993,21.114,41.881,17348,8125,9223,12.986,27.728,8855,14.153,55.456,1017,1019,4385
1979,2373,10961,11281,244182,234630,1134,10.115,995,8.875,61511,9107,52404,3.881,26.216,42459,9958,32501,4.244,18.096,19052,8.120,36.192,731,733,6588
1979,2379,4551,4619,118752,113572,867,19.143,687,15.169,34525,7642,26883,6.729,30.399,23960,4239,19721,3.732,21.097,10565,9.303,42.194,495,495,2540
1979,2381,69111,69513,599563,566584,12337,18.148,9273,13.641,193786,56127,137659,9.906,34.203,127730,43547,84183,7.686,22.544,66056,11.659,45.088,7230,7231,34222
1979,2382,95734,97434,997434,945562,13759,14.405,9919,10.385,251825,57430,194395,6.074,26.632,148253,46226,102027,4.889,15.679,103572,10.953,31.358,7778,7789,33277
1979,2383,71380,71775,541938,515736,13685,19.375,11398,16.137,177080,55122,121958,10.688,34.335,124310,48669,75641,9.437,24.103,52770,10.232,48.207,9005,9009,36941
1979,2389,33470,33666,358161,339070,6241,19.046,4446,13.568,108165,28457,79708,8.393,31.900,70125,20965,49160,6.183,20.682,38040,11.219,41.363,3386,3387,14143
1979,3111,1461,2146,61888,60906,113,5.235,138,6.393,8498,1902,6596,3.123,13.953,6471,1628,4843,2.673,10.625,2027,3.328,21.249,80,82,671
1979,3112,512,874,81470,80925,42,4.786,49,5.584,6249,1011,5238,1.249,7.722,5049,1012,4037,1.251,6.239,1200,1.483,12.478,29,29,425
1979,3113,1182,1559,93125,95393,155,9.816,195,12.350,8470,1810,6660,1.897,8.879,12780,3314,9466,3.474,13.397,-4310,-4.518,17.758,93,96,820
1979,3114,1277,1812,194915,192774,88,4.775,150,8.139,23891,3194,20697,1.657,12.393,19527,3717,15810,1.928,10.129,4364,2.264,20.259,85,85,1379
1979,3115,2104,2933,153527,154335,130,4.335,262,8.736,14686,3349,11337,2.170,9.516,16201,4597,11604,2.979,10.497,-1515,-0.982,19.031,174,176,2243
1979,3116,4511,5141,332964,331807,353,6.761,514,9.844,37844,6785,31059,2.045,11.405,35794,12729,23065,3.836,10.788,2050,0.618,21.575,346,347,5008
1979,3117,750,884,50798,49697,52,5.849,62,6.974,9539,2405,7134,4.839,19.195,7336,1545,5791,3.109,14.762,2203,4.433,29.523,35,35,827
1979,3118,7847,9431,310606,308011,1133,12.047,1080,11.484,43124,15140,27984,4.915,14.001,37951,16677,21274,5.414,12.321,5173,1.679,24.643,751,769,7012
1979,3119,1980,2370,119919,119244,170,7.070,239,9.940,15203,2741,12462,2.299,12.750,13943,4210,9733,3.531,11.693,1260,1.057,23.386,151,151,1660
1979,3121,2232,2840,189556,187538,172,5.965,259,8.982,22798,4734,18064,2.524,12.156,18526,6929,11597,3.695,9.879,4272,2.278,19.757,155,156,2094
1979,3122,131,197,47895,47873,12,5.970,20,9.950,2981,346,2635,0.723,6.227,2913,525,2388,1.097,6.085,68,0.142,12.170,10,10,92
1979,3131,459,714,126167,128872,41,5.636,68,9.347,9639,3062,6577,2.376,7.480,14875,6448,8427,5.003,11.542,-5236,-4.063,14.959,35,35,1582
1979,3132,1765,2223,366977,367493,160,7.129,203,9.044,25649,4618,21031,1.257,6.979,26465,6177,20288,1.681,7.202,-816,-0.222,13.959,124,126,2579
1979,3133,3378,3800,158403,158760,288,7.705,164,4.387,15843,3445,12398,2.170,9.979,16364,5027,11337,3.166,10.307,-521,-0.328,19.958,83,84,1867
1979,3141,4524,4833,135789,136130,592,12.281,567,11.762,17918,5457,12461,4.009,13.162,18710,5285,13425,3.882,13.744,-792,-0.582,26.325,438,438,3564
1979,3149,3416,3552,136624,135367,504,14.491,356,10.236,22669,8050,14619,5.947,16.746,20114,6947,13167,5.132,14.859,2555,1.887,29.718,253,254,3599
1979,3151,1405,1544,142867,141904,143,9.229,154,9.939,19159,5377,13782,3.789,13.501,17261,4903,12358,3.455,12.164,1898,1.338,24.328,118,118,3042
1979,3152,13540,15494,1013272,1022918,1930,12.415,2033,13.078,139543,47214,92329,4.616,13.642,159120,60607,98513,5.925,15.556,-19577,-1.914,27.283,1472,1484,31607
1979,3159,1523,1632,65021,64682,169,10.362,167,10.239,9617,2431,7186,3.758,14.868,9020,3015,6005,4.661,13.945,597,0.923,27.890,119,119,1295
1979,3161,375,423,22821,23489,25,5.714,54,12.343,2054,447,1607,1.903,8.745,3408,526,2882,2.239,14.509,-1354,-5.764,17.489,42,42,339
1979,3162,525,789,153726,155629,50,6.262,69,8.641,14666,2243,12423,1.441,9.424,18629,5801,12828,3.727,11.970,-3963,-2.546,18.847,37,37,1747
1979,3169,1369,1433,69315,69681,136,9.399,164,11.334,9643,1979,7664,2.840,13.839,10345,2494,7851,3.579,14.846,-702,-1.007,27.678,110,110,1448
1979,3211,5593,6179,169163,166038,749,12.155,715,11.603,26829,7338,19491,4.419,16.158,20362,7683,12679,4.627,12.263,6467,3.895,24.527,498,506,4322
1979,3212,1039,1322,99585,97921,156,11.954,122,9.349,12052,4068,7984,4.154,12.308,8746,2853,5893,2.914,8.932,3306,3.376,17.863,77,77,820
1979,3219,8381,9199,319878,318856,1179,12.968,964,10.603,49254,14111,35143,4.426,15.447,46963,13725,33238,4.304,14.729,2291,0.719,29.457,666,667,7635
1979,3221,369,745,212094,212763,29,3.831,53,7.001,9787,2351,7436,1.105,4.600,11130,2418,8712,1.136,5.231,-1343,-0.631,9.200,31,31,267
1979,3222,3470,5081,418251,415629,298,5.859,308,6.056,41642,8824,32818,2.123,10.019,35814,10394,25420,2.501,8.617,5828,1.402,17.234,172,173,3617
1979,3231,29722,31053,632900,618240,3328,10.766,3047,9.857,90940,22256,68684,3.600,14.710,61459,25784,35675,4.171,9.941,29481,4.769,19.882,2153,2169,13193
1979,3241,1274,2096,155333,152312,201,9.703,152,7.338,13785,3437,10348,2.257,9.051,7768,1425,6343,0.936,5.100,6017,3.950,10.200,68,68,582
1979,3251,1018,2089,271063,269367,155,7.448,139,6.679,18276,3153,15123,1.171,6.785,14846,3812,11034,1.415,5.511,3430,1.273,11.023,39,42,481
1979,3252,384,613,164753,164153,39,6.321,47,7.618,9496,2417,7079,1.472,5.785,8276,1683,6593,1.025,5.042,1220,0.743,10.083,24,24,129
1979,3253,752,1142,55424,56432,79,6.837,106,9.174,5241,765,4476,1.356,9.287,7440,1506,5934,2.669,13.184,-2199,-3.897,18.575,40,40,300
1979,3254,867,1091,158204,155420,104,9.533,104,9.533,16184,4498,11686,2.894,10.413,10492,3359,7133,2.161,6.751,5692,3.662,13.501,56,56,1027
1979,3255,1645,2105,82374,80848,139,6.621,128,6.097,9772,1756,8016,2.172,12.087,6714,1789,4925,2.213,8.305,3058,3.782,16.609,67,67,417
1979,3256,2021,2285,121028,118258,204,8.926,205,8.970,15785,3177,12608,2.686,13.348,10221,2376,7845,2.009,8.643,5564,4.705,17.286,126,126,820
1979,3259,1528,2004,130539,128770,162,8.002,203,10.027,13038,3240,9798,2.516,10.125,9545,3200,6345,2.485,7.412,3493,2.713,14.825,112,112,856
1979,3261,9161,10600,552958,537101,1202,11.549,818,7.859,91955,19786,72169,3.684,17.121,59777,18065,41712,3.363,11.130,32178,5.991,22.259,514,522,8073
1979,3262,1723,2104,239637,236152,198,9.556,134,6.467,22701,3660,19041,1.550,9.613,15956,4381,11575,1.855,6.757,6745,2.856,13.513,77,77,1383
1979,3271,1256,1567,100328,99759,182,11.534,204,12.928,11593,2869,8724,2.876,11.621,10590,2859,7731,2.866,10.616,1003,1.005,21.231,152,153,1348
1979,3272,1346,1625,181841,183444,202,12.601,158,9.857,13793,2436,11357,1.328,7.519,16794,4510,12284,2.459,9.155,-3001,-1.636,15.038,111,113,1351
1979,3273,7462,9328,203635,196784,697,7.434,793,8.458,39643,8099,31544,4.116,20.145,25752,9176,16576,4.663,13.086,13891,7.059,26.173,477,521,4380
1979,3274,273,371,18070,17606,51,13.992,38,10.425,1910,630,1280,3.578,10.849,988,416,572,2.363,5.612,922,5.237,11.223,29,29,67
1979,3279,1963,2286,100373,97952,193,8.321,260,11.209,13502,2803,10699,2.862,13.784,8767,3059,5708,3.123,8.950,4735,4.834,17.901,164,165,934
1979,3311,379,480,426117,425991,41,8.428,54,11.100,24433,1352,23081,0.317,5.736,24402,3217,21185,0.755,5.728,31,0.007,11.457,30,30,605
1979,3312,529,706,99389,98100,52,7.482,30,4.317,8794,1238,7556,1.262,8.964,6159,1630,4529,1.662,6.278,2635,2.686,12.557,16,16,377
1979,3313,275,431,111240,109460,32,7.433,31,7.201,16146,7932,8214,7.247,14.751,13646,9971,3675,9.109,12.467,2500,2.284,24.933,5,5,36
1979,3314,729,954,124266,119074,86,8.944,101,10.504,17180,3469,13711,2.913,14.428,6734,2638,4096,2.215,5.655,10446,8.773,11.311,54,54,490
1979,3315,2824,3176,339832,327930,171,5.374,183,5.751,41169,7554,33615,2.304,12.554,17180,4911,12269,1.498,5.239,23989,7.315,10.478,110,110,1863
1979,3321,2791,2999,162613,158319,203,6.766,206,6.866,20578,3139,17439,1.983,12.998,11825,5096,6729,3.219,7.469,8753,5.529,14.938,125,125,2465
1979,3322,1145,1255,100335,98972,105,8.444,82,6.594,10453,2154,8299,2.176,10.562,7634,1769,5865,1.787,7.713,2819,2.848,15.427,42,44,852
1979,3323,9357,10177,375151,364958,913,9.022,799,7.895,61026,12263,48763,3.360,16.721,40431,11153,29278,3.056,11.078,20595,5.643,22.157,522,523,5226
1979,3324,1325,1733,173262,172135,115,6.638,114,6.580,18636,3755,14881,2.181,10.826,16573,5348,11225,3.107,9.628,2063,1.198,19.256,49,49,922
1979,3325,841,919,93202,91599,65,7.019,79,8.531,8616,855,7761,0.933,9.406,5531,1123,4408,1.226,6.038,3085,3.368,12.077,46,46,389
1979,3326,1543,1734,80094,76795,152,8.871,111,6.478,11510,2340,9170,3.047,14.988,4965,1356,3609,1.766,6.465,6545,8.523,12.931,63,63,452
1979,3327,18591,18906,349383,329027,2372,12.831,1532,8.287,70120,14347,55773,4.360,21.311,29413,12813,16600,3.894,8.939,40707,12.372,17.879,1040,1043,6308
1979,3328,5200,5483,130819,126358,435,7.933,436,7.951,22317,3901,18416,3.087,17.662,13505,5029,8476,3.980,10.688,8812,6.974,21.376,296,297,2904
1979,3329,4318,4828,397314,385332,511,10.625,474,9.855,50478,7830,42648,2.032,13.100,26485,9846,16639,2.555,6.873,23993,6.227,13.747,281,282,3006
1979,3331,2800,3230,424376,404096,347,10.780,325,10.096,66925,11908,55017,2.947,16.562,26567,11189,15378,2.769,6.574,40358,9.987,13.149,184,184,1761
1979,3332,3374,3622,193303,188489,244,6.695,289,7.930,23579,3208,20371,1.702,12.509,14023,4270,9753,2.265,7.440,9556,5.070,14.879,174,174,1777
1979,3333,1997,2118,162199,155946,181,8.609,150,7.134,24303,6077,18226,3.897,15.584,11727,3984,7743,2.555,7.520,12576,8.064,15.040,90,90,907
1979,3334,1638,1867,196869,191561,233,12.625,190,10.295,25812,4242,21570,2.214,13.475,15345,3308,12037,1.727,8.011,10467,5.464,16.021,125,125,1283
1979,3335,9527,9945,304013,292283,847,8.617,615,6.257,41587,6589,34998,2.254,14.228,18093,6110,11983,2.090,6.190,23494,8.038,12.380,392,393,3280
1979,3336,652,789,201146,197206,56,7.134,48,6.115,25381,6531,18850,3.312,12.870,16740,10787,5953,5.470,8.489,8641,4.382,16.977,21,21,198
1979,3339,5705,6219,393088,379637,498,8.055,425,6.874,52038,8749,43289,2.305,13.707,25391,7188,18203,1.893,6.688,26647,7.019,13.376,262,262,2815
1979,3341,880,1025,271100,252526,190,19.398,99,10.107,54898,11421,43477,4.523,21.740,17515,7118,10397,2.819,6.936,37383,14.804,13.872,60,60,2018
1979,3342,1522,1681,277839,266452,187,11.198,165,9.880,39454,7783,31671,2.921,14.807,17019,4484,12535,1.683,6.387,22435,8.420,12.775,92,92,2097
1979,3343,472,500,63571,65120,76,15.124,81,16.119,6293,1055,5238,1.620,9.664,9250,3203,6047,4.919,14.205,-2957,-4.541,19.328,61,61,298
1979,3344,3195,3609,422821,398588,514,14.577,348,9.870,72808,16585,56223,4.161,18.267,24723,9096,15627,2.282,6.203,48085,12.064,12.405,208,210,4266
1979,3345,3351,3838,550404,534483,385,10.106,328,8.610,69616,14078,55538,2.634,13.025,37452,13733,23719,2.569,7.007,32164,6.018,14.014,183,183,4157
1979,3346,593,619,25798,26700,91,14.630,97,15.595,3957,799,3158,2.993,14.820,5770,2152,3618,8.060,21.610,-1813,-6.790,29.640,74,74,1117
1979,3351,1174,1297,94308,92775,116,8.848,144,10.984,12922,2491,10431,2.685,13.928,9885,4373,5512,4.714,10.655,3037,3.274,21.310,92,92,1562
1979,3352,345,454,143350,148402,38,8.379,37,8.159,10021,2087,7934,1.406,6.753,20268,1685,18583,1.135,13.657,-10247,-6.905,13.505,19,19,149
1979,3353,1853,2303,301604,296028,193,8.402,181,7.880,32507,6781,25726,2.291,10.981,21118,5123,15995,1.731,7.134,11389,3.847,14.268,101,101,913
1979,3359,1610,2012,234386,225301,178,8.847,178,8.847,36604,9185,27419,4.077,16.247,18431,9085,9346,4.032,8.181,18173,8.066,16.361,86,86,2351
1979,3361,155,211,340145,328884,34,16.505,24,11.650,35418,285,35133,0.087,10.769,12281,216,12065,0.066,3.734,23137,7.035,7.468,20,20,130
1979,3362,1924,2166,154762,152870,249,11.485,253,11.670,22655,4810,17845,3.146,14.820,18909,4973,13936,3.253,12.369,3746,2.450,24.739,183,183,2152
1979,3363,3336,4081,810311,783888,401,9.720,490,11.877,87738,16273,71465,2.076,11.193,34816,10666,24150,1.361,4.441,52922,6.751,8.883,333,334,3247
1979,3364,1006,1198,610456,572931,98,8.160,104,8.659,85289,3315,81974,0.579,14.886,9599,4017,5582,0.701,1.675,75690,13.211,3.351,47,47,877
1979,3365,149,201,72934,66767,10,4.914,15,7.371,14156,408,13748,0.611,21.202,1806,400,1406,0.599,2.705,12350,18.497,5.410,5,5,85
1979,3366,1102,1198,204045,203183,171,14.615,115,9.829,26615,3698,22917,1.820,13.099,25220,3436,21784,1.691,12.412,1395,0.687,24.825,78,78,1638
1979,3369,409,426,33733,33871,60,13.986,66,15.385,3933,1195,2738,3.528,11.612,4163,1320,2843,3.897,12.291,-230,-0.679,23.224,43,43,528
1979,3371,11993,12578,401180,399373,1605,12.833,1462,11.690,53181,13097,40084,3.279,13.316,49579,17736,31843,4.441,12.414,3602,0.902,24.828,1089,1094,10569
1979,3372,2175,2290,120811,115289,248,10.956,195,8.615,20191,3130,17061,2.715,17.513,9312,3094,6218,2.684,8.077,10879,9.436,16.154,129,129,1513
1979,3379,1076,1222,40635,40423,102,8.395,88,7.243,5965,1540,4425,3.810,14.756,5283,2815,2468,6.964,13.069,682,1.687,26.139,56,57,2141
1979,3391,8543,9085,209298,204789,1168,13.007,957,10.658,33628,9081,24547,4.434,16.421,24686,9232,15454,4.508,12.054,8942,4.366,24.109,687,690,4183
1979,3399,14011,14671,476673,474200,1675,11.335,1887,12.770,69814,14856,54958,3.133,14.722,64700,21287,43413,4.489,13.644,5114,1.078,27.288,1361,1363,10160
1979,4231,18421,21935,271366,261636,2369,10.916,1905,8.778,48687,14708,33979,5.622,18.609,29284,11314,17970,4.324,11.193,19403,7.416,22.385,1286,1296,6042
1979,4232,6599,7667,88064,85342,992,13.187,703,9.345,18080,6543,11537,7.667,21.185,12792,3709,9083,4.346,14.989,5288,6.196,29.978,490,493,2116
1979,4233,7143,8944,117327,112938,1148,13.140,733,8.390,23187,6975,16212,6.176,20.531,14361,4653,9708,4.120,12.716,8826,7.815,25.432,489,495,2575
1979,4234,16505,22793,396173,384413,3131,14.041,2142,9.606,74886,28642,46244,7.451,19.481,51502,22438,29064,5.837,13.398,23384,6.083,26.795,1248,1282,6785
1979,4235,5769,8305,139060,134267,855,10.401,686,8.345,23571,5757,17814,4.288,17.555,13940,5495,8445,4.093,10.382,9631,7.173,20.765,338,340,2048
1979,4236,12213,17190,217425,211027,2230,13.188,1668,9.865,43935,15333,28602,7.266,20.820,31336,13307,18029,6.306,14.849,12599,5.970,29.699,946,979,4748
1979,4237,9827,12670,143654,139223,1247,10.001,845,6.777,23892,6535,17357,4.694,17.161,15192,5237,9955,3.762,10.912,8700,6.249,21.824,534,546,2934
1979,4238,42805,55856,663788,635494,5654,10.288,3861,7.025,124174,36526,87648,5.748,19.540,67494,26094,41400,4.106,10.621,56680,8.919,21.241,2340,2384,12029
1979,4239,19107,20837,219306,213563,2964,14.469,2261,11.037,47706,13931,33775,6.523,22.338,36427,12190,24237,5.708,17.057,11279,5.281,34.114,1634,1637,7850
1979,4241,6293,8748,125437,123392,890,10.295,684,7.912,20139,5646,14493,4.576,16.321,15822,7387,8435,5.987,12.823,4317,3.499,25.645,353,359,1945
1979,4242,2502,3237,89955,88343,410,12.769,358,11.149,13812,4297,9515,4.864,15.635,10321,4291,6030,4.857,11.683,3491,3.952,23.366,224,227,1915
1979,4243,8365,9180,95421,93642,1449,15.998,1204,13.293,24961,9696,15265,10.354,26.656,21213,7455,13758,7.961,22.653,3748,4.002,45.307,856,867,4385
1979,4244,26315,32245,544445,539990,3307,10.267,3234,10.041,92755,29080,63675,5.385,17.177,83801,33770,50031,6.254,15.519,8954,1.658,31.038,2237,2264,14992
1979,4245,8851,12043,110034,110282,766,6.343,833,6.898,18072,5124,12948,4.646,16.387,18504,5357,13147,4.858,16.779,-432,-0.392,32.774,503,519,3389
1979,4246,5505,8201,102120,98393,1021,12.721,671,8.360,21340,6674,14666,6.783,21.689,13971,5643,8328,5.735,14.199,7369,7.489,28.398,345,357,2061
1979,4247,12031,15824,149577,149657,1170,7.302,1569,9.792,28881,7942,20939,5.307,19.298,28946,10994,17952,7.346,19.342,-65,-0.043,38.596,820,845,3592
1979,4248,4804,5920,125626,123801,338,5.651,461,7.707,17398,3794,13604,3.065,14.053,13792,5154,8638,4.163,11.140,3606,2.913,22.281,323,331,3023
1979,4249,16969,20396,210230,207029,2417,11.916,2191,10.802,37901,11286,26615,5.451,18.307,31433,12603,18830,6.088,15.183,6468,3.124,30.366,1484,1497,6423
1979,4251,24765,27369,278877,270708,3261,12.170,2115,7.893,52916,17221,35695,6.361,19.547,36575,12430,24145,4.592,13.511,16341,6.036,27.022,1366,1368,6293
1979,4411,41340,42454,920226,900123,3928,9.267,3790,8.942,126472,34660,91812,3.851,14.051,86219,32198,54021,3.577,9.579,40253,4.472,19.157,3100,3120,25127
1979,4412,12634,13057,87814,85188,1552,11.865,1600,12.231,20347,6212,14135,7.292,23.885,15121,6626,8495,7.778,17.750,5226,6.135,35.501,1308,1321,5334
1979,4413,41504,56531,421176,408145,5721,10.238,4419,7.908,79413,26800,52613,6.566,19.457,53322,20589,32733,5.045,13.064,26091,6.393,26.129,2864,2945,12635
1979,4421,24187,27993,225977,220756,3197,11.577,2439,8.832,41659,14714,26945,6.665,18.871,31217,11328,19889,5.131,14.141,10442,4.730,28.282,1855,1888,7756
1979,4422,19098,21601,126642,122194,3584,17.052,2419,11.509,31124,13664,17460,11.182,25.471,22224,9421,12803,7.710,18.188,8900,7.284,36.375,1803,1830,6753
1979,4431,28273,38200,223241,216956,4638,12.233,4064,10.719,48319,19077,29242,8.793,22.271,35641,14989,20652,6.909,16.428,12678,5.844,32.856,2748,2825,9535
1979,4441,55480,69815,675264,654210,6593,9.560,4897,7.100,118093,38134,79959,5.829,18.051,76099,25031,51068,3.826,11.632,41994,6.419,23.264,3427,3465,15176
1979,4442,15741,19115,147199,142995,1896,9.982,1654,8.708,29519,8477,21042,5.928,20.643,21023,7642,13381,5.344,14.702,8496,5.941,29.404,1131,1152,4849
1979,4451,64025,95142,1597943,1552121,10989,11.572,10635,11.199,281842,119101,162741,7.673,18.159,188778,81485,107293,5.250,12.163,93064,5.996,24.325,7081,7185,34823
1979,4452,22000,26858,169289,165434,4093,15.208,4203,15.617,44445,19322,25123,11.680,26.866,36295,17729,18566,10.717,21.939,8150,4.926,43.879,2806,2905,11564
1979,4453,29025,34307,170220,168707,3665,10.723,3410,9.977,35810,12147,23663,7.200,21.226,32807,10972,21835,6.504,19.446,3003,1.780,38.892,2588,2612,8004
1979,4461,45857,62808,562150,544919,6987,11.381,4152,6.763,100251,37875,62376,6.951,18.397,64696,21548,43148,3.954,11.873,35555,6.525,23.745,2823,2858,12991
1979,4471,120320,158387,929816,935863,18884,11.746,23645,14.708,211565,87039,124526,9.300,22.606,223420,98742,124678,10.551,23.873,-11855,-1.267,45.213,16162,16401,61966
1979,4481,61076,94269,782632,769464,12635,13.673,8909,9.641,160619,72185,88434,9.381,20.874,134450,42248,92202,5.491,17.473,26169,3.401,34.946,5933,6127,23630
1979,4482,11946,31156,175560,167820,3643,11.949,2308,7.570,40950,16346,24604,9.740,24.401,26032,9146,16886,5.450,15.512,14918,8.889,31.024,992,1039,3857
1979,4483,16819,23457,137682,133415,2969,12.953,1897,8.276,28988,11527,17461,8.640,21.728,20252,7643,12609,5.729,15.180,8736,6.548,30.359,1291,1326,5196
1979,4511,31861,39591,238257,230369,6284,16.142,4961,12.744,58345,25094,33251,10.893,25.327,42632,17559,25073,7.622,18.506,15713,6.821,37.012,3514,3715,11444
1979,4512,7303,10008,64578,61978,1698,17.521,1064,10.979,15575,6640,8935,10.713,25.130,10412,3761,6651,6.068,16.800,5163,8.330,33.599,800,815,2593
1979,4522,561,6496,1132403,1126531,588,9.303,237,3.750,119689,55551,64138,4.931,10.625,104536,15513,89023,1.377,9.279,15153,1.345,18.559,22,32,959
1979,4523,17007,32656,838708,829705,2981,9.082,3318,10.108,111725,48672,63053,5.866,13.466,94093,29232,64861,3.523,11.341,17632,2.125,22.681,1762,1823,7432
1979,4531,19561,20698,100984,99361,3048,15.126,1953,9.692,21609,8384,13225,8.438,21.748,18424,6024,12400,6.063,18.543,3185,3.205,37.085,1477,1494,4513
1979,4532,21559,25286,149642,142633,4590,18.748,2984,12.188,38600,17657,20943,12.379,27.062,24414,9984,14430,7.000,17.117,14186,9.946,34.233,2242,2272,6915
1979,4533,7714,8895,39256,38373,1519,17.593,997,11.547,9405,4292,5113,11.185,24.510,7664,3087,4577,8.045,19.973,1741,4.537,39.945,763,764,2093
1979,4539,21050,24884,114504,110055,4288,17.574,3320,13.607,32088,13701,18387,12.449,29.156,23267,10327,12940,9.383,21.141,8821,8.015,42.282,2431,2472,7320
1979,4541,5220,6982,98327,93898,1048,15.393,701,10.296,21281,8850,12431,9.425,22.664,11965,4252,7713,4.528,12.743,9316,9.921,25.485,494,496,1995
1979,4542,4442,5590,81798,78108,617,11.100,554,9.967,15743,4762,10981,6.097,20.156,8451,3210,5241,4.110,10.820,7292,9.336,21.639,390,395,1351
1979,4543,18367,24114,210822,206999,2248,9.330,2208,9.164,38708,11209,27499,5.415,18.700,31341,11884,19457,5.741,15.141,7367,3.559,30.281,1623,1647,7206
1979,4811,984,2310,299089,285537,289,12.847,168,7.468,35319,5156,30163,1.806,12.369,8547,2778,5769,0.973,2.993,26772,9.376,5.987,92,92,503
1979,4812,365,503,7565,6646,123,26.032,62,13.122,2519,716,1803,10.774,37.905,642,325,317,4.891,9.661,1877,28.245,19.321,44,44,224
1979,4831,441,691,37101,36971,79,11.326,92,13.190,9593,3544,6049,9.586,25.948,9258,2897,6361,7.836,25.042,335,0.906,50.083,35,35,158
1979,4832,427,503,16154,15563,69,14.010,48,9.746,3493,1416,2077,9.099,22.445,2332,1034,1298,6.644,14.985,1161,7.460,29.969,30,30,262
1979,4841,21439,26495,567931,546710,5011,19.383,3725,14.409,111283,33927,77356,6.206,20.355,68802,24382,44420,4.460,12.585,42481,7.770,25.169,2782,2783,12827
1979,4842,39522,42989,561056,538765,7640,18.123,5974,14.171,123245,37363,85882,6.935,22.875,79135,29221,49914,5.424,14.688,44110,8.187,29.376,4683,4691,19919
1979,4851,421,468,22125,21608,47,10.195,33,7.158,2259,569,1690,2.633,10.455,1199,265,934,1.226,5.549,1060,4.906,11.098,27,27,159
1979,4852,300,643,30207,29535,25,3.867,32,4.950,2862,330,2532,1.117,9.690,1468,307,1161,1.039,4.970,1394,4.720,9.941,17,17,143
1979,4853,6407,6467,75284,77097,1077,16.754,1000,15.556,15583,5349,10234,6.938,20.212,18992,7163,11829,9.291,24.634,-3409,-4.422,40.425,858,862,6024
1979,4854,3779,3947,93312,90721,358,9.010,411,10.344,16804,4349,12455,4.794,18.523,11917,3609,8308,3.978,13.136,4887,5.387,26.272,358,358,3203
1979,4855,439,462,7904,7415,67,15.073,32,7.199,1768,417,1351,5.624,23.844,800,246,554,3.318,10.789,968,13.055,21.578,23,23,113
1979,4859,876,928,19087,18067,164,18.042,126,13.861,4311,1486,2825,8.225,23.862,2329,1065,1264,5.895,12.891,1982,10.971,25.783,95,96,710
1979,4861,83,292,11020,11536,10,3.407,13,4.429,1075,95,980,0.824,9.319,2142,507,1635,4.395,18.569,-1067,-9.250,18.638,D,D,D
1979,4862,228,1009,52073,50657,105,10.870,19,1.967,4976,2551,2425,5.036,9.823,2241,259,1982,0.511,4.424,2735,5.399,8.848,9,9,77
1979,4869,65,266,7308,7119,22,8.397,14,5.344,1041,129,912,1.812,14.624,658,320,338,4.495,9.244,383,5.380,18.487,3,3,90
1979,4871,160,163,1583,1636,38,24.359,24,15.385,350,144,206,8.805,21.400,451,274,177,16.753,27.576,-101,-6.175,42.800,20,20,199
1979,4872,727,734,8379,8591,129,17.720,117,16.071,2014,760,1254,8.846,23.443,2448,688,1760,8.008,28.495,-434,-5.052,46.886,96,96,536
1979,4879,54,62,580,526,18,30.769,11,18.803,219,65,154,12.369,41.675,112,75,37,14.272,21.313,107,20.362,42.626,7,7,39
1979,4881,2064,2522,51185,48652,403,16.479,250,10.223,12598,5056,7542,10.392,25.894,7472,2636,4836,5.418,15.358,5126,10.536,30.716,189,189,873
1979,4882,279,353,14417,15281,60,17.804,28,8.309,3407,921,2486,6.027,22.296,5131,291,4840,1.904,33.579,-1724,-11.282,44.593,18,18,195
1979,4883,2092,2514,128559,125871,351,14.196,268,10.839,34343,8535,25808,6.781,27.284,28126,5437,22689,4.320,22.345,6217,4.939,44.690,157,157,1315
1979,4884,2551,3139,47490,46671,570,18.893,326,10.805,8495,3122,5373,6.689,18.202,6906,2141,4765,4.587,14.797,1589,3.405,29.594,211,211,1033
1979,4885,3738,5425,76277,74145,842,16.035,494,9.408,15057,4519,10538,6.095,20.308,10833,3730,7103,5.031,14.611,4224,5.697,29.221,283,301,2456
1979,4889,330,341,5777,5915,52,15.499,41,12.221,1449,678,771,11.463,24.499,1657,228,1429,3.855,28.016,-208,-3.517,48.998,30,30,158
1979,4921,1036,1517,57390,54172,312,21.174,225,15.270,9829,2497,7332,4.609,18.144,3457,1309,2148,2.416,6.382,6372,11.763,12.763,185,185,1032
1979,4922,709,709,4526,4318,310,44.254,293,41.827,1918,1097,821,25.405,44.419,1537,1041,496,24.108,35.595,381,8.824,71.190,259,259,946
1979,4931,6017,9235,395380,385736,878,9.659,587,6.458,70925,23787,47138,6.167,18.387,51435,11195,40240,2.902,13.334,19490,5.053,26.668,230,230,1685
1979,5111,12859,14413,591137,579517,1777,12.455,1486,10.415,68107,17816,50291,3.074,11.752,44662,14336,30326,2.474,7.707,23445,4.046,15.414,1103,1104,8931
1979,5112,3293,4090,69750,62949,1310,36.014,405,11.134,24654,11821,12833,18.779,39.165,11006,4892,6114,7.771,17.484,13648,21.681,34.968,234,237,1450
1979,5121,8333,13636,194161,188614,1924,14.200,1750,12.916,55419,16659,38760,8.832,29.382,43818,14487,29331,7.681,23.232,11601,6.151,46.463,884,904,6024
1979,5122,1171,1175,9724,8797,340,31.481,150,13.889,3695,1820,1875,20.689,42.003,1911,913,998,10.379,21.723,1784,20.280,43.447,113,113,686
1979,5151,5365,6293,178856,175142,634,10.243,427,6.899,26767,9830,16937,5.613,15.283,19316,6270,13046,3.580,11.029,7451,4.254,22.058,306,307,3906
1979,5152,4,4,28,22,D,D,D,D,15,D,D,D,68.182,1,D,D,D,4.545,14,63.636,9.091,D,D,D
1979,5173,2007,13768,951446,936562,384,2.730,983,6.988,172790,3162,169628,0.338,18.449,142907,24601,118306,2.627,15.259,29883,3.191,30.517,167,167,1025
1979,5174,513,843,23722,22415,114,14.022,54,6.642,5471,1572,3899,7.013,24.408,2870,1201,1669,5.358,12.804,2601,11.604,25.608,29,29,169
1979,5179,949,1979,54329,55287,231,11.901,155,7.986,9426,1394,8032,2.521,17.049,11624,1560,10064,2.822,21.025,-2198,-3.976,34.099,75,75,320
1979,5182,4836,6296,180443,172880,1059,17.229,760,12.365,41695,16250,25445,9.400,24.118,26863,13889,12974,8.034,15.539,14832,8.579,31.077,376,378,2820
1979,5191,2010,2395,26767,26128,266,11.372,154,6.584,3994,1337,2657,5.117,15.286,2753,820,1933,3.138,10.537,1241,4.750,21.073,110,110,644
1979,5211,19,48,23505,23472,0,0.000,0,0.000,647,0,647,0.000,2.756,629,0,629,0.000,2.680,18,0.077,5.360,0,0,0
1979,5221,21083,60238,1650466,1605286,3506,5.950,882,1.497,180394,47979,132415,2.989,11.237,90313,12592,77721,0.784,5.626,90081,5.612,11.252,440,442,4377
1979,5222,24449,45125,345118,334036,3858,8.663,2675,6.007,60725,21612,39113,6.470,18.179,38184,14222,23962,4.258,11.431,22541,6.748,22.862,1232,1244,5124
1979,5223,2625,2909,34067,32322,627,22.281,437,15.529,8103,3216,4887,9.950,25.070,4699,2454,2245,7.592,14.538,3404,10.532,29.076,327,329,1526
1979,5231,4180,7908,169741,161588,1313,17.296,680,8.957,35289,10973,24316,6.791,21.839,19039,8990,10049,5.564,11.782,16250,10.056,23.565,391,391,2020
1979,5232,91,101,4471,4187,13,13.198,8,8.122,621,59,562,1.409,14.833,56,35,21,0.836,1.338,565,13.496,2.675,6,6,32
1979,5239,9065,9379,78381,75116,1794,19.669,1278,14.012,22345,8455,13890,11.256,29.747,16003,6699,9304,8.918,21.304,6342,8.443,42.609,968,968,3117
1979,5241,6275,29706,1200567,1174203,4310,15.189,1648,5.808,163706,57602,106104,4.906,13.942,112987,26441,86546,2.252,9.622,50719,4.319,19.245,333,353,4887
1979,5242,86040,90230,939838,868523,11071,12.541,7174,8.126,252232,44980,207252,5.179,29.041,108105,29802,78303,3.431,12.447,144127,16.594,24.894,5250,5261,15923
1979,5259,593,798,6936,6917,70,8.766,71,8.892,1520,279,1241,4.034,21.975,1413,429,984,6.202,20.428,107,1.547,40.856,28,28,75
1979,5311,108407,110219,520207,508590,16140,14.783,14057,12.875,128108,57711,70397,11.347,25.189,104786,49873,54913,9.806,20.603,23322,4.586,41.207,11472,11492,35891
1979,5312,31309,32242,169066,161411,6589,21.314,3934,12.725,50901,20344,30557,12.604,31.535,35618,13729,21889,8.506,22.067,15283,9.468,44.133,3086,3092,9922
1979,5313,20645,21248,180794,171215,4254,20.884,2498,12.263,49255,18295,30960,10.685,28.768,29933,11708,18225,6.838,17.483,19322,11.285,34.965,1939,1940,7821
1979,5321,5612,9215,100321,88865,2147,24.956,923,10.729,34568,12902,21666,14.519,38.899,12236,5695,6541,6.409,13.769,22332,25.130,27.538,565,573,2761
1979,5322,7955,9253,85282,81348,1751,19.479,1223,13.606,24468,8874,15594,10.909,30.078,16607,7366,9241,9.055,20.415,7861,9.663,40.830,890,898,4697
1979,5323,1959,2128,16964,15525,404,19.990,190,9.401,5328,1898,3430,12.226,34.320,2466,937,1529,6.036,15.885,2862,18.435,31.769,133,133,573
1979,5324,3509,3865,42926,40953,693,18.694,377,10.170,12214,3614,8600,8.825,29.825,8389,2671,5718,6.522,20.485,3825,9.340,40.969,260,260,1304
1979,5331,875,934,10303,11029,154,16.117,197,20.617,2994,1255,1739,11.379,27.147,4588,3212,1376,29.123,41.599,-1594,-14.453,54.293,101,103,406
1979,5411,100304,103115,518455,497742,13708,13.593,9173,9.096,106523,39592,66931,7.954,21.401,64799,26737,38062,5.372,13.019,41724,8.383,26.037,6646,6686,19411
1979,5412,41938,44708,321935,301024,8053,18.777,4414,10.292,79534,36533,43001,12.136,26.421,37811,19163,18648,6.366,12.561,41723,13.860,25.122,3169,3250,13666
1979,5413,39226,42796,560245,526426,7490,18.264,3918,9.554,134511,43921,90590,8.343,25.552,66934,22816,44118,4.334,12.715,67577,12.837,25.430,2773,2794,13471
1979,5414,9911,10129,77522,72518,2325,24.353,1161,12.161,21532,9232,12300,12.731,29.692,11622,4680,6942,6.454,16.026,9910,13.666,32.053,887,888,3154
1979,5415,2563,3071,30184,26844,1608,61.941,658,25.347,13367,7456,5911,27.776,49.796,6587,4079,2508,15.195,24.539,6780,25.258,49.077,560,560,2434
1979,5416,15090,15673,146869,141204,3872,25.782,2562,17.060,45140,16851,28289,11.934,31.968,33701,14319,19382,10.141,23.867,11439,8.101,47.734,1976,1982,9734
1979,5417,4387,5452,363330,358759,706,12.977,683,12.554,44726,9589,35137,2.673,12.467,34774,11800,22974,3.289,9.693,9952,2.774,19.386,421,427,2807
1979,5418,17946,19663,246969,238112,3254,16.990,2234,11.664,54311,16726,37585,7.024,22.809,36426,13862,22564,5.822,15.298,17885,7.511,30.596,1667,1682,8696
1979,5419,22365,23969,182269,175516,3461,14.853,2125,9.120,37622,14167,23455,8.072,21.435,23802,8719,15083,4.968,13.561,13820,7.874,27.122,1580,1598,5861
1979,5511,20026,37773,2573911,2501924,4305,11.619,2862,7.724,463418,144587,318831,5.779,18.522,317598,78274,239324,3.129,12.694,145820,5.828,25.388,424,429,4563
1979,5611,4818,4993,62953,61721,784,15.480,927,18.304,16329,3900,12429,6.319,26.456,13880,6089,7791,9.865,22.488,2449,3.968,44.977,733,735,4080
1979,5612,218,267,14536,14833,36,12.565,75,26.178,3322,864,2458,5.825,22.397,3936,2469,1467,16.646,26.536,-614,-4.140,44.794,40,42,538
1979,5613,8879,11692,544242,503203,2559,23.124,1308,11.819,184840,56932,127908,11.314,36.733,101356,21805,79551,4.333,20.142,83484,16.591,40.284,881,891,9779
1979,5614,15037,16886,184861,175486,3037,18.666,1806,11.100,45057,15527,29530,8.848,25.676,26204,9654,16550,5.501,14.932,18853,10.743,29.865,1384,1394,5527
1979,5615,14433,16850,126990,118685,2845,17.709,1275,7.937,32465,13256,19209,11.169,27.354,15811,6742,9069,5.681,13.322,16654,14.032,26.644,834,855,3838
1979,5616,9311,11038,334460,318845,2485,23.796,1295,12.401,84966,29047,55919,9.110,26.648,54801,18096,36705,5.675,17.187,30165,9.461,34.375,959,962,10226
1979,5617,46683,49155,636261,611504,11769,24.957,7773,16.483,181280,63988,117292,10.464,29.645,131997,49062,82935,8.023,21.586,49283,8.059,43.171,6137,6157,33289
1979,5619,9461,10147,131485,119326,2535,26.990,1026,10.924,42372,16710,25662,14.004,35.509,18449,6401,12048,5.364,15.461,23923,20.048,30.922,756,757,4070
1979,5621,5378,5502,104378,98914,780,14.381,624,11.504,20844,4008,16836,4.052,21.073,9961,4103,5858,4.148,10.070,10883,11.002,20.141,493,493,2873
1979,5622,1824,2189,36114,34645,295,13.869,171,8.039,7272,2873,4399,8.293,20.990,4341,1324,3017,3.822,12.530,2931,8.460,25.060,118,119,676
1979,5629,3711,3896,34041,32431,672,17.731,460,12.137,9653,3221,6432,9.932,29.765,6417,2987,3430,9.210,19.787,3236,9.978,39.573,344,344,1806
1979,6111,12679,13029,330983,323021,617,4.699,822,6.260,42486,7400,35086,2.291,13.153,26720,8208,18512,2.541,8.272,15766,4.881,16.544,598,606,5138
1979,6112,456,530,30724,30373,42,8.124,16,3.095,3912,710,3202,2.338,12.880,3210,176,3034,0.579,10.569,702,2.311,21.138,12,12,136
1979,6113,1934,2175,777957,741847,122,5.640,98,4.531,111676,4487,107189,0.605,15.054,38502,2004,36498,0.270,5.190,73174,9.864,10.380,62,62,1287
1979,6114,1533,1699,25056,24364,311,18.673,244,14.650,5801,1905,3896,7.819,23.810,4401,1859,2542,7.630,18.064,1400,5.746,36.128,178,180,1058
1979,6115,4022,4469,45213,43025,657,15.133,402,9.259,11314,3870,7444,8.995,26.296,6968,2468,4500,5.736,16.195,4346,10.101,32.390,287,294,1654
1979,6116,10081,10534,104310,100251,2267,22.312,1520,14.960,27538,9987,17551,9.962,27.469,19304,6943,12361,6.926,19.256,8234,8.213,38.512,1210,1218,5175
1979,6117,821,832,7850,7623,182,22.567,131,16.243,2360,1092,1268,14.325,30.959,1908,1145,763,15.020,25.030,452,5.929,50.059,100,100,341
1979,6211,145914,150013,825337,793022,15226,10.383,8490,5.789,154166,60445,93721,7.622,19.440,90170,29119,61051,3.672,11.370,63996,8.070,22.741,6434,6460,21693
1979,6212,83744,85014,346967,332884,6524,7.810,3559,4.261,65544,19964,45580,5.997,19.690,37447,11468,25979,3.445,11.249,28097,8.440,22.499,2705,2714,8778
1979,6213,28931,29887,91385,85835,4541,15.817,2188,7.621,24553,11294,13259,13.158,28.605,13214,6056,7158,7.055,15.395,11339,13.210,30.789,1596,1607,4606
1979,6214,4080,5040,77176,73496,809,16.620,464,9.533,17639,5835,11804,7.939,24.000,10392,3680,6712,5.007,14.140,7247,9.860,28.279,277,281,2136
1979,6215,3630,4576,57969,56395,658,14.612,512,11.370,13430,5800,7630,10.285,23.814,10240,4139,6101,7.339,18.158,3190,5.657,36.316,319,327,2019
1979,6216,2190,2786,80723,75887,523,19.822,228,8.641,21562,6940,14622,9.145,28.413,11906,2756,9150,3.632,15.689,9656,12.724,31.378,142,143,1282
1979,6219,2105,2379,42240,40729,473,21.055,208,9.259,11098,4388,6710,10.774,27.249,8160,2633,5527,6.465,20.035,2938,7.214,40.070,148,148,1333
1979,6221,4314,5188,2658144,2606539,164,3.150,200,3.842,206524,27558,178966,1.057,7.923,104336,37803,66533,1.450,4.003,102188,3.920,8.006,124,127,22438
1979,6222,360,424,85103,82388,38,9.102,25,5.988,9665,1195,8470,1.450,11.731,4159,912,3247,1.107,5.048,5506,6.683,10.096,15,15,365
1979,6223,175,204,46050,44702,11,5.473,5,2.488,3775,253,3522,0.566,8.445,1134,194,940,0.434,2.537,2641,5.908,5.074,3,3,95
1979,6231,8371,10992,825443,807885,761,6.930,741,6.747,119759,41247,78512,5.106,14.824,84353,35654,48699,4.413,10.441,35406,4.383,20.882,513,556,24916
1979,6232,2890,3532,80869,76992,601,17.938,238,7.103,16262,6737,9525,8.750,21.122,8508,3461,5047,4.495,11.050,7754,10.071,22.101,181,184,2718
1979,6233,6244,7038,202110,197915,917,13.341,588,8.555,32263,10751,21512,5.432,16.301,23956,11930,12026,6.028,12.104,8307,4.197,24.208,410,426,8652
1979,6239,2320,2768,67804,65259,326,12.217,127,4.759,10882,3158,7724,4.839,16.675,5686,1638,4048,2.510,8.713,5196,7.962,17.426,80,80,947
1979,6241,10373,14186,222512,215048,1886,13.818,811,5.942,47583,14338,33245,6.667,22.127,32573,5393,27180,2.508,15.147,15010,6.980,30.294,497,501,2743
1979,6242,2948,3527,39691,37153,482,14.275,181,5.361,10417,2795,7622,7.523,28.038,5354,1498,3856,4.032,14.411,5063,13.627,28.821,118,119,823
1979,6243,3085,4541,218612,208742,702,16.051,367,8.391,51638,22582,29056,10.818,24.738,32534,6212,26322,2.976,15.586,19104,9.152,31.172,183,184,2142
1979,6244,23208,26929,233045,221663,4099,15.766,2238,8.608,56127,20928,35199,9.441,25.321,33408,11852,21556,5.347,15.072,22719,10.249,30.143,1646,1669,8161
1979,7111,4162,4201,50739,51491,856,20.716,718,17.377,14934,5367,9567,10.423,29.003,16679,5869,10810,11.398,32.392,-1745,-3.389,58.007,539,539,3405
1979,7112,1983,2067,52748,52730,387,18.828,364,17.709,12912,3279,9633,6.218,24.487,12732,2536,10196,4.809,24.146,180,0.341,48.291,268,268,2087
1979,7113,1823,1857,27070,25558,373,20.371,321,17.531,8800,3210,5590,12.560,34.431,5883,2759,3124,10.795,23.018,2917,11.413,46.036,227,227,2100
1979,7114,971,983,10647,10175,234,24.723,161,17.010,3774,1872,1902,18.398,37.091,2866,1288,1578,12.658,28.167,908,8.924,56.334,123,123,930
1979,7115,4589,4610,48732,37961,1630,39.688,624,15.194,30122,5606,24516,14.768,79.350,7868,3001,4867,7.905,20.727,22254,58.623,41.453,413,416,1610
1979,7121,1830,1937,31126,30328,172,9.012,115,6.026,4862,747,4115,2.463,16.031,3377,434,2943,1.431,11.135,1485,4.896,22.270,58,58,224
1979,7131,1430,1528,50397,50094,212,13.762,237,15.385,7470,2266,5204,4.523,14.912,6973,1296,5677,2.587,13.920,497,0.992,27.840,190,191,896
1979,7132,611,622,15921,15489,109,17.709,96,15.597,2881,816,2065,5.268,18.601,2000,1097,903,7.083,12.913,881,5.688,25.826,80,80,932
1979,7139,27692,29088,415293,403784,3772,13.153,2953,10.297,84811,28508,56303,7.060,21.004,61932,20312,41620,5.030,15.338,22879,5.666,30.676,2219,2234,15067
1979,7211,29710,33443,997636,975117,4755,14.298,4384,13.182,213020,86029,126991,8.822,21.846,168705,72929,95776,7.479,17.301,44315,4.545,34.602,3210,3252,45680
1979,7212,3365,3573,18404,18232,517,14.500,502,14.079,5120,1745,3375,9.571,28.083,4768,1993,2775,10.932,26.153,352,1.931,52.305,325,326,1162
1979,7213,5757,5830,35210,35259,417,7.065,562,9.521,5409,1444,3965,4.095,15.341,5507,2263,3244,6.418,15.619,-98,-0.278,30.682,436,436,1886
1979,7223,12195,14854,258423,249989,2694,18.441,2204,15.087,66309,32140,34169,12.857,26.525,49980,20350,29630,8.140,19.993,16329,6.532,39.986,1635,1640,12174
1979,7224,66539,67285,360394,357636,10250,15.154,10958,16.201,102951,49799,53152,13.925,28.787,97641,44954,52687,12.570,27.302,5310,1.485,54.604,8463,8485,34590
1979,7225,176832,226818,3875231,3760737,40205,18.063,31726,14.254,1001917,542319,459598,14.421,26.642,776124,315871,460253,8.399,20.638,225793,6.004,41.275,22296,22692,199252
1979,8111,86241,89535,441095,422755,16181,18.573,11350,13.028,119077,52899,66178,12.513,28.167,82167,37849,44318,8.953,19.436,36910,8.731,38.872,8749,8803,28891
1979,8112,10106,11139,61936,60832,1465,13.085,1579,14.103,12302,4795,7507,7.882,20.223,10127,4357,5770,7.162,16.648,2175,3.575,33.295,1243,1244,3207
1979,8113,16841,17983,140576,133533,2690,15.282,1929,10.959,33574,10625,22949,7.957,25.143,19471,8045,11426,6.025,14.581,14103,10.561,29.163,1483,1487,5733
1979,8114,21107,22737,143011,138827,3778,16.854,3137,13.994,31899,13157,18742,9.477,22.978,23445,9419,14026,6.785,16.888,8454,6.090,33.776,2406,2417,6829
1979,8121,83070,90637,409866,403340,13298,14.815,11546,12.863,96511,46618,49893,11.558,23.928,84240,35002,49238,8.678,20.886,12271,3.042,41.771,9044,9123,25486
1979,8122,17632,19933,111150,109968,1556,7.883,1166,5.907,17359,5382,11977,4.894,15.786,14893,3771,11122,3.429,13.543,2466,2.242,27.086,777,795,2589
1979,8123,34148,39654,346604,344132,4090,10.269,4440,11.148,54737,18316,36421,5.322,15.906,49777,20633,29144,5.996,14.465,4960,1.441,28.929,3431,3518,15349
1979,8129,12021,17839,180456,171998,3584,20.892,2216,12.918,43895,20007,23888,11.632,25.521,27462,11918,15544,6.929,15.967,16433,9.554,31.933,1232,1277,6425
1979,8131,69219,69302,639326,615663,3869,5.653,2154,3.147,104645,15247,89398,2.477,16.997,57058,8472,48586,1.376,9.268,47587,7.729,18.535,1046,1046,3501
1979,8132,6696,7437,115327,112970,785,10.705,577,7.869,25556,8088,17468,7.159,22.622,20753,4575,16178,4.050,18.370,4803,4.252,36.741,379,381,2573
1979,8133,6217,7222,94941,93108,983,13.940,642,9.104,21380,6464,14916,6.942,22.963,17674,4939,12735,5.305,18.982,3706,3.980,37.965,403,407,3068
1979,8134,27836,29025,234917,231298,2765,9.747,1453,5.122,38043,7775,30268,3.361,16.448,30972,5897,25075,2.550,13.391,7071,3.057,26.781,1006,1006,3801
1979,8139,54316,56354,420037,417212,4896,8.789,3604,6.469,81899,18031,63868,4.322,19.630,76005,13972,62033,3.349,18.217,5894,1.413,36.435,2490,2497,8939
1980,1131,203,209,2542,2634,34,16.425,30,14.493,283,125,158,4.747,10.746,458,145,313,5.506,17.391,-175,-6.645,21.492,20,20,117
1980,1132,101,117,1453,1513,17,14.592,16,13.734,471,107,364,7.072,31.130,592,160,432,10.575,39.128,-121,-7.997,62.260,11,11,143
1980,1133,11477,11603,99010,100443,1886,16.123,2075,17.739,21117,7716,13401,7.682,21.024,24148,8326,15822,8.289,24.041,-3031,-3.018,42.048,1594,1594,6161
1980,1141,1490,1521,11078,11115,300,19.763,294,19.368,3641,1396,2245,12.560,32.758,3713,1229,2484,11.057,33.405,-72,-0.648,65.515,208,208,764
1980,1142,159,160,720,640,43,28.667,23,15.333,290,167,123,26.094,45.313,143,65,78,10.156,22.344,147,22.969,44.688,18,18,56
1980,1151,4236,4608,53553,52330,602,13.151,541,11.819,14987,4808,10179,9.188,28.639,12604,3492,9112,6.673,24.086,2383,4.554,48.171,398,398,2109
1980,1152,1615,1640,9724,9616,246,14.735,305,18.269,2199,865,1334,8.996,22.869,1972,1002,970,10.421,20.509,227,2.361,41.017,246,246,770
1980,1153,713,728,9164,9234,154,21.844,108,15.319,2621,1129,1492,12.227,28.384,2766,813,1953,8.804,29.955,-145,-1.570,56.768,86,86,679
1980,2111,6049,7842,137411,132908,1106,14.524,652,8.562,27162,8437,18725,6.348,20.437,18062,4991,13071,3.755,13.590,9100,6.847,27.180,369,374,1538
1980,2121,2918,3691,232572,240030,614,16.239,794,21.000,34945,14011,20934,5.837,14.559,50012,14703,35309,6.125,20.836,-15067,-6.277,29.117,612,618,8090
1980,2122,531,711,85320,82612,170,25.167,99,14.656,11825,3558,8267,4.307,14.314,6273,2298,3975,2.782,7.593,5552,6.721,15.187,50,51,261
1980,2123,3706,5146,114854,116682,454,8.797,484,9.378,15637,4242,11395,3.636,13.401,19616,4980,14636,4.268,16.812,-3979,-3.410,26.803,261,279,2289
1980,2131,8260,9506,285890,267590,2013,22.308,1048,11.614,83056,26234,56822,9.804,31.039,46441,18615,27826,6.957,17.355,36615,13.683,34.711,697,708,9476
1980,2211,1547,5620,529847,522981,186,3.334,104,1.864,28718,5840,22878,1.117,5.491,14910,3585,11325,0.685,2.851,13808,2.640,5.702,32,32,268
1980,2212,532,2314,134204,133160,105,4.541,102,4.411,9474,3422,6052,2.570,7.115,7572,1890,5682,1.419,5.686,1902,1.428,11.373,36,37,142
1980,2213,3972,4281,34938,34978,285,6.654,289,6.748,4846,2014,2832,5.758,13.854,4931,2381,2550,6.807,14.097,-85,-0.243,27.709,212,212,752
1980,2361,105206,105535,608270,634377,21851,20.302,26041,24.195,192669,87165,105504,13.740,30.371,244934,98617,146317,15.546,38.610,-52265,-8.239,60.743,20166,20169,75740
1980,2362,32704,33209,617763,621251,4812,14.301,5692,16.916,147020,29317,117703,4.719,23.665,153755,34875,118880,5.614,24.749,-6735,-1.084,47.330,4385,4386,24320
1980,2371,13585,13899,327601,328823,1557,11.193,1581,11.365,65697,14029,51668,4.266,19.979,68505,13361,55144,4.063,20.833,-2808,-0.854,39.959,1142,1144,7926
1980,2372,7732,7880,69205,68256,2204,29.204,1538,20.379,23303,11412,11891,16.719,34.141,21542,8073,13469,11.828,31.561,1761,2.580,63.121,1159,1159,5477
1980,2373,10937,11209,242750,244852,1014,8.976,1190,10.534,51326,8629,42697,3.524,20.962,55782,11370,44412,4.644,22.782,-4456,-1.820,41.924,831,835,7033
1980,2379,4541,4602,106772,110023,811,17.537,856,18.510,23808,4470,19338,4.063,21.639,29748,4877,24871,4.433,27.038,-5940,-5.399,43.278,648,648,2894
1980,2381,66725,67129,573096,586822,9757,14.282,12129,17.755,151268,44798,106470,7.634,25.778,178967,51749,127218,8.819,30.498,-27699,-4.720,51.555,9240,9240,39816
1980,2382,96599,98274,1008939,1005205,12361,12.625,11636,11.884,214429,53620,160809,5.334,21.332,206341,54244,152097,5.396,20.527,8088,0.805,41.055,9079,9084,39050
1980,2383,69001,69399,523792,532948,11445,16.228,13701,19.427,141314,46400,94914,8.706,26.516,160038,51596,108442,9.681,30.029,-18724,-3.513,53.031,10665,10665,40046
1980,2389,34024,34206,347560,352432,5543,16.272,5259,15.439,83612,23847,59765,6.766,23.724,93722,23527,70195,6.676,26.593,-10110,-2.869,47.449,3952,3952,17067
1980,3111,1437,2112,60746,61299,118,5.541,153,7.185,7198,2190,5008,3.573,11.743,8461,2733,5728,4.459,13.803,-1263,-2.060,23.485,87,89,1147
1980,3112,512,872,79793,80635,46,5.266,49,5.610,5264,1665,3599,2.065,6.528,6922,1634,5288,2.026,8.584,-1658,-2.056,13.056,22,22,276
1980,3113,1206,1581,92426,92662,137,8.704,123,7.814,8461,2077,6384,2.241,9.131,8869,1475,7394,1.592,9.571,-408,-0.440,18.262,70,72,386
1980,3114,1253,1778,190863,192692,105,5.859,133,7.422,20155,5405,14750,2.805,10.460,23770,4285,19485,2.224,12.336,-3615,-1.876,20.919,77,77,1187
1980,3115,1975,2774,146977,150180,110,3.868,249,8.757,11083,1782,9301,1.187,7.380,17452,5083,12369,3.385,11.621,-6369,-4.241,14.760,165,165,2180
1980,3116,4416,5020,329560,329996,367,7.239,466,9.192,36585,8413,28172,2.549,11.086,37112,16150,20962,4.894,11.246,-527,-0.160,22.173,327,330,5090
1980,3117,729,849,47048,48402,61,7.056,92,10.642,5820,1306,4514,2.698,12.024,8484,1958,6526,4.045,17.528,-2664,-5.504,24.049,61,62,729
1980,3118,7896,9484,300826,305533,1145,12.116,1078,11.407,31798,10822,20976,3.542,10.407,40973,16093,24880,5.267,13.410,-9175,-3.003,20.815,765,772,8372
1980,3119,1984,2370,119632,119854,195,8.238,189,7.985,15889,3299,12590,2.753,13.257,16174,6282,9892,5.241,13.495,-285,-0.238,26.514,114,116,1495
1980,3121,2187,2780,187261,188301,160,5.697,217,7.727,15985,4240,11745,2.252,8.489,17943,5498,12445,2.920,9.529,-1958,-1.040,16.978,135,135,2212
1980,3122,130,191,45403,46701,12,6.218,16,8.290,2411,465,1946,0.996,5.163,4917,308,4609,0.660,10.529,-2506,-5.366,10.325,8,8,25
1980,3131,459,716,123705,125377,58,8.112,56,7.832,9212,2802,6410,2.235,7.347,12482,4414,8068,3.521,9.956,-3270,-2.608,14.695,30,30,1585
1980,3132,1772,2216,363536,364859,170,7.654,180,8.104,24873,5460,19413,1.496,6.817,27547,7513,20034,2.059,7.550,-2674,-0.733,13.634,127,127,1486
1980,3133,3482,3921,153698,156144,304,7.870,188,4.867,14296,3469,10827,2.222,9.156,19020,5316,13704,3.405,12.181,-4724,-3.025,18.311,96,98,1340
1980,3141,4414,4715,128341,131813,525,11.006,635,13.312,13535,2899,10636,2.199,10.268,20548,6241,14307,4.735,15.589,-7013,-5.320,20.537,521,525,3167
1980,3149,3359,3492,132486,134837,372,10.559,434,12.319,18242,5610,12632,4.161,13.529,23117,8450,14667,6.267,17.144,-4875,-3.615,27.058,334,334,5382
1980,3151,1415,1551,142413,141784,141,9.100,138,8.906,16193,3503,12690,2.471,11.421,15089,5381,9708,3.795,10.642,1104,0.779,21.285,105,106,2927
1980,3152,13366,15239,980840,995743,1839,11.984,2052,13.372,130592,44716,85876,4.491,13.115,160345,56748,103597,5.699,16.103,-29753,-2.988,26.230,1618,1629,34736
1980,3159,1519,1630,63754,64487,180,11.026,185,11.332,8231,1731,6500,2.684,12.764,9713,3149,6564,4.883,15.062,-1482,-2.298,25.528,153,153,2070
1980,3161,368,413,20676,21772,26,6.198,39,9.297,1798,455,1343,2.090,8.258,3990,1062,2928,4.878,18.326,-2192,-10.068,16.517,30,30,607
1980,3162,502,750,142516,146922,46,6.005,78,10.183,13112,2380,10732,1.620,8.924,21849,9332,12517,6.352,14.871,-8737,-5.947,17.849,45,46,3054
1980,3169,1365,1420,67021,67989,137,9.641,139,9.782,8451,2400,6051,3.530,12.430,10214,2632,7582,3.871,15.023,-1763,-2.593,24.860,109,110,1840
1980,3211,5601,6175,163426,165981,730,11.827,725,11.746,21138,6559,14579,3.952,12.735,26038,7937,18101,4.782,15.687,-4900,-2.952,25.470,540,540,4698
1980,3212,1066,1351,90144,94889,140,10.456,116,8.663,7124,2355,4769,2.482,7.508,16623,4199,12424,4.425,17.518,-9499,-10.011,15.015,75,75,1396
1980,3219,8448,9237,292800,305641,1081,11.756,998,10.853,34199,11012,23187,3.603,11.189,59923,17196,42727,5.626,19.606,-25724,-8.416,22.379,743,744,8281
1980,3221,361,747,215515,213956,35,4.682,36,4.816,12480,1431,11049,0.669,5.833,9606,1727,7879,0.807,4.490,2874,1.343,8.979,22,22,209
1980,3222,3449,5039,418702,418550,290,5.730,334,6.599,36710,7762,28948,1.854,8.771,36501,9005,27496,2.151,8.721,209,0.050,17.442,205,206,3454
1980,3231,30698,32064,641824,637347,3686,11.686,2644,8.382,78123,21578,56545,3.386,12.258,69527,21715,47812,3.407,10.909,8596,1.349,21.818,2067,2073,14174
1980,3241,1307,2088,145593,150600,200,9.563,207,9.897,9376,2710,6666,1.799,6.226,19706,4956,14750,3.291,13.085,-10330,-6.859,12.452,59,78,920
1980,3251,1033,2117,279598,275022,158,7.544,113,5.395,25212,9032,16180,3.284,9.167,15709,3615,12094,1.314,5.712,9503,3.455,11.424,48,48,558
1980,3252,384,623,160884,162913,56,9.069,45,7.287,7623,1388,6235,0.852,4.679,11533,2607,8926,1.600,7.079,-3910,-2.400,9.358,31,31,340
1980,3253,767,1150,56249,55681,92,8.045,79,6.909,6840,1493,5347,2.681,12.284,5649,2064,3585,3.707,10.145,1191,2.139,20.291,43,43,573
1980,3254,893,1122,159516,159005,121,10.916,94,8.480,12963,2783,10180,1.750,8.153,12006,2084,9922,1.311,7.551,957,0.602,15.101,51,52,735
1980,3255,1674,2136,80607,81529,139,6.549,112,5.277,6560,1925,4635,2.361,8.046,8413,1860,6553,2.281,10.319,-1853,-2.273,16.093,61,61,380
1980,3256,2007,2267,119555,119687,186,8.194,192,8.458,11756,2575,9181,2.151,9.822,12012,2729,9283,2.280,10.036,-256,-0.214,19.645,131,131,1094
1980,3259,1561,2039,99648,99343,181,8.976,136,6.744,8715,1719,6996,1.730,8.773,8165,1853,6312,1.865,8.219,550,0.554,16.438,81,82,937
1980,3261,9371,10825,535191,544130,1126,10.508,908,8.473,69040,20117,48923,3.697,12.688,86894,23429,63465,4.306,15.969,-17854,-3.281,25.376,619,625,9844
1980,3262,1740,2126,214467,226874,172,8.121,156,7.365,14866,4903,9963,2.161,6.553,40631,12325,28306,5.433,17.909,-25765,-11.357,13.105,97,97,603
1980,3271,1330,1637,98113,99378,218,13.557,160,9.950,10040,2977,7063,2.996,10.103,12563,2353,10210,2.368,12.642,-2523,-2.539,20.206,125,127,1271
1980,3272,1409,1689,176844,179672,208,12.549,145,8.748,11650,2246,9404,1.250,6.484,17294,2265,15029,1.261,9.625,-5644,-3.141,12.968,105,105,661
1980,3273,7381,9215,192233,198382,623,6.723,727,7.845,23189,6498,16691,3.275,11.689,35490,9118,26372,4.596,17.890,-12301,-6.201,23.378,469,476,3853
1980,3274,264,349,17067,17479,47,13.128,65,18.156,1495,623,872,3.564,8.553,2398,1503,895,8.599,13.720,-903,-5.166,17.107,39,39,271
1980,3279,1947,2259,96480,98471,202,8.907,220,9.700,8789,3017,5772,3.064,8.926,12915,4217,8698,4.283,13.116,-4126,-4.190,17.851,140,141,1194
1980,3311,404,498,409911,415980,59,12.090,39,7.992,16568,2253,14315,0.542,3.983,28108,6322,21786,1.520,6.757,-11540,-2.774,7.966,25,25,945
1980,3312,537,718,94115,96482,49,6.882,37,5.197,6442,1829,4613,1.896,6.677,11063,2731,8332,2.831,11.466,-4621,-4.790,13.354,23,23,793
1980,3313,287,447,113873,112966,39,8.904,21,4.795,8730,1873,6857,1.658,7.728,6920,1773,5147,1.570,6.126,1810,1.602,12.252,9,9,212
1980,3314,752,972,126965,125403,93,9.688,69,7.188,13601,2990,10611,2.384,10.846,10468,2518,7950,2.008,8.347,3133,2.498,16.695,32,32,287
1980,3315,2865,3234,317376,328950,201,6.268,147,4.584,22380,4727,17653,1.437,6.803,46145,4310,41835,1.310,14.028,-23765,-7.225,13.607,106,106,1930
1980,3321,2850,3071,163743,162840,248,8.181,169,5.575,17965,4294,13671,2.637,11.032,16213,2830,13383,1.738,9.956,1752,1.076,19.913,125,125,1588
1980,3322,1145,1266,100142,100088,102,8.105,87,6.913,8459,2266,6193,2.264,8.452,8394,1544,6850,1.543,8.387,65,0.065,16.773,61,61,746
1980,3323,9525,10349,372577,374129,952,9.267,801,7.797,49998,12276,37722,3.281,13.364,53027,13222,39805,3.534,14.173,-3029,-0.810,26.728,597,602,8047
1980,3324,1384,1787,169762,171674,156,8.851,107,6.071,14626,4055,10571,2.362,8.520,18263,4676,13587,2.724,10.638,-3637,-2.119,17.039,58,58,1088
1980,3325,850,933,88990,91189,83,8.968,68,7.347,7134,2115,5019,2.319,7.823,11580,2112,9468,2.316,12.699,-4446,-4.876,15.647,50,50,456
1980,3326,1569,1764,77498,78745,137,7.802,121,6.891,8720,2195,6525,2.787,11.074,11381,2108,9273,2.677,14.453,-2661,-3.379,22.147,82,82,779
1980,3327,19722,20033,354978,352403,2694,13.846,1543,7.930,53187,14018,39169,3.978,15.093,48147,14289,33858,4.055,13.663,5040,1.430,27.325,1187,1189,8224
1980,3328,5256,5545,127131,129169,447,8.103,390,7.070,17521,5278,12243,4.086,13.564,21497,5176,16321,4.007,16.643,-3976,-3.078,27.129,279,281,3424
1980,3329,4541,5058,397373,398197,582,11.771,355,7.180,36102,5831,30271,1.464,9.066,38010,8900,29110,2.235,9.546,-1908,-0.479,18.133,231,231,2936
1980,3331,2946,3390,412324,418033,405,12.226,250,7.547,43530,12461,31069,2.981,10.413,55506,16434,39072,3.931,13.278,-11976,-2.865,20.826,158,159,1930
1980,3332,3443,3697,196862,195073,305,8.360,208,5.701,23912,4671,19241,2.394,12.258,20250,9301,10949,4.768,10.381,3662,1.877,20.762,130,130,1487
1980,3333,2004,2130,162555,161845,165,7.770,152,7.158,16311,2510,13801,1.551,10.078,14740,3655,11085,2.258,9.107,1571,0.971,18.215,106,106,1415
1980,3334,1771,2005,191435,194267,285,14.710,150,7.742,19832,3723,16109,1.916,10.209,25760,5891,19869,3.032,13.260,-5928,-3.051,20.417,100,100,1283
1980,3335,9770,10202,312764,308162,864,8.580,599,5.949,36299,6518,29781,2.115,11.779,27217,7717,19500,2.504,8.832,9082,2.947,17.664,442,443,4104
1980,3336,653,797,194074,197453,55,6.962,41,5.190,10955,3125,7830,1.583,5.548,17902,2449,15453,1.240,9.066,-6947,-3.518,11.096,23,23,1185
1980,3339,5769,6299,401225,397529,507,8.099,429,6.853,45756,11422,34334,2.873,11.510,38289,12403,25886,3.120,9.632,7467,1.878,19.264,289,289,3856
1980,3341,945,1121,315023,293812,206,19.172,113,10.517,66309,17006,49303,5.788,22.569,24551,10221,14330,3.479,8.356,41758,14.212,16.712,67,67,3440
1980,3342,1559,1734,295699,287138,206,12.079,149,8.736,37667,5919,31748,2.061,13.118,20093,8440,11653,2.939,6.998,17574,6.120,13.995,94,94,1522
1980,3343,463,491,64256,64363,68,13.710,78,15.726,7729,2762,4967,4.291,12.009,8050,2004,6046,3.114,12.507,-321,-0.499,24.017,57,57,923
1980,3344,3376,3824,462886,443020,591,15.930,363,9.784,76157,22886,53271,5.166,17.190,35856,12776,23080,2.884,8.094,40301,9.097,16.187,247,247,5732
1980,3345,3462,3985,586060,567944,440,11.240,299,7.638,72413,16027,56386,2.822,12.750,35616,11706,23910,2.061,6.271,36797,6.479,12.542,191,192,3220
1980,3346,576,598,22289,23977,93,15.296,113,18.586,2364,1263,1101,5.268,9.859,5843,1524,4319,6.356,24.369,-3479,-14.510,19.719,83,83,906
1980,3351,1205,1328,90451,92034,125,9.495,102,7.748,8348,2406,5942,2.614,9.071,11345,2158,9187,2.345,12.327,-2997,-3.256,18.141,72,72,922
1980,3352,343,451,150208,146939,45,10.011,42,9.344,13115,1764,11351,1.200,8.925,6520,1048,5472,0.713,4.437,6595,4.488,8.874,24,24,267
1980,3353,1871,2344,302732,301989,219,9.460,161,6.955,33645,8865,24780,2.936,11.141,32121,9276,22845,3.072,10.636,1524,0.505,21.273,99,100,1818
1980,3359,1620,2017,232392,233587,153,7.612,139,6.915,24622,6420,18202,2.748,10.541,26962,7616,19346,3.260,11.543,-2340,-1.002,21.082,81,82,1603
1980,3361,178,236,265280,302753,41,17.982,25,10.965,12992,5800,7192,1.916,4.291,88085,6052,82033,1.999,29.095,-75093,-24.803,8.583,20,20,252
1980,3362,1780,1990,116040,134412,193,9.346,343,16.610,9785,3220,6565,2.396,7.280,46472,8548,37924,6.360,34.574,-36687,-27.295,14.560,253,254,3980
1980,3363,3366,4118,662387,735477,408,9.969,357,8.723,28378,9401,18977,1.278,3.858,174390,12387,162003,1.684,23.711,-146012,-19.853,7.717,253,253,3668
1980,3364,1053,1251,667006,638448,133,10.866,79,6.454,77063,4960,72103,0.777,12.070,20594,9415,11179,1.475,3.226,56469,8.845,6.451,48,48,423
1980,3365,154,203,77602,75064,20,9.926,17,8.437,9894,567,9327,0.755,13.181,4985,755,4230,1.006,6.641,4909,6.540,13.282,6,6,297
1980,3366,1123,1230,201565,202015,150,12.386,112,9.249,23112,3601,19511,1.783,11.441,23287,1949,21338,0.965,11.527,-175,-0.087,22.882,86,86,979
1980,3369,402,418,33352,33503,57,13.636,57,13.636,4096,514,3582,1.534,12.226,4417,727,3690,2.170,13.184,-321,-0.958,24.452,44,44,417
1980,3371,12144,12753,387157,394203,1634,12.872,1516,11.943,43829,15778,28051,4.003,11.118,57898,17144,40754,4.349,14.687,-14069,-3.569,22.237,1184,1188,10661
1980,3372,2192,2310,118992,119225,236,10.274,210,9.142,12069,1930,10139,1.619,10.123,12649,2946,9703,2.471,10.609,-580,-0.486,20.246,164,164,1598
1980,3379,1051,1195,39473,39932,97,8.077,109,9.076,4439,842,3597,2.109,11.117,5341,1241,4100,3.108,13.375,-902,-2.259,22.233,80,81,705
1980,3391,8851,9384,214189,212236,1206,13.062,904,9.791,28867,8497,20370,4.004,13.601,24776,8665,16111,4.083,11.674,4091,1.928,23.348,655,657,2808
1980,3399,13986,14655,458479,466179,1679,11.478,1626,11.115,60055,18771,41284,4.027,12.882,75662,19194,56468,4.117,16.230,-15607,-3.348,25.765,1275,1277,9461
1980,4231,18427,21960,257608,265097,2117,9.634,2147,9.770,30883,11114,19769,4.192,11.650,45649,14489,31160,5.466,17.220,-14766,-5.570,23.299,1484,1501,7147
1980,4232,6755,7810,87871,88252,950,12.265,821,10.600,13567,4382,9185,4.965,15.373,14320,4814,9506,5.455,16.226,-753,-0.853,30.746,567,572,2599
1980,4233,7298,9123,115218,116650,1055,11.653,916,10.118,17864,6066,11798,5.200,15.314,20707,6183,14524,5.300,17.751,-2843,-2.437,30.629,613,619,3530
1980,4234,17237,23725,409528,403148,3272,14.054,2385,10.244,68233,27615,40618,6.850,16.925,55554,26329,29225,6.531,13.780,12679,3.145,27.560,1359,1383,6727
1980,4235,5953,8447,140647,139683,834,9.951,702,8.376,19731,6596,13135,4.722,14.126,17757,6186,11571,4.429,12.712,1974,1.413,25.425,361,365,2304
1980,4236,12655,17754,225521,221913,2164,12.377,1623,9.283,41260,14524,26736,6.545,18.593,34168,13276,20892,5.983,15.397,7092,3.196,30.794,939,954,4566
1980,4237,10118,13036,144475,144185,1256,9.762,917,7.127,19774,6232,13542,4.322,13.714,19158,7068,12090,4.902,13.287,616,0.427,26.574,578,591,2830
1980,4238,43991,57263,686026,675861,5388,9.512,4152,7.330,106133,31237,74896,4.622,15.703,85894,29943,55951,4.430,12.709,20239,2.995,25.418,2546,2597,13297
1980,4239,20158,21878,221347,220484,3239,15.120,2328,10.867,40773,13412,27361,6.083,18.492,39089,12898,26191,5.850,17.729,1684,0.764,35.457,1719,1730,8371
1980,4241,6568,9050,132201,128862,926,10.393,646,7.250,19067,6083,12984,4.721,14.797,12416,4187,8229,3.249,9.635,6651,5.161,19.270,400,405,1949
1980,4242,2512,3223,91142,91000,358,11.078,375,11.605,11545,3755,7790,4.126,12.687,11342,5397,5945,5.931,12.464,203,0.223,24.927,242,246,1241
1980,4243,8406,9167,93759,95168,1330,14.483,1362,14.832,19871,7042,12829,7.400,20.880,22674,9898,12776,10.401,23.825,-2803,-2.945,41.760,991,995,4619
1980,4244,26088,31934,543000,545850,3082,9.587,3508,10.912,77002,23997,53005,4.396,14.107,82573,31102,51471,5.698,15.127,-5571,-1.021,28.214,2454,2493,15243
1980,4245,8781,11929,108118,109476,743,6.180,930,7.735,15655,4210,11445,3.846,14.300,18367,4895,13472,4.471,16.777,-2712,-2.477,28.600,588,607,3204
1980,4246,5685,8502,105215,104357,1020,12.208,727,8.701,17445,6218,11227,5.958,16.717,15592,4964,10628,4.757,14.941,1853,1.776,29.882,402,407,2195
1980,4247,11967,15653,147526,148382,1116,7.079,1339,8.494,22839,6508,16331,4.386,15.392,24572,7601,16971,5.123,16.560,-1733,-1.168,30.784,808,829,3871
1980,4248,4763,5856,128410,127451,341,5.787,415,7.042,15423,3332,12091,2.614,12.101,13451,5666,7785,4.446,10.554,1972,1.547,21.108,276,283,2667
1980,4249,17148,20533,212365,211805,2354,11.478,2304,11.235,35358,11143,24215,5.261,16.694,34204,12260,21944,5.788,16.149,1154,0.545,32.298,1621,1645,7452
1980,4251,25704,28358,283241,281579,3251,11.656,2317,8.307,47813,15844,31969,5.627,16.980,44591,14127,30464,5.017,15.836,3222,1.144,31.672,1481,1487,6701
1980,4411,40028,41082,826325,873550,3274,7.834,4690,11.223,70535,28563,41972,3.270,8.075,165115,40118,124997,4.593,18.902,-94580,-10.827,16.149,3787,3819,31638
1980,4412,12229,12646,79210,83700,1363,10.601,1786,13.891,14668,5310,9358,6.344,17.524,23706,8166,15540,9.756,28.323,-9038,-10.798,35.049,1433,1442,6177
1980,4413,41807,56764,401614,411924,5220,9.217,4962,8.761,57435,22957,34478,5.573,13.943,77596,25225,52371,6.124,18.837,-20161,-4.894,27.886,3116,3191,14138
1980,4421,24104,28134,223556,225143,2939,10.462,2855,10.163,35377,13584,21793,6.034,15.713,38407,12208,26199,5.422,17.059,-3030,-1.346,31.426,2161,2195,8810
1980,4422,19681,22470,130547,128684,3520,15.969,2666,12.095,28284,12471,15813,9.691,21.980,24531,9237,15294,7.178,19.063,3753,2.916,38.126,2033,2063,6801
1980,4431,28043,37887,220583,222234,4375,11.493,4731,12.429,41450,17075,24375,7.683,18.652,44847,18117,26730,8.152,20.180,-3397,-1.529,37.303,3095,3189,10559
1980,4441,56612,71324,673370,675561,6562,9.277,5376,7.601,97321,39380,57941,5.829,14.406,101774,29649,72125,4.389,15.065,-4453,-0.659,28.812,3774,3889,18783
1980,4442,15999,19369,146560,147412,1793,9.304,1596,8.282,22688,7475,15213,5.071,15.391,24453,6656,17797,4.515,16.588,-1765,-1.197,30.782,1136,1146,4162
1980,4451,63709,94982,1651806,1625958,10448,10.990,10613,11.164,262794,123105,139689,7.571,16.162,210733,81379,129354,5.005,12.961,52061,3.202,25.921,7041,7169,35738
1980,4452,22102,26954,167972,168785,3799,14.107,3749,13.922,38793,16902,21891,10.014,22.984,40314,15715,24599,9.311,23.885,-1521,-0.901,45.967,2705,2744,11135
1980,4453,28942,34256,172247,171216,3486,10.170,3528,10.293,33709,12252,21457,7.156,19.688,31651,10848,20803,6.336,18.486,2058,1.202,36.972,2702,2730,8082
1980,4461,46949,64706,568957,564819,6445,10.108,4556,7.145,89896,37115,52781,6.571,15.916,80554,24864,55690,4.402,14.262,9342,1.654,28.524,3030,3129,14957
1980,4471,115363,153495,862187,895819,15964,10.243,20675,13.266,167558,78497,89061,8.763,18.704,234745,84672,150073,9.452,26.205,-67187,-7.500,37.409,14061,14480,56209
1980,4481,60832,95865,769114,775930,12035,12.658,10458,11.000,135975,66744,69231,8.602,17.524,148956,49046,99910,6.321,19.197,-12981,-1.673,35.048,6963,7329,26062
1980,4482,12360,32978,178827,177394,4008,12.492,2220,6.919,35893,17871,18022,10.074,20.233,32326,8127,24199,4.581,18.223,3567,2.011,36.445,1150,1199,3869
1980,4483,17112,23733,152450,145357,2728,11.561,2454,10.400,40420,10275,30145,7.069,27.807,25102,9561,15541,6.578,17.269,15318,10.538,34.538,1452,1508,4982
1980,4511,32159,40249,244695,241711,6042,15.137,5377,13.471,56139,25004,31135,10.345,23.226,49451,18370,31081,7.600,20.459,6688,2.767,40.918,3898,4015,12365
1980,4512,7453,10391,68415,66697,1558,15.248,1211,11.852,15792,6562,9230,9.839,23.677,12012,4406,7606,6.606,18.010,3780,5.667,36.020,881,916,3232
1980,4522,550,6634,1114542,1123719,449,6.848,294,4.484,88427,50342,38085,4.480,7.869,108355,12717,95638,1.132,9.643,-19928,-1.773,15.738,18,20,667
1980,4523,16591,32152,838092,838633,2722,8.398,3243,10.005,94990,48801,46189,5.819,11.327,96216,28964,67252,3.454,11.473,-1226,-0.146,22.654,1807,1859,7503
1980,4531,20158,21374,102987,102361,2960,14.055,2331,11.069,21288,8480,12808,8.284,20.797,19963,6799,13164,6.642,19.503,1325,1.294,39.005,1775,1800,5198
1980,4532,22410,26531,155777,152553,4420,17.067,3153,12.175,35625,16617,19008,10.893,23.353,29269,11543,17726,7.567,19.186,6356,4.166,38.372,2482,2508,8216
1980,4533,7753,8965,39364,39256,1379,15.464,1284,14.399,8511,4041,4470,10.294,21.681,8266,3298,4968,8.401,21.057,245,0.624,42.114,1023,1028,2469
1980,4539,21900,25807,115288,115307,4336,17.073,3516,13.844,27746,13591,14155,11.787,24.063,27786,10545,17241,9.145,24.098,-40,-0.035,48.126,2598,2662,7859
1980,4541,5268,7040,92705,95234,908,12.966,834,11.909,15318,5711,9607,5.997,16.085,20424,6358,14066,6.676,21.446,-5106,-5.362,32.169,595,596,3276
1980,4542,4403,5556,83665,83022,548,9.845,568,10.205,13265,3656,9609,4.404,15.978,11860,3538,8322,4.262,14.285,1405,1.692,28.571,401,404,1664
1980,4543,17912,23552,206926,208935,1955,8.207,2491,10.458,30831,10252,20579,4.907,14.756,34864,13263,21601,6.348,16.687,-4033,-1.930,29.513,1754,1781,7428
1980,4811,1006,2374,314698,307030,294,12.535,237,10.104,33016,3915,29101,1.275,10.753,17276,1819,15457,0.592,5.627,15740,5.127,11.254,120,121,949
1980,4812,403,553,9314,8487,126,23.796,79,14.920,2223,963,1260,11.347,26.193,595,251,344,2.957,7.011,1628,19.182,14.021,55,55,192
1980,4831,435,695,37899,37325,91,13.256,74,10.779,9080,4289,4791,11.491,24.327,8217,2260,5957,6.055,22.015,863,2.312,44.030,32,32,516
1980,4832,418,481,17261,16493,52,10.623,69,14.096,3675,1295,2380,7.852,22.283,2188,1089,1099,6.603,13.267,1487,9.016,26.533,37,37,212
1980,4841,21600,26778,535646,551860,4405,16.523,4170,15.641,69672,26647,43025,4.829,12.625,102622,26640,75982,4.827,18.596,-32950,-5.971,25.250,3237,3259,14399
1980,4842,39564,43084,534264,547640,6925,16.090,6835,15.881,86654,30880,55774,5.639,15.823,113711,32537,81174,5.941,20.764,-27057,-4.941,31.646,5484,5505,23007
1980,4851,409,460,21652,21490,45,9.793,44,9.576,1938,527,1411,2.452,9.018,1619,724,895,3.369,7.534,319,1.484,15.067,32,32,433
1980,4852,319,699,30816,30755,57,8.352,24,3.516,2211,140,2071,0.455,7.189,2237,746,1491,2.426,7.274,-26,-0.085,14.378,18,18,677
1980,4853,6080,6136,68581,71823,901,14.323,1210,19.235,12064,4473,7591,6.228,16.797,18679,5856,12823,8.153,26.007,-6615,-9.210,33.594,1032,1032,4621
1980,4854,3738,3915,93605,93328,405,10.300,439,11.165,15542,4605,10937,4.934,16.653,14917,5167,9750,5.536,15.983,625,0.670,31.967,356,356,3040
1980,4855,480,504,8940,8708,56,11.133,54,10.736,1947,603,1344,6.925,22.359,1466,589,877,6.764,16.835,481,5.524,33.670,46,46,305
1980,4859,859,909,18820,19238,153,16.897,146,16.124,3438,1357,2081,7.054,17.871,4203,1942,2261,10.095,21.848,-765,-3.977,35.743,116,116,1003
1980,4861,88,302,10883,10895,26,8.739,17,5.714,1292,484,808,4.442,11.859,1304,309,995,2.836,11.969,-12,-0.110,23.717,3,3,41
1980,4862,235,1038,54570,53276,71,6.944,40,3.912,5261,1319,3942,2.476,9.875,2759,643,2116,1.207,5.179,2502,4.696,10.357,22,22,150
1980,4869,68,265,7063,7260,22,8.255,25,9.381,1023,325,698,4.477,14.091,1419,953,466,13.127,19.545,-396,-5.455,28.182,3,3,15
1980,4871,168,170,2158,1900,32,19.162,26,15.569,725,356,369,18.737,38.158,227,89,138,4.684,11.947,498,26.211,23.895,22,22,74
1980,4872,754,763,9663,8958,141,18.977,101,13.594,2883,1248,1635,13.932,32.184,1492,590,902,6.586,16.656,1391,15.528,33.311,77,77,338
1980,4879,54,64,564,574,13,20.472,12,18.898,186,80,106,13.949,32.432,194,33,161,5.754,33.827,-8,-1.395,64.865,5,5,13
1980,4881,2059,2510,55063,53889,359,14.269,371,14.746,9825,2265,7560,4.203,18.232,7442,2683,4759,4.979,13.810,2383,4.422,27.620,274,275,1630
1980,4882,300,374,13410,13810,63,17.308,43,11.813,2313,832,1481,6.025,16.749,3038,1357,1681,9.827,21.999,-725,-5.250,33.499,21,22,327
1980,4883,2201,2626,128750,129634,391,15.217,278,10.819,34421,15324,19097,11.821,26.552,36553,3341,33212,2.577,28.197,-2132,-1.645,53.105,191,191,2258
1980,4884,2605,3202,44111,45726,529,16.746,443,14.023,5626,2586,3040,5.655,12.304,8934,2507,6427,5.483,19.538,-3308,-7.234,24.607,334,335,1619
1980,4885,3958,5671,81119,78876,837,15.072,602,10.840,16627,5458,11169,6.920,21.080,11926,4676,7250,5.928,15.120,4701,5.960,30.240,391,393,2464
1980,4889,347,356,6495,5969,60,17.291,42,12.104,2007,583,1424,9.768,33.627,1035,240,795,4.021,17.341,972,16.285,34.682,35,35,209
1980,4921,1077,1598,59899,58123,362,23.691,222,14.529,8765,2628,6137,4.521,15.080,5229,2144,3085,3.689,8.996,3536,6.084,17.993,157,157,721
1980,4922,659,659,3267,3483,282,43.857,250,38.880,1255,796,459,22.854,36.032,1674,990,684,28.424,48.062,-419,-12.030,72.064,217,217,753
1980,4931,6202,9544,393105,394808,851,9.020,632,6.699,51331,15391,35940,3.898,13.002,54192,11875,42317,3.008,13.726,-2861,-0.725,26.003,326,328,1896
1980,5111,12954,14588,587540,586776,1577,10.888,1370,9.458,54008,14895,39113,2.538,9.204,52258,16848,35410,2.871,8.906,1750,0.298,17.812,1050,1054,8999
1980,5112,4242,5147,78299,73030,1610,34.860,553,11.974,24512,10733,13779,14.697,33.565,14054,7868,6186,10.774,19.244,10458,14.320,38.489,319,320,1681
1980,5121,8531,13736,190089,192757,1934,14.111,1873,13.666,44278,16106,28172,8.356,22.971,50308,15266,35042,7.920,26.099,-6030,-3.128,45.942,1015,1091,7848
1980,5122,1333,1338,10023,9937,343,27.244,185,14.694,2742,1377,1365,13.857,27.594,2475,958,1517,9.641,24.907,267,2.687,49.814,124,124,527
1980,5151,5524,6475,193044,186527,630,9.864,454,7.108,31165,10763,20402,5.770,16.708,17798,6892,10906,3.695,9.542,13367,7.166,19.084,345,348,4509
1980,5152,12,12,50,39,9,112.500,D,D,32,32,0,82.051,82.051,11,D,10,D,28.205,21,53.846,56.410,D,D,D
1980,5173,2053,13904,972986,962401,445,3.216,308,2.226,250897,3067,247830,0.319,26.070,229916,2181,227735,0.227,23.890,20981,2.180,47.780,200,200,1300
1980,5174,561,958,29274,26577,170,18.826,60,6.645,8156,2231,5925,8.394,30.688,2756,806,1950,3.033,10.370,5400,20.318,20.740,36,36,380
1980,5179,983,2072,65165,59776,275,13.587,179,8.844,19085,2311,16774,3.866,31.928,8253,1044,7209,1.747,13.807,10832,18.121,27.613,131,131,591
1980,5182,5091,6664,194882,186744,1232,19.045,842,13.016,47571,21859,25712,11.705,25.474,31094,14793,16301,7.922,16.651,16477,8.823,33.301,486,489,5112
1980,5191,2079,2463,27175,26889,230,9.477,158,6.510,3466,1079,2387,4.013,12.890,2920,1206,1714,4.485,10.860,546,2.031,21.719,111,111,896
1980,5211,21,52,23790,23648,5,10.000,D,D,1036,555,481,2.347,4.381,765,D,344,D,3.235,271,1.146,6.470,0,0,0
1980,5221,21289,62524,1736436,1695877,3474,5.658,1233,2.008,171176,43802,127374,2.583,10.094,89895,19985,69910,1.178,5.301,81281,4.793,10.602,472,500,5084
1980,5222,24125,44629,353755,349266,3209,7.156,3638,8.113,56108,21559,34549,6.173,16.065,47451,18525,28926,5.304,13.586,8657,2.479,27.172,1457,1474,5641
1980,5223,2853,3171,37819,35734,706,23.235,441,14.514,10118,5065,5053,14.174,28.315,5988,2128,3860,5.955,16.757,4130,11.558,33.514,353,353,1143
1980,5231,4470,8528,188132,179200,1349,16.397,747,9.080,41086,12109,28977,6.757,22.928,23185,7298,15887,4.073,12.938,17901,9.989,25.876,459,462,2412
1980,5232,98,110,5852,5238,20,18.692,14,13.084,1443,226,1217,4.315,27.551,222,89,133,1.699,4.239,1221,23.313,8.477,12,12,81
1980,5239,9556,9902,81152,80013,1874,19.379,1411,14.591,21111,8376,12735,10.468,26.384,18661,8643,10018,10.802,23.322,2450,3.062,46.645,1116,1116,4221
1980,5241,6269,29999,1229727,1218607,2266,7.592,1961,6.570,135433,44502,90931,3.652,11.114,112184,32138,80046,2.637,9.206,23249,1.908,18.412,371,397,2417
1980,5242,87545,91988,990629,964975,10277,11.280,8521,9.352,192264,45900,146364,4.757,19.924,142546,41316,101230,4.282,14.772,49718,5.152,29.544,6172,6180,25621
1980,5259,591,790,9331,8110,67,8.422,78,9.805,3161,516,2645,6.363,38.979,712,273,439,3.366,8.780,2449,30.199,17.560,48,48,120
1980,5311,106486,108179,512375,517916,14207,13.012,16222,14.857,113046,52902,60144,10.214,21.827,123763,56207,67556,10.853,23.896,-10717,-2.069,43.654,13379,13396,43743
1980,5312,32090,33094,162175,164519,6057,18.533,5232,16.009,39925,17661,22264,10.735,24.268,44479,15388,29091,9.353,27.036,-4554,-2.768,48.536,4198,4203,11133
1980,5313,21071,21708,182596,180852,3918,18.239,3464,16.126,45341,16252,29089,8.986,25.071,41703,17353,24350,9.595,23.059,3638,2.012,46.119,2775,2780,10991
1980,5321,5564,8953,100358,100348,1245,13.696,1519,16.711,27532,7335,20197,7.310,27.437,27259,11996,15263,11.954,27.164,273,0.272,54.329,737,755,3849
1980,5322,8390,9894,87570,85730,1997,20.863,1353,14.135,22972,9918,13054,11.569,26.796,19277,9331,9946,10.884,22.486,3695,4.310,44.972,999,1005,5689
1980,5323,2097,2311,17590,17130,400,18.042,212,9.562,4194,1722,2472,10.053,24.483,3338,913,2425,5.330,19.486,856,4.997,38.973,146,146,557
1980,5324,3761,4214,45006,44139,731,18.067,395,9.763,9792,3323,6469,7.529,22.185,8172,2599,5573,5.888,18.514,1620,3.670,37.029,271,271,1401
1980,5331,855,911,9624,10025,158,17.146,179,19.425,3038,1178,1860,11.751,30.306,3920,2461,1459,24.550,39.104,-882,-8.798,60.612,142,142,933
1980,5411,104198,107153,547185,533095,14101,13.414,10038,9.549,102271,39920,62351,7.488,19.184,74060,27305,46755,5.122,13.892,28211,5.292,27.785,7361,7397,20159
1980,5412,44328,47241,341279,331039,7731,16.820,5177,11.263,67800,29045,38755,8.774,20.481,46950,20341,26609,6.145,14.183,20850,6.298,28.365,3843,3883,14361
1980,5413,41901,45603,612483,591636,7461,16.860,4762,10.761,127001,43832,83169,7.409,21.466,85190,26032,59158,4.400,14.399,41811,7.067,28.798,3393,3410,16003
1980,5414,11041,11278,83351,80494,2510,23.427,1382,12.899,20911,9537,11374,11.848,25.978,15135,5526,9609,6.865,18.803,5776,7.176,37.606,1047,1048,3745
1980,5415,2901,3376,30146,30279,1427,44.608,1073,33.542,10283,5627,4656,18.584,33.961,10525,7465,3060,24.654,34.760,-242,-0.799,67.922,819,821,3851
1980,5416,15738,16330,154780,151790,3773,23.531,3182,19.845,43696,16700,26996,11.002,28.787,37674,16349,21325,10.771,24.820,6022,3.967,49.640,2513,2518,11345
1980,5417,4439,5513,382401,373551,641,11.662,608,11.062,44585,11269,33316,3.017,11.935,27321,8005,19316,2.143,7.314,17264,4.622,14.628,384,386,2905
1980,5418,18728,20434,252565,248504,3247,16.195,2478,12.359,49489,16695,32794,6.718,19.915,41448,15976,25472,6.429,16.679,8041,3.236,33.358,1834,1838,9610
1980,5419,23347,25071,177299,179719,3694,15.073,2566,10.470,32327,12313,20014,6.851,17.988,36939,11892,25047,6.617,20.554,-4612,-2.566,35.975,1804,1823,6900
1980,5511,20555,38896,2649333,2607973,3974,10.366,2855,7.447,417351,122159,295192,4.684,16.003,332589,96856,235733,3.714,12.753,84762,3.250,25.506,568,592,6517
1980,5611,4531,4699,63192,63858,688,14.219,967,19.986,15114,4973,10141,7.788,23.668,16441,6802,9639,10.652,25.746,-1327,-2.078,47.337,759,761,5243
1980,5612,201,248,13644,14439,44,16.956,67,25.819,3276,1524,1752,10.555,22.689,4935,3606,1329,24.975,34.179,-1659,-11.490,45.379,28,29,820
1980,5613,9705,12826,583228,562938,2613,21.333,1458,11.903,156764,48074,108690,8.540,27.847,116531,22936,93595,4.074,20.701,40233,7.147,41.401,1029,1038,11021
1980,5614,16223,18134,190118,188281,3192,18.206,1990,11.350,38498,13788,24710,7.323,20.447,34999,8655,26344,4.597,18.589,3499,1.858,37.177,1482,1501,5901
1980,5615,15683,18259,137802,132429,2756,15.696,1356,7.723,30168,11052,19116,8.346,22.781,19629,6278,13351,4.741,14.822,10539,7.958,29.645,961,971,4063
1980,5616,10664,12533,371655,353389,2836,24.080,1325,11.250,96131,35984,60147,10.183,27.203,59009,17574,41435,4.973,16.698,37122,10.505,33.396,964,965,9869
1980,5617,48726,51196,643861,640501,11290,22.506,9227,18.393,155744,60873,94871,9.504,24.316,149787,47553,102234,7.424,23.386,5957,0.930,46.772,7309,7321,31673
1980,5619,11017,11763,139924,136314,2733,24.887,1170,10.654,34419,14811,19608,10.865,25.250,27132,8658,18474,6.352,19.904,7287,5.346,39.808,838,840,4675
1980,5621,5464,5582,101356,102335,751,13.545,676,12.192,13095,4135,8960,4.041,12.796,14986,4067,10919,3.974,14.644,-1891,-1.848,25.592,526,527,2653
1980,5622,1880,2266,36327,36284,285,12.763,219,9.807,5756,2038,3718,5.617,15.864,5639,2292,3347,6.317,15.541,117,0.322,31.083,153,153,1439
1980,5629,3862,4060,35675,35114,674,16.922,520,13.055,8033,2841,5192,8.091,22.877,6926,2493,4433,7.100,19.724,1107,3.153,39.449,408,408,1771
1980,6111,12722,13059,335532,333113,620,4.752,597,4.576,32771,5511,27260,1.654,9.838,27763,5357,22406,1.608,8.334,5008,1.503,16.669,441,443,3524
1980,6112,440,510,34104,33197,20,3.846,40,7.692,5037,791,4246,2.383,15.173,3370,758,2612,2.283,10.152,1667,5.022,20.303,27,28,590
1980,6113,1946,2189,827712,808403,83,3.793,82,3.747,80320,1012,79308,0.125,9.936,42348,3033,39315,0.375,5.238,37972,4.697,10.477,49,51,1612
1980,6114,1585,1762,26786,26183,286,16.489,231,13.318,5583,1514,4069,5.782,21.323,4458,1626,2832,6.210,17.027,1125,4.297,34.053,182,183,1153
1980,6115,4070,4528,44798,44801,582,12.964,505,11.248,8933,3779,5154,8.435,19.940,8911,2763,6148,6.167,19.890,22,0.049,39.781,387,392,1857
1980,6116,10248,10734,105483,104801,1994,18.765,1778,16.733,23991,8931,15060,8.522,22.892,22603,8146,14457,7.773,21.568,1388,1.324,43.135,1444,1449,6363
1980,6117,788,799,7781,8172,130,15.951,162,19.877,1707,543,1164,6.645,20.890,2540,759,1781,9.288,31.084,-833,-10.194,41.779,130,130,580
1980,6211,153199,157405,852487,838713,16536,10.760,9082,5.910,141431,56179,85252,6.698,16.863,113831,31122,82709,3.711,13.572,27600,3.291,27.144,6829,6857,21814
1980,6212,86080,87434,355525,351117,6348,7.364,3884,4.506,56428,18497,37931,5.268,16.071,47482,11792,35690,3.358,13.523,8946,2.548,27.046,2930,2943,9035
1980,6213,30872,31998,97237,94181,4799,15.521,2640,8.539,23597,11652,11945,12.372,25.055,17432,7021,10411,7.455,18.509,6165,6.546,37.018,1963,1966,5480
1980,6214,4389,5458,80598,79040,843,16.025,448,8.516,16042,6163,9879,7.797,20.296,13093,5549,7544,7.021,16.565,2949,3.731,33.130,295,298,4121
1980,6215,3714,4680,59101,58395,608,13.152,494,10.686,10888,4191,6697,7.177,18.645,9553,3053,6500,5.228,16.359,1335,2.286,32.719,329,345,1727
1980,6216,2451,3157,94687,87906,571,19.116,231,7.734,25755,9313,16442,10.594,29.299,12215,2724,9491,3.099,13.896,13540,15.403,27.791,157,159,1461
1980,6219,2346,2648,48934,45560,495,19.635,241,9.560,13571,4272,9299,9.377,29.787,6667,2548,4119,5.593,14.634,6904,15.154,29.267,161,161,1585
1980,6221,4074,4963,2743070,2689726,183,3.688,180,3.628,192053,37192,154861,1.383,7.140,84071,35987,48084,1.338,3.126,107982,4.015,6.251,99,99,19829
1980,6222,360,432,86222,84808,34,8.038,16,3.783,9584,1751,7833,2.065,11.301,6678,403,6275,0.475,7.874,2906,3.427,15.749,7,7,126
1980,6223,186,214,46041,46146,18,8.551,11,5.226,3486,894,2592,1.937,7.554,3486,2291,1195,4.965,7.554,0,0.000,15.109,8,8,1847
1980,6231,8303,11047,835942,830439,705,6.401,640,5.811,97786,35153,62633,4.233,11.775,87111,33324,53787,4.013,10.490,10675,1.285,20.980,442,463,22715
1980,6232,3084,3818,88799,85050,561,15.261,277,7.535,16546,6813,9733,8.011,19.455,8921,2871,6050,3.376,10.489,7625,8.965,20.978,179,182,1788
1980,6233,6330,7180,205543,203899,833,11.719,689,9.693,28586,10429,18157,5.115,14.020,25271,10324,14947,5.063,12.394,3315,1.626,24.788,492,495,7070
1980,6239,2408,2880,69980,68752,280,9.920,165,5.846,9474,2857,6617,4.156,13.780,7007,1806,5201,2.627,10.192,2467,3.588,20.383,115,116,1288
1980,6241,10825,14768,232160,226686,1633,11.300,1000,6.920,44132,11239,32893,4.958,19.468,33063,7668,25395,3.383,14.585,11069,4.883,29.171,617,626,3660
1980,6242,3046,3652,41264,40443,364,10.148,234,6.524,7064,1679,5385,4.152,17.467,5381,1353,4028,3.345,13.305,1683,4.161,26.610,144,147,763
1980,6243,3258,4774,227310,221240,663,14.269,408,8.781,47307,13481,33826,6.093,21.383,35693,5446,30247,2.462,16.133,11614,5.250,32.266,191,211,2496
1980,6244,24241,28187,238632,235578,4123,14.980,2794,10.152,48513,20344,28169,8.636,20.593,42377,15434,26943,6.552,17.989,6136,2.605,35.977,2034,2058,9054
1980,7111,4165,4199,52392,51630,781,18.642,762,18.188,15705,5331,10374,10.325,30.418,14017,5241,8776,10.151,27.149,1688,3.269,54.298,599,601,3814
1980,7112,2013,2092,55341,54205,379,18.239,351,16.891,12179,2388,9791,4.405,22.468,10180,1872,8308,3.454,18.781,1999,3.688,37.561,253,253,949
1980,7113,1871,1904,27386,27428,372,19.840,314,16.747,7496,3783,3713,13.793,27.330,7631,2835,4796,10.336,27.822,-135,-0.492,54.660,239,240,1817
1980,7114,1007,1019,11297,10910,212,21.232,171,17.126,3941,1766,2175,16.188,36.124,3109,1316,1793,12.063,28.498,832,7.626,56.996,127,127,859
1980,7115,5280,5301,50644,49767,1608,32.289,966,19.398,12802,5372,7430,10.794,25.724,11034,4025,7009,8.088,22.171,1768,3.553,44.343,710,710,2888
1980,7121,1851,1963,31513,31293,156,8.025,118,6.070,4182,613,3569,1.959,13.364,3679,594,3085,1.898,11.757,503,1.607,23.513,80,80,303
1980,7131,1397,1655,51044,50847,352,22.097,228,14.313,6935,2306,4629,4.535,13.639,6315,1424,4891,2.801,12.420,620,1.219,24.839,180,180,782
1980,7132,651,663,16165,16006,135,20.963,97,15.062,2746,1141,1605,7.129,17.157,2390,754,1636,4.711,14.932,356,2.224,29.865,78,78,546
1980,7139,28350,29823,421642,418750,3788,12.860,3055,10.371,78317,28164,50153,6.726,18.703,72844,22909,49935,5.471,17.396,5473,1.307,34.791,2258,2270,15200
1980,7211,29322,33154,1025422,1014139,4097,12.295,4433,13.304,193138,78168,114970,7.708,19.045,170779,65946,104833,6.503,16.840,22359,2.205,33.680,3250,3265,41283
1980,7212,3335,3534,18000,18214,475,13.346,525,14.751,4716,1714,3002,9.410,25.892,5133,1614,3519,8.861,28.182,-417,-2.289,51.784,339,340,910
1980,7213,5570,5644,32095,32470,336,5.864,508,8.866,4191,1089,3102,3.354,12.907,4951,1670,3281,5.143,15.248,-760,-2.341,25.815,363,367,1333
1980,7223,12121,14921,257611,257707,2501,16.805,2424,16.288,57776,30585,27191,11.868,22.419,58271,23178,35093,8.994,22.611,-495,-0.192,44.839,1835,1844,15280
1980,7224,64482,65244,350404,355880,9340,14.095,11385,17.181,92711,46559,46152,13.083,26.051,103973,44901,59072,12.617,29.216,-11262,-3.165,52.102,8872,8900,34931
1980,7225,179153,231878,3963594,3919407,38782,16.908,33771,14.723,953048,535995,417053,13.675,24.316,866558,347127,519431,8.857,22.109,86490,2.207,44.219,23983,24460,215779
1980,8111,87550,90986,422159,432450,14607,16.170,13299,14.722,88804,45449,43355,10.510,20.535,109473,43010,66463,9.946,25.315,-20669,-4.780,41.070,10333,10367,33204
1980,8112,9820,10872,62373,62042,1411,12.832,1659,15.087,11204,4611,6593,7.432,18.059,10564,4365,6199,7.036,17.027,640,1.032,34.055,1311,1311,3077
1980,8113,17353,18557,147030,143847,2722,14.907,2127,11.649,30420,10590,19830,7.362,21.148,24222,8368,15854,5.817,16.839,6198,4.309,33.678,1593,1604,6069
1980,8114,21072,22746,136327,139800,3530,15.535,3485,15.337,23743,10567,13176,7.559,16.984,30931,11045,19886,7.901,22.125,-7188,-5.142,33.967,2690,2694,8197
1980,8121,82443,90449,401771,405863,12444,13.749,12564,13.881,84079,42106,41973,10.374,20.716,92335,37938,54397,9.348,22.750,-8256,-2.034,41.432,10058,10129,29086
1980,8122,17668,20053,109466,110365,1400,6.998,1306,6.528,15570,4764,10806,4.317,14.108,17369,4239,13130,3.841,15.738,-1799,-1.630,28.216,900,912,2916
1980,8123,33546,39194,337843,343330,4075,10.321,4651,11.780,45473,17957,27516,5.230,13.245,56172,20158,36014,5.871,16.361,-10699,-3.116,26.489,3515,3609,14297
1980,8129,13066,19017,192173,186356,3706,20.113,2523,13.693,42965,20074,22891,10.772,23.055,31320,10626,20694,5.702,16.807,11645,6.249,33.613,1504,1536,6284
1980,8131,70556,70642,651844,645184,3601,5.146,2280,3.258,80783,14664,66119,2.273,12.521,67278,7420,59858,1.150,10.428,13505,2.093,20.855,1119,1119,3255
1980,8132,6859,7614,126702,120911,741,9.837,578,7.673,30617,6178,24439,5.110,25.322,19077,4176,14901,3.454,15.778,11540,9.544,31.555,391,398,2513
1980,8133,6452,7563,98824,97472,952,12.855,637,8.602,20823,4949,15874,5.077,21.363,18098,5736,12362,5.885,18.567,2725,2.796,37.135,383,383,2944
1980,8134,27903,29120,237252,237039,1801,6.196,1691,5.818,33658,6294,27364,2.655,14.199,33381,5381,28000,2.270,14.083,277,0.117,28.165,1154,1155,3610
1980,8139,54945,57059,429856,425159,4406,7.770,3697,6.520,77880,17484,60396,4.112,18.318,68480,12048,56432,2.834,16.107,9400,2.211,32.214,2635,2637,7748
1981,1131,203,208,2113,2337,31,14.797,34,16.229,529,114,415,4.878,22.636,1014,748,266,32.007,43.389,-485,-20.753,45.272,21,21,52
1981,1132,94,110,1105,1276,10,8.969,13,11.659,179,29,150,2.274,14.034,515,116,399,9.094,40.376,-336,-26.343,28.067,11,11,71
1981,1133,10842,10957,91852,95330,1480,13.136,2099,18.630,17395,5898,11497,6.187,18.247,24469,8518,15951,8.935,25.668,-7074,-7.421,36.494,1513,1513,6067
1981,1141,1437,1470,10136,10451,281,18.834,325,21.783,3169,1276,1893,12.209,30.322,3813,1491,2322,14.267,36.485,-644,-6.162,60.645,223,224,966
1981,1142,132,133,624,667,16,11.111,38,26.389,178,46,132,6.902,26.707,265,141,124,21.155,39.760,-87,-13.053,53.413,32,32,98
1981,1151,4141,4512,53205,52978,564,12.446,603,13.307,14605,4813,9792,9.085,27.568,14124,6546,7578,12.356,26.660,481,0.908,53.320,406,408,2965
1981,1152,1639,1660,10554,10268,275,16.672,254,15.399,2510,1166,1344,11.356,24.445,1961,831,1130,8.093,19.098,549,5.347,38.196,189,189,542
1981,1153,747,762,9438,9293,153,20.482,123,16.466,3007,1435,1572,15.442,32.358,2641,985,1656,10.599,28.419,366,3.938,56.838,91,91,753
1981,2111,6841,8765,164000,150796,1601,19.251,704,8.465,40841,12908,27933,8.560,27.084,14839,7264,7575,4.817,9.840,26002,17.243,19.681,424,430,2430
1981,2121,2957,3734,232625,232701,733,19.720,699,18.805,37538,12249,25289,5.264,16.131,37400,14064,23336,6.044,16.072,138,0.059,32.144,501,503,7869
1981,2122,638,816,85405,85528,223,29.036,127,16.536,10804,3892,6912,4.551,12.632,11121,2986,8135,3.491,13.003,-317,-0.371,25.264,77,79,458
1981,2123,3680,5140,114514,114993,450,8.760,444,8.643,17841,5205,12636,4.526,15.515,18775,3205,15570,2.787,16.327,-934,-0.812,31.030,272,274,1829
1981,2131,10132,11542,360636,323340,3169,30.092,1147,10.892,124914,45602,79312,14.103,38.632,49853,20335,29518,6.289,15.418,75061,23.214,30.836,800,806,11800
1981,2211,1589,5717,548162,539696,205,3.615,113,1.993,30256,5484,24772,1.016,5.606,13399,3579,9820,0.663,2.483,16857,3.123,4.965,23,23,112
1981,2212,543,2351,140272,138821,118,5.075,66,2.839,9452,2964,6488,2.135,6.809,6592,1443,5149,1.039,4.749,2860,2.060,9.497,30,30,336
1981,2213,3919,4225,33997,33580,305,7.233,288,6.830,4305,1034,3271,3.079,12.820,3466,1396,2070,4.157,10.322,839,2.499,20.643,205,206,916
1981,2361,96518,96877,556887,581933,17663,17.452,26331,26.016,174436,69691,104745,11.976,29.975,224649,95013,129636,16.327,38.604,-50213,-8.629,59.951,20062,20066,74631
1981,2362,32129,32649,591835,605588,4743,14.371,5453,16.522,136454,34165,102289,5.642,22.532,163192,29260,133932,4.832,26.948,-26738,-4.415,45.065,4091,4091,21079
1981,2371,13546,13868,336597,332229,1593,11.486,1594,11.494,76106,16506,59600,4.968,22.908,66882,12791,54091,3.850,20.131,9224,2.776,40.263,1182,1182,8761
1981,2372,7697,7856,68534,68509,1846,23.549,1812,23.115,20449,9245,11204,13.495,29.849,20360,8088,12272,11.806,29.719,89,0.130,59.437,1413,1415,5659
1981,2373,10697,10990,224836,233625,1009,9.104,1196,10.791,46683,13067,33616,5.593,19.982,63761,10169,53592,4.353,27.292,-17078,-7.310,39.964,856,857,6546
1981,2379,4564,4628,114390,111884,839,18.209,798,17.320,32103,6070,26033,5.425,28.693,27028,7209,19819,6.443,24.157,5075,4.536,48.314,608,608,3199
1981,2381,63151,63546,541007,556457,8492,13.005,11994,18.368,141233,41958,99275,7.540,25.381,172068,51981,120087,9.341,30.922,-30835,-5.541,50.762,8773,8774,39765
1981,2382,95395,97117,996037,1001769,11175,11.442,12267,12.561,200826,53578,147248,5.348,20.047,212019,52874,159145,5.278,21.164,-11193,-1.117,40.094,9332,9342,40017
1981,2383,64679,65063,492948,507949,9783,14.567,13975,20.809,128845,40369,88476,7.947,25.366,158670,53637,105033,10.560,31.237,-29825,-5.872,50.732,10555,10559,41924
1981,2389,33671,33878,352518,349452,5120,15.032,5485,16.104,89684,26287,63397,7.522,25.664,82900,21815,61085,6.243,23.723,6784,1.941,47.446,4071,4071,15850
1981,3111,1431,2105,58664,59664,129,6.109,142,6.725,5786,2301,3485,3.857,9.698,7731,1915,5816,3.210,12.958,-1945,-3.260,19.395,85,87,1022
1981,3112,537,897,77814,78547,57,6.426,37,4.171,4918,1302,3616,1.658,6.261,6324,1138,5186,1.449,8.051,-1406,-1.790,12.522,21,21,264
1981,3113,1258,1650,89588,90296,194,12.042,116,7.200,7550,1691,5859,1.873,8.361,8918,912,8006,1.010,9.876,-1368,-1.515,16.723,61,63,382
1981,3114,1252,1757,183330,186850,115,6.497,141,7.966,16430,2709,13721,1.450,8.793,23188,5513,17675,2.951,12.410,-6758,-3.617,17.586,79,80,861
1981,3115,1916,2697,144641,145432,109,3.996,171,6.268,12698,2804,9894,1.928,8.731,14215,5032,9183,3.460,9.774,-1517,-1.043,17.463,103,103,1566
1981,3116,4471,5073,329206,326504,454,9.003,393,7.794,38424,15288,23136,4.682,11.768,32680,9709,22971,2.974,10.009,5744,1.759,20.018,286,291,4668
1981,3117,722,853,44206,45648,82,9.676,71,8.378,7278,2435,4843,5.334,15.944,10217,3103,7114,6.798,22.382,-2939,-6.438,31.888,41,41,1616
1981,3118,8022,9579,294018,297105,1209,12.682,1117,11.717,32304,13108,19196,4.412,10.873,38566,15553,23013,5.235,12.981,-6262,-2.108,21.746,799,817,8684
1981,3119,2000,2371,118513,118903,208,8.791,198,8.369,14062,5257,8805,4.421,11.826,15041,3699,11342,3.111,12.650,-979,-0.823,23.653,117,117,1271
1981,3121,2167,2757,183314,184508,195,7.069,198,7.178,16980,6191,10789,3.355,9.203,19283,8063,11220,4.370,10.451,-2303,-1.248,18.406,143,145,3263
1981,3122,126,186,46802,46032,7,3.723,11,5.851,3506,166,3340,0.361,7.617,1911,240,1671,0.521,4.152,1595,3.465,8.303,9,9,225
1981,3131,449,702,119191,122780,36,5.046,59,8.269,6863,1439,5424,1.172,5.590,13961,3688,10273,3.004,11.371,-7098,-5.781,11.179,29,29,541
1981,3132,1749,2192,344355,353023,170,7.706,198,8.976,20297,7533,12764,2.134,5.749,37348,10532,26816,2.983,10.579,-17051,-4.830,11.499,137,138,2938
1981,3133,3674,4131,145411,148826,364,9.037,158,3.923,13709,4386,9323,2.947,9.211,20373,4327,16046,2.907,13.689,-6664,-4.478,18.423,88,89,1992
1981,3141,4278,4577,117496,122937,494,10.632,633,13.623,13321,6436,6885,5.235,10.836,24242,8690,15552,7.069,19.719,-10921,-8.883,21.671,501,504,3849
1981,3149,3450,3579,127269,129812,459,12.994,366,10.361,17834,6940,10894,5.346,13.738,22822,7434,15388,5.727,17.581,-4988,-3.842,27.477,291,291,4957
1981,3151,1402,1543,146787,147826,143,9.247,150,9.699,14520,3696,10824,2.500,9.822,16336,4476,11860,3.028,11.051,-1816,-1.228,19.645,130,130,2892
1981,3152,13828,15670,965526,971284,2272,14.708,1826,11.821,140326,59481,80845,6.124,14.447,151777,52055,99722,5.359,15.626,-11451,-1.179,28.895,1466,1478,31724
1981,3159,1565,1670,63515,63713,214,12.978,172,10.431,9047,2995,6052,4.701,14.200,9396,2745,6651,4.308,14.747,-349,-0.548,28.399,142,142,1723
1981,3161,361,403,21148,20777,36,8.834,45,11.043,3030,733,2297,3.528,14.583,2306,976,1330,4.698,11.099,724,3.485,22.198,34,37,617
1981,3162,513,758,145260,144634,64,8.494,55,7.299,18933,4108,14825,2.840,13.090,17431,6030,11401,4.169,12.052,1502,1.038,24.104,31,31,1282
1981,3169,1396,1446,62619,64778,167,11.678,135,9.441,8292,2552,5740,3.940,12.801,12485,3061,9424,4.725,19.274,-4193,-6.473,25.601,106,106,2021
1981,3211,5405,5970,146951,154446,575,9.479,767,12.644,16899,6121,10778,3.963,10.942,31748,7670,24078,4.966,20.556,-14849,-9.614,21.883,583,584,4207
1981,3212,1083,1354,85108,87290,141,10.452,131,9.711,10553,3435,7118,3.935,12.090,14894,4092,10802,4.688,17.063,-4341,-4.973,24.179,85,87,1072
1981,3219,8632,9436,276761,284921,1186,12.675,1028,10.986,36540,15234,21306,5.347,12.825,52906,15027,37879,5.274,18.569,-16366,-5.744,25.649,767,773,7955
1981,3221,345,698,210052,212597,29,4.033,71,9.875,8867,1995,6872,0.938,4.171,14024,3712,10312,1.746,6.597,-5157,-2.426,8.342,21,24,718
1981,3222,3497,5087,404832,411036,344,6.804,281,5.558,28620,9127,19493,2.220,6.963,41162,9340,31822,2.272,10.014,-12542,-3.051,13.926,154,154,2699
1981,3231,32189,33607,655602,648535,4140,12.614,2566,7.818,87036,33397,53639,5.150,13.420,73012,22379,50633,3.451,11.258,14024,2.162,22.516,1953,1959,12065
1981,3241,1368,2150,156445,151190,235,11.088,174,8.209,21682,5791,15891,3.830,14.341,10916,2344,8572,1.550,7.220,10766,7.121,14.440,81,81,638
1981,3251,1127,2208,271762,275956,217,10.028,129,5.961,15745,5521,10224,2.001,5.706,24589,3302,21287,1.197,8.910,-8844,-3.205,11.411,44,44,741
1981,3252,399,640,155218,158285,49,7.772,30,4.758,7495,2612,4883,1.650,4.735,13568,1351,12217,0.854,8.572,-6073,-3.837,9.470,17,17,183
1981,3253,770,1133,57923,57257,69,6.055,82,7.196,6484,1330,5154,2.323,11.324,5049,1404,3645,2.452,8.818,1435,2.506,17.636,40,42,695
1981,3254,948,1184,162714,161873,134,11.532,90,7.745,12329,2129,10200,1.315,7.616,10657,2346,8311,1.449,6.584,1672,1.033,13.167,57,57,420
1981,3255,1664,2115,77196,78802,125,5.882,145,6.824,5671,1313,4358,1.666,7.197,8948,2244,6704,2.848,11.355,-3277,-4.159,14.393,90,95,578
1981,3256,2052,2304,121590,119924,213,9.365,154,6.771,15921,4020,11901,3.352,13.276,12419,2777,9642,2.316,10.356,3502,2.920,20.711,109,109,1331
1981,3259,1648,2158,98153,98751,231,10.956,132,6.260,8967,2732,6235,2.767,9.080,10020,1866,8154,1.890,10.147,-1053,-1.066,18.161,79,79,680
1981,3261,9739,11206,515724,524003,1231,11.173,854,7.751,65050,21716,43334,4.144,12.414,81913,19615,62298,3.743,15.632,-16863,-3.218,24.828,587,589,8009
1981,3262,1826,2208,194107,204260,225,10.376,146,6.733,13225,3574,9651,1.750,6.475,34208,13713,20495,6.714,16.747,-20983,-10.273,12.949,94,94,1955
1981,3271,1331,1637,87702,92593,201,12.267,204,12.450,6617,2713,3904,2.930,7.146,16343,4360,11983,4.709,17.650,-9726,-10.504,14.293,155,156,1819
1981,3272,1489,1772,171668,174003,223,12.849,150,8.643,10888,2898,7990,1.665,6.257,15663,3016,12647,1.733,9.002,-4775,-2.744,12.515,114,114,1303
1981,3273,7357,9267,185627,189016,676,7.321,609,6.596,25429,8847,16582,4.681,13.453,32066,5887,26179,3.115,16.965,-6637,-3.511,26.907,405,407,3320
1981,3274,243,342,17409,17156,48,13.933,53,15.385,2152,1175,977,6.849,12.544,1587,353,1234,2.058,9.250,565,3.293,18.501,44,44,190
1981,3279,2013,2323,92519,94254,252,10.968,201,8.749,10106,3979,6127,4.222,10.722,13421,3111,10310,3.301,14.239,-3315,-3.517,21.444,144,145,1039
1981,3311,419,513,385737,400061,56,11.056,43,8.490,8560,3215,5345,0.804,2.140,37749,6175,31574,1.544,9.436,-29189,-7.296,4.279,31,31,982
1981,3312,539,725,92350,93379,55,7.639,45,6.250,8458,2900,5558,3.106,9.058,10409,2306,8103,2.470,11.147,-1951,-2.089,18.116,30,31,905
1981,3313,300,458,107919,110636,36,8.009,19,4.227,6080,2101,3979,1.899,5.496,11546,2284,9262,2.064,10.436,-5466,-4.941,10.991,7,7,187
1981,3314,834,1045,120017,123316,158,15.675,84,8.333,9359,4050,5309,3.284,7.589,16114,5352,10762,4.340,13.067,-6755,-5.478,15.179,51,52,496
1981,3315,2936,3293,287222,301592,217,6.626,181,5.527,21742,6622,15120,2.196,7.209,50686,12384,38302,4.106,16.806,-28944,-9.597,14.418,122,124,3625
1981,3321,2935,3164,153792,158256,269,8.634,172,5.521,13148,4485,8663,2.834,8.308,22140,3066,19074,1.937,13.990,-8992,-5.682,16.616,121,121,1554
1981,3322,1175,1305,94708,97141,107,8.288,79,6.119,6868,2417,4451,2.488,7.070,11495,1569,9926,1.615,11.833,-4627,-4.763,14.140,58,59,732
1981,3323,9819,10674,363882,367830,1101,10.471,782,7.437,50876,15860,35016,4.312,13.831,58756,11996,46760,3.261,15.974,-7880,-2.142,27.663,613,616,6143
1981,3324,1430,1825,160324,165162,155,8.571,122,6.746,12437,4058,8379,2.457,7.530,22136,4272,17864,2.587,13.403,-9699,-5.872,15.060,64,64,516
1981,3325,873,962,83642,86509,84,8.796,70,7.330,5558,2182,3376,2.522,6.425,11360,1202,10158,1.389,13.132,-5802,-6.707,12.850,54,54,714
1981,3326,1606,1789,74548,77259,159,8.970,126,7.109,8079,3431,4648,4.441,10.457,13344,2709,10635,3.506,17.272,-5265,-6.815,20.914,78,78,769
1981,3327,20544,20866,351465,356173,2573,12.579,1750,8.556,45887,17886,28001,5.022,12.883,55427,11558,43869,3.245,15.562,-9540,-2.678,25.767,1364,1367,8839
1981,3328,5337,5629,121975,123844,492,8.826,383,6.871,16214,5709,10505,4.610,13.092,19951,4078,15873,3.293,16.110,-3737,-3.018,26.185,294,300,2744
1981,3329,4794,5343,389414,392453,667,12.860,354,6.825,35757,11256,24501,2.868,9.111,42344,7653,34691,1.950,10.790,-6587,-1.678,18.222,254,254,3575
1981,3331,3156,3640,398768,405731,475,13.447,260,7.360,60801,24395,36406,6.013,14.986,74074,22187,51887,5.468,18.257,-13273,-3.271,29.971,172,172,2188
1981,3332,3612,3868,193784,195416,364,9.607,206,5.437,20287,7477,12810,3.826,10.381,23622,3119,20503,1.596,12.088,-3335,-1.707,20.763,147,148,1072
1981,3333,2019,2149,162184,162035,178,8.329,154,7.206,19824,7032,12792,4.340,12.234,19696,5375,14321,3.317,12.155,128,0.079,24.311,104,104,1139
1981,3334,1894,2139,186666,189311,316,15.203,195,9.382,22284,7511,14773,3.968,11.771,27027,4969,22058,2.625,14.277,-4743,-2.505,23.542,150,151,1876
1981,3335,10050,10504,306239,308515,913,8.833,577,5.582,32711,9621,23090,3.118,10.603,37361,6260,31101,2.029,12.110,-4650,-1.507,21.205,433,433,3756
1981,3336,673,831,182444,188282,69,8.446,41,5.018,12462,5664,6798,3.008,6.619,24134,1521,22613,0.808,12.818,-11672,-6.199,13.238,26,27,626
1981,3339,5908,6469,379784,390098,591,9.280,390,6.124,40425,14129,26296,3.622,10.363,60924,13697,47227,3.511,15.618,-20499,-5.255,20.726,273,273,3708
1981,3341,1126,1308,324405,318459,312,25.700,124,10.214,44908,14414,30494,4.526,14.102,32914,11838,21076,3.717,10.335,11994,3.766,20.671,75,75,2709
1981,3342,1669,1850,277622,285094,251,13.979,142,7.909,26985,7810,19175,2.739,9.465,42264,7539,34725,2.644,14.825,-15279,-5.359,18.931,86,86,2459
1981,3343,477,504,61054,62760,69,13.745,65,12.948,4538,931,3607,1.483,7.231,7846,2302,5544,3.668,12.502,-3308,-5.271,14.462,49,49,564
1981,3344,3659,4142,463315,463370,649,16.356,301,7.586,58945,24624,34321,5.314,12.721,59145,16548,42597,3.571,12.764,-200,-0.043,25.442,222,223,3915
1981,3345,3678,4222,593714,589717,509,12.387,283,6.887,61505,17768,43737,3.013,10.430,53458,14748,38710,2.501,9.065,8047,1.365,18.130,176,176,2697
1981,3346,570,594,20719,21437,98,16.568,93,15.723,3806,1365,2441,6.368,17.755,5137,2518,2619,11.746,23.964,-1331,-6.209,35.510,73,73,799
1981,3351,1202,1316,82847,85851,127,9.647,128,9.723,6720,2199,4521,2.561,7.828,12603,2698,9905,3.143,14.680,-5883,-6.853,15.655,98,99,1023
1981,3352,368,473,141783,146132,50,10.718,37,7.931,7851,1256,6595,0.859,5.373,16754,2374,14380,1.625,11.465,-8903,-6.092,10.745,23,23,147
1981,3353,1956,2446,293423,299704,230,9.597,131,5.466,29598,11423,18175,3.811,9.876,42067,10933,31134,3.648,14.036,-12469,-4.160,19.751,76,76,1876
1981,3359,1738,2149,228296,231683,248,11.841,139,6.636,23670,10023,13647,4.326,10.217,29914,9056,20858,3.909,12.912,-6244,-2.695,20.433,79,79,1740
1981,3361,180,236,245544,255259,37,15.812,33,14.103,36109,13459,22650,5.273,14.146,54540,16519,38021,6.471,21.367,-18431,-7.221,28.292,27,27,332
1981,3362,1714,1894,99845,107641,190,9.784,286,14.727,12658,3644,9014,3.385,11.760,28132,7410,20722,6.884,26.135,-15474,-14.376,23.519,205,205,2254
1981,3363,3395,4143,608794,635029,416,10.122,350,8.516,47699,13234,34465,2.084,7.511,99936,18796,81140,2.960,15.737,-52237,-8.226,15.023,232,233,3809
1981,3364,1140,1351,678559,673353,164,12.529,80,6.112,46826,5687,41139,0.845,6.954,38287,3506,34781,0.521,5.686,8539,1.268,11.372,59,59,1247
1981,3365,172,221,59136,68429,27,12.587,14,6.527,3300,546,2754,0.798,4.823,21854,509,21345,0.744,31.937,-18554,-27.114,9.645,8,8,91
1981,3366,1162,1266,210161,205737,166,13.317,127,10.189,27048,5550,21498,2.698,13.147,17807,5465,12342,2.656,8.655,9241,4.492,17.310,96,96,3430
1981,3369,408,421,30682,32192,61,14.507,60,14.269,2928,989,1939,3.072,9.095,6090,1311,4779,4.072,18.918,-3162,-9.822,18.191,45,45,304
1981,3371,12263,12886,370611,380493,1639,12.769,1539,11.990,42633,18251,24382,4.797,11.205,62029,18276,43753,4.803,16.302,-19396,-5.098,22.409,1216,1218,10411
1981,3372,2265,2386,115209,117039,271,11.542,195,8.305,13642,5367,8275,4.586,11.656,17332,3780,13552,3.230,14.809,-3690,-3.153,23.312,154,154,2127
1981,3379,1089,1229,39505,39707,110,9.050,83,6.828,4854,2070,2784,5.213,12.225,5450,1421,4029,3.579,13.726,-596,-1.501,24.449,55,55,663
1981,3391,9161,9702,216860,215661,1323,13.857,1014,10.621,28396,10237,18159,4.747,13.167,25950,9400,16550,4.359,12.033,2446,1.134,24.066,749,752,3226
1981,3399,14230,14883,443961,449703,1799,12.194,1540,10.438,59563,19624,39939,4.364,13.245,71272,19637,51635,4.367,15.849,-11709,-2.604,26.490,1169,1171,9723
1981,4231,18381,21829,247294,252064,2070,9.464,2155,9.853,33409,13963,19446,5.539,13.254,42793,13409,29384,5.320,16.977,-9384,-3.723,26.508,1529,1554,7211
1981,4232,6930,8034,89923,88989,1054,13.310,824,10.405,15431,5082,10349,5.711,17.340,13490,4687,8803,5.267,15.159,1941,2.181,30.318,599,605,2883
1981,4233,7328,9214,109869,112127,1060,11.564,964,10.517,17918,6864,11054,6.122,15.980,22501,6365,16136,5.677,20.068,-4583,-4.087,31.960,684,692,3560
1981,4234,18204,25026,430265,419922,3744,15.378,2385,9.796,74732,35301,39431,8.407,17.797,53715,20937,32778,4.986,12.792,21017,5.005,25.583,1462,1482,7378
1981,4235,6227,8761,142171,141286,1023,11.898,697,8.107,21130,8632,12498,6.110,14.956,19562,5877,13685,4.160,13.846,1568,1.110,27.691,389,391,2224
1981,4236,13150,18566,239858,232473,2447,13.474,1638,9.019,49884,20592,29292,8.858,21.458,34913,11992,22921,5.158,15.018,14971,6.440,30.036,1008,1047,4720
1981,4237,10230,13245,144121,143949,1265,9.637,1027,7.824,21782,8363,13419,5.810,15.132,21275,6778,14497,4.709,14.780,507,0.352,29.559,736,748,4013
1981,4238,45094,59068,691577,687897,6215,10.692,4339,7.464,107668,40827,66841,5.935,15.652,100091,31331,68760,4.555,14.550,7577,1.101,29.101,2843,2913,14975
1981,4239,21443,23169,224268,222246,3570,15.801,2419,10.707,42986,17810,25176,8.014,19.342,39061,13245,25816,5.960,17.576,3925,1.766,35.151,1785,1809,7767
1981,4241,6807,9278,135543,133906,937,10.228,704,7.684,19776,6146,13630,4.590,14.769,16676,5471,11205,4.086,12.454,3100,2.315,24.907,412,427,2353
1981,4242,2579,3346,91085,91229,466,14.220,328,10.009,13078,3642,9436,3.992,14.335,13590,5006,8584,5.487,14.897,-512,-0.561,28.671,234,235,2146
1981,4243,8486,9207,95848,94562,1451,15.818,1383,15.077,24096,11325,12771,11.976,25.482,21662,9356,12306,9.894,22.908,2434,2.574,45.816,1061,1073,6350
1981,4244,26216,32121,559145,550963,3455,10.790,3256,10.168,90073,35583,54490,6.458,16.348,73558,27781,45777,5.042,13.351,16515,2.997,26.702,2324,2369,15703
1981,4245,8631,11798,105694,107030,726,6.126,832,7.021,14706,5299,9407,4.951,13.740,17521,4773,12748,4.460,16.370,-2815,-2.630,27.480,573,596,3273
1981,4246,6005,8937,110995,107435,1152,13.218,709,8.135,22689,9098,13591,8.468,21.119,15660,4585,11075,4.268,14.576,7029,6.543,29.153,438,446,2103
1981,4247,11907,15595,153099,150120,1366,8.755,1381,8.851,30459,10496,19963,6.992,20.290,24413,8976,15437,5.979,16.262,6046,4.027,32.525,865,884,4400
1981,4248,4773,5887,136343,132222,420,7.159,380,6.477,19458,6420,13038,4.855,14.716,11269,3866,7403,2.924,8.523,8189,6.193,17.046,269,279,2483
1981,4249,17276,20733,217611,214986,2398,11.635,2151,10.437,38940,13967,24973,6.497,18.113,33775,11075,22700,5.152,15.710,5165,2.402,31.421,1628,1651,6700
1981,4251,26798,29586,291252,287205,3576,12.344,2341,8.081,52389,19644,32745,6.840,18.241,44156,12952,31204,4.510,15.374,8233,2.867,30.749,1597,1602,7636
1981,4411,38053,39021,752058,788288,3131,7.827,5094,12.734,75650,30847,44803,3.913,9.597,147764,51408,96356,6.521,18.745,-72114,-9.148,19.193,4218,4258,42161
1981,4412,11618,12016,74762,76642,1159,9.421,1731,14.071,14062,5105,8957,6.661,18.348,17743,6833,10910,8.916,23.151,-3681,-4.803,36.696,1390,1408,5372
1981,4413,41930,56965,400004,400170,5127,9.022,4850,8.535,63743,27135,36608,6.781,15.929,64505,22306,42199,5.574,16.119,-762,-0.190,31.858,3137,3252,13442
1981,4421,23387,27627,214563,218897,2498,8.968,2956,10.612,31735,11872,19863,5.424,14.498,40426,13486,26940,6.161,18.468,-8691,-3.970,28.995,2291,2340,9583
1981,4422,19750,22869,127476,128865,3193,14.088,2785,12.288,24741,11525,13216,8.944,19.199,27468,10198,17270,7.914,21.315,-2727,-2.116,38.398,2158,2192,7626
1981,4431,27739,37779,215079,217944,4417,11.685,4462,11.804,39001,18546,20455,8.510,17.895,44834,16939,27895,7.772,20.571,-5833,-2.676,35.790,3070,3271,11379
1981,4441,56703,72026,664334,668440,5983,8.349,5252,7.329,90888,37566,53322,5.620,13.597,99134,26063,73071,3.899,14.831,-8246,-1.234,27.194,3929,3987,16756
1981,4442,16167,19614,149489,148074,1891,9.696,1670,8.563,25085,8245,16840,5.568,16.941,22305,6473,15832,4.371,15.063,2780,1.877,30.127,1238,1279,4672
1981,4451,63707,96914,1706446,1678606,11964,12.468,10058,10.481,269301,126030,143271,7.508,16.043,212187,76254,135933,4.543,12.641,57114,3.402,25.281,6931,7047,35066
1981,4452,22186,27218,167549,167445,3955,14.587,3744,13.809,39041,19683,19358,11.755,23.316,39008,16282,22726,9.724,23.296,33,0.020,46.592,2712,2802,11664
1981,4453,28285,33279,160870,171881,3414,10.113,4374,12.957,30161,11904,18257,6.926,17.548,52507,20996,31511,12.215,30.548,-22346,-13.001,35.095,2723,2767,8597
1981,4461,47507,66657,567858,568342,6875,10.488,4667,7.119,86237,38274,47963,6.734,15.173,87132,26153,60979,4.602,15.331,-895,-0.157,30.347,3211,3292,15944
1981,4471,110556,150871,878419,869434,17266,11.355,19641,12.917,196489,83922,112567,9.652,22.600,178067,75890,102177,8.729,20.481,18422,2.119,40.962,13501,13796,50481
1981,4481,59742,96640,765549,766305,11695,12.162,10731,11.160,139397,67387,72010,8.794,18.191,140327,47465,92862,6.194,18.312,-930,-0.121,36.382,7270,8005,29216
1981,4482,12434,34758,189452,184040,4567,13.490,2759,8.150,44282,22058,22224,11.985,24.061,34041,10742,23299,5.837,18.497,10241,5.565,36.993,1314,1441,5428
1981,4483,17258,24674,145007,148638,3119,12.899,2130,8.809,29162,15063,14099,10.134,19.620,36962,8730,28232,5.873,24.867,-7800,-5.248,39.239,1447,1510,5220
1981,4511,32202,40646,249367,246766,5769,14.272,5318,13.157,52919,21699,31220,8.793,21.445,47470,18269,29201,7.403,19.237,5449,2.208,38.474,4017,4142,12479
1981,4512,7517,10726,68407,68382,1586,15.025,1246,11.804,13609,6734,6875,9.848,19.901,13652,4544,9108,6.645,19.964,-43,-0.063,39.803,866,902,2768
1981,4522,524,6975,1113068,1113863,531,7.800,196,2.879,107371,62293,45078,5.593,9.640,108913,9303,99610,0.835,9.778,-1542,-0.138,19.279,34,39,658
1981,4523,15993,31614,822798,830165,2550,8.006,3027,9.503,91444,51046,40398,6.149,11.015,106096,28788,77308,3.468,12.780,-14652,-1.765,22.030,1788,1820,6191
1981,4531,20552,21810,102963,103073,2760,12.767,2375,10.986,19622,7342,12280,7.123,19.037,19857,6443,13414,6.251,19.265,-235,-0.228,38.074,1828,1848,4968
1981,4532,23123,27604,163411,159540,4388,16.208,3325,12.282,37386,17633,19753,11.052,23.434,29608,11284,18324,7.073,18.558,7778,4.875,37.117,2544,2578,7682
1981,4533,7954,9204,40230,39733,1443,15.899,1187,13.078,8845,4254,4591,10.707,22.261,7899,3278,4621,8.250,19.880,946,2.381,39.761,937,939,2303
1981,4539,21932,25755,113123,114049,3831,14.854,3904,15.137,26273,11493,14780,10.077,23.037,28194,12491,15703,10.952,24.721,-1921,-1.684,46.073,2888,2984,9248
1981,4541,5309,7050,90519,91166,979,13.938,927,13.198,14145,5067,9078,5.558,15.516,15363,5253,10110,5.762,16.852,-1218,-1.336,31.031,655,659,2411
1981,4542,4289,5492,81558,82706,554,10.028,619,11.205,11139,3653,7486,4.417,13.468,13466,3327,10139,4.023,16.282,-2327,-2.814,26.936,403,406,1544
1981,4543,17494,23185,203479,204850,2059,8.826,2349,10.069,32228,10676,21552,5.212,15.733,34706,12536,22170,6.120,16.942,-2478,-1.210,31.465,1690,1709,7615
1981,4811,1047,2503,301085,307743,338,13.844,215,8.806,15364,4424,10940,1.438,4.992,28288,3498,24790,1.137,9.192,-12924,-4.200,9.985,134,135,1763
1981,4812,419,587,10638,10083,127,22.458,84,14.854,2229,747,1482,7.409,22.107,1113,686,427,6.804,11.038,1116,11.068,22.077,75,75,408
1981,4831,426,683,35012,36417,72,10.596,65,9.566,5301,1513,3788,4.155,14.556,7811,1308,6503,3.592,21.449,-2510,-6.892,29.113,34,35,619
1981,4832,408,475,18328,17921,53,11.193,50,10.560,3924,1490,2434,8.315,21.897,3129,1460,1669,8.147,17.460,795,4.436,34.921,35,35,533
1981,4841,21511,26940,513903,525502,4314,16.051,4188,15.582,71563,29546,42017,5.622,13.618,94756,29082,65674,5.534,18.032,-23193,-4.413,27.236,3213,3225,14739
1981,4842,38866,42480,516151,524364,6250,14.613,6831,15.971,86195,31121,55074,5.935,16.438,102566,33271,69295,6.345,19.560,-16371,-3.122,32.876,5339,5349,22348
1981,4851,386,421,25349,26723,45,10.274,79,18.037,1748,462,1286,1.729,6.541,4677,3306,1371,12.372,17.502,-2929,-10.961,13.083,50,50,364
1981,4852,328,709,31326,31175,30,4.249,24,3.399,2309,601,1708,1.928,7.407,2054,968,1086,3.105,6.589,255,0.818,13.177,15,15,128
1981,4853,5736,5792,61857,65397,830,13.915,1176,19.715,10777,3624,7153,5.542,16.479,18070,6012,12058,9.193,27.631,-7293,-11.152,32.959,977,980,4994
1981,4854,3692,3883,95426,94658,349,8.948,384,9.845,15372,6194,9178,6.544,16.240,13829,4778,9051,5.048,14.610,1543,1.630,29.219,327,327,2732
1981,4855,482,511,10066,9743,81,15.945,75,14.764,2105,896,1209,9.197,21.606,1460,496,964,5.091,14.986,645,6.620,29.972,59,59,394
1981,4859,882,932,19720,19102,153,16.603,132,14.324,4046,1424,2622,7.455,21.182,2860,1386,1474,7.256,14.973,1186,6.209,29.945,108,108,884
1981,4861,86,327,11756,11270,46,14.696,18,5.751,1914,727,1187,6.451,16.984,943,469,474,4.162,8.368,971,8.616,16.735,5,5,96
1981,4862,226,1151,56560,55221,143,13.041,34,3.101,5172,1761,3411,3.189,9.366,2414,334,2080,0.605,4.372,2758,4.994,8.743,17,17,127
1981,4869,77,269,6876,7024,31,11.610,27,10.112,731,233,498,3.317,10.408,1049,168,881,2.392,14.936,-318,-4.528,20.816,6,6,55
1981,4871,162,165,2263,2205,21,12.613,24,14.414,506,98,408,4.445,22.953,400,150,250,6.804,18.145,106,4.808,36.289,20,20,141
1981,4872,763,771,9423,9581,118,15.445,104,13.613,2093,669,1424,6.983,21.845,2384,958,1426,9.999,24.883,-291,-3.037,43.691,84,84,498
1981,4879,55,68,699,633,15,22.556,12,18.045,240,108,132,17.062,37.915,113,56,57,8.847,17.852,127,20.063,35.703,11,11,52
1981,4881,2076,2547,55350,55084,384,15.208,340,13.465,9325,3363,5962,6.105,16.929,8877,4491,4386,8.153,16.116,448,0.813,32.231,254,256,3047
1981,4882,303,394,13109,13322,59,15.305,42,10.895,2608,1387,1221,10.412,19.577,2995,438,2557,3.288,22.482,-387,-2.905,39.155,25,25,288
1981,4883,2302,2726,123554,126192,377,14.107,270,10.103,22261,4479,17782,3.549,17.641,27461,4663,22798,3.695,21.761,-5200,-4.121,35.281,187,189,2415
1981,4884,2598,3162,41531,42062,466,14.724,472,14.913,6360,3301,3059,7.848,15.121,7364,2520,4844,5.991,17.507,-1004,-2.387,30.241,312,314,1455
1981,4885,4148,5899,81176,81158,855,14.808,605,10.478,15678,6316,9362,7.782,19.318,15880,4207,11673,5.184,19.567,-202,-0.249,38.636,404,408,2679
1981,4889,358,366,6044,6262,58,16.022,50,13.812,1192,493,699,7.874,19.037,1624,576,1048,9.199,25.936,-432,-6.899,38.074,42,42,229
1981,4921,1140,1739,60604,60333,363,21.743,224,13.417,8139,2558,5581,4.240,13.490,7544,2195,5349,3.638,12.504,595,0.986,25.008,174,174,1095
1981,4922,720,720,3444,3354,288,41.800,226,32.801,1401,852,549,25.403,41.771,1231,679,552,20.244,36.702,170,5.069,73.405,199,199,594
1981,4931,6297,9771,392058,393445,811,8.404,570,5.906,51546,20023,31523,5.089,13.101,54307,8464,45843,2.151,13.803,-2761,-0.702,26.202,281,283,1906
1981,5111,13235,14929,594343,590282,1797,12.179,1450,9.827,56042,16911,39131,2.865,9.494,48161,16131,32030,2.733,8.159,7881,1.335,16.318,1156,1162,8480
1981,5112,5474,6466,95787,87007,1972,33.956,655,11.279,32188,15447,16741,17.754,36.995,14555,6104,8451,7.016,16.729,17633,20.266,33.457,401,414,2392
1981,5121,8752,13999,189727,190496,1997,14.408,1720,12.409,48598,20488,28110,10.755,25.511,49890,14723,35167,7.729,26.190,-1292,-0.678,51.023,1004,1046,7012
1981,5122,1558,1563,11610,10756,431,29.602,217,14.904,3841,2200,1641,20.455,35.712,2137,898,1239,8.349,19.869,1704,15.843,39.738,148,148,625
1981,5151,5655,6666,201330,197265,678,10.311,497,7.558,29864,12034,17830,6.100,15.139,21878,7599,14279,3.852,11.091,7986,4.048,22.181,385,392,4988
1981,5152,12,12,53,56,D,D,3,24.000,13,D,11,D,23.423,17,9,8,16.216,30.631,-4,-7.207,46.847,3,3,9
1981,5173,2097,13730,981995,977863,415,3.004,586,4.242,215142,5422,209720,0.554,22.001,208844,5050,203794,0.516,21.357,6298,0.644,42.714,207,207,1576
1981,5174,612,1039,62456,45612,152,15.307,60,6.042,35984,3247,32737,7.119,78.892,2963,1164,1799,2.552,6.496,33021,72.395,12.992,33,33,421
1981,5179,1036,2155,82190,72853,313,14.859,216,10.254,28878,2514,26364,3.451,39.639,11334,3440,7894,4.722,15.557,17544,24.082,31.115,158,158,3051
1981,5182,5495,7192,198149,197534,1394,20.110,874,12.608,39394,16775,22619,8.492,19.943,38457,14289,24168,7.234,19.469,937,0.474,38.937,515,520,4497
1981,5191,2168,2551,28080,27625,257,10.259,165,6.587,3739,1089,2650,3.942,13.535,2783,703,2080,2.545,10.074,956,3.461,20.148,121,121,460
1981,5211,22,58,25204,24609,8,14.815,0,0.000,1342,234,1108,0.951,5.453,125,0,125,0.000,0.508,1217,4.945,1.016,0,0,0
1981,5221,21147,65208,1812880,1774734,3896,6.100,1210,1.895,185208,51596,133612,2.907,10.436,109012,21554,87458,1.214,6.142,76196,4.293,12.285,635,655,8099
1981,5222,23681,43672,350845,352369,3324,7.531,4253,9.636,56052,23404,32648,6.642,15.907,58914,24432,34482,6.934,16.719,-2862,-0.812,31.814,1556,1576,6380
1981,5223,2916,3270,42850,40458,694,21.513,606,18.785,11803,6116,5687,15.117,29.173,7151,3689,3462,9.118,17.675,4652,11.498,35.350,484,492,1926
1981,5231,4963,9358,218448,203644,1536,17.188,693,7.755,44844,10989,33855,5.396,22.021,15296,3727,11569,1.830,7.511,29548,14.510,15.022,464,466,2077
1981,5232,114,129,6436,6145,29,24.167,11,9.167,955,251,704,4.085,15.542,373,281,92,4.573,6.070,582,9.472,12.141,9,9,49
1981,5239,10379,10740,97882,90377,2339,22.648,1514,14.660,32924,12503,20421,13.834,36.430,17634,8391,9243,9.284,19.512,15290,16.918,39.023,1179,1180,4132
1981,5241,6214,30319,1259733,1243353,2449,8.127,2080,6.902,164602,67699,96903,5.445,13.239,131801,38686,93115,3.111,10.600,32801,2.638,21.201,404,436,2703
1981,5242,88512,93205,1082722,1028510,10432,11.266,9223,9.960,257964,54658,203306,5.314,25.081,151529,73005,78524,7.098,14.733,106435,10.348,29.466,6582,6589,40827
1981,5259,614,803,11946,11789,71,8.864,67,8.365,1817,378,1439,3.206,15.413,1549,289,1260,2.451,13.139,268,2.273,26.279,37,38,87
1981,5311,103582,105447,513742,510162,12877,12.086,15074,14.148,114914,53482,61432,10.483,22.525,107531,48427,59104,9.492,21.078,7383,1.447,42.156,12238,12305,36676
1981,5312,31722,32739,165918,164533,5727,17.375,6173,18.728,43941,21127,22814,12.841,26.707,41397,16329,25068,9.924,25.160,2544,1.546,50.321,4854,4863,12174
1981,5313,20924,21565,189088,185443,3723,17.173,3951,18.225,45012,17966,27046,9.688,24.273,37791,16853,20938,9.088,20.379,7221,3.894,40.758,3118,3126,10863
1981,5321,5476,9011,102195,101294,1200,13.372,1126,12.547,19540,7921,11619,7.820,19.290,18181,6793,11388,6.706,17.949,1359,1.342,35.897,713,725,3445
1981,5322,8706,10376,93980,90951,1980,19.575,1458,14.414,24588,11165,13423,12.276,27.034,18506,7636,10870,8.396,20.347,6082,6.687,40.694,1083,1090,4682
1981,5323,2235,2495,19864,18798,426,17.732,241,10.031,5252,2195,3057,11.677,27.940,3096,1081,2015,5.751,16.470,2156,11.470,32.941,170,170,682
1981,5324,3965,4510,47056,45314,759,17.390,468,10.723,12039,4989,7050,11.010,26.568,8498,2708,5790,5.976,18.754,3541,7.814,37.507,334,335,1116
1981,5331,885,936,9345,9539,167,18.044,146,15.775,2196,821,1375,8.607,23.021,2552,1144,1408,11.993,26.753,-356,-3.732,46.043,112,113,513
1981,5411,108950,112122,590636,568227,15626,14.259,10563,9.639,119399,49143,70256,8.648,21.013,74257,29877,44380,5.258,13.068,45142,7.944,26.136,7781,7816,21985
1981,5412,46714,49876,376293,358951,8303,17.102,5651,11.640,82544,35403,47141,9.863,22.996,47308,19256,28052,5.365,13.180,35236,9.816,26.359,4223,4265,14134
1981,5413,44244,48188,656826,636991,7998,17.061,5380,11.476,137295,48727,88568,7.650,21.554,97620,28573,69047,4.486,15.325,39675,6.229,30.650,3842,3877,16814
1981,5414,12453,12706,89462,86689,2851,23.763,1434,11.952,22570,10555,12015,12.176,26.036,16957,5983,10974,6.902,19.561,5613,6.475,39.122,1093,1096,3898
1981,5415,2904,3434,32086,30270,1347,39.781,1251,36.946,12092,6594,5498,21.784,39.948,8431,4971,3460,16.422,27.853,3661,12.095,55.706,1055,1061,3524
1981,5416,15460,16010,159444,156547,3437,21.335,3637,22.576,43724,17588,26136,11.235,27.930,38037,15872,22165,10.139,24.297,5687,3.633,48.595,2947,2963,11659
1981,5417,4361,5420,390159,386677,596,10.919,673,12.329,43792,10354,33438,2.678,11.325,36932,9715,27217,2.512,9.551,6860,1.774,19.102,446,450,2338
1981,5418,19468,21350,261667,257137,3573,17.108,2642,12.651,49280,19268,30012,7.493,19.165,40462,14677,25785,5.708,15.736,8818,3.429,31.471,2062,2075,9397
1981,5419,24349,26525,197540,186034,3848,14.910,2413,9.350,49452,19624,29828,10.549,26.582,25630,9600,16030,5.160,13.777,23822,12.805,27.554,1809,1817,6549
1981,5511,21463,41359,2768294,2713183,4934,12.260,2707,6.726,457415,157298,300117,5.798,16.859,346346,66479,279867,2.450,12.765,111069,4.094,25.531,565,576,5837
1981,5611,3973,4116,62811,62707,514,11.723,1051,23.971,13417,4719,8698,7.526,21.397,13238,5383,7855,8.584,21.111,179,0.285,42.222,827,829,4038
1981,5612,173,201,10731,12208,32,14.254,79,35.189,2344,1686,658,13.811,19.201,5241,2182,3059,17.874,42.933,-2897,-23.731,38.403,41,41,473
1981,5613,10230,13627,559941,569693,2524,19.082,1724,13.034,139588,49650,89938,8.715,24.502,159887,27555,132332,4.837,28.065,-20299,-3.563,49.005,1271,1281,15580
1981,5614,17673,19630,201111,195930,3631,19.204,2186,11.562,44054,17428,26626,8.895,22.485,33507,10530,22977,5.374,17.102,10547,5.383,34.203,1677,1696,7202
1981,5615,16664,19430,143170,140504,2747,14.574,1585,8.409,27838,11113,16725,7.909,19.813,22405,7732,14673,5.503,15.946,5433,3.867,31.892,1144,1176,5532
1981,5616,12379,14441,385242,378034,3336,24.714,1451,10.749,94497,40368,54129,10.678,24.997,79961,25413,54548,6.722,21.152,14536,3.845,42.304,1029,1041,12060
1981,5617,50261,52949,659697,651339,11360,21.825,9562,18.371,154756,57710,97046,8.860,23.760,137222,48594,88628,7.461,21.068,17534,2.692,42.135,7611,7634,34826
1981,5619,13003,13857,156396,148154,3344,26.050,1304,10.158,44176,21401,22775,14.445,29.818,27742,9085,18657,6.132,18.725,16434,11.093,37.450,914,916,5390
1981,5621,5381,5496,98921,99682,655,11.836,731,13.209,13481,3546,9935,3.557,13.524,15073,4959,10114,4.975,15.121,-1592,-1.597,27.048,591,594,3409
1981,5622,1951,2370,39036,38191,303,12.999,225,9.653,6470,2805,3665,7.345,16.941,4821,1606,3215,4.205,12.624,1649,4.318,25.247,152,152,883
1981,5629,3928,4140,36534,35994,638,15.569,554,13.519,8540,3392,5148,9.424,23.727,7430,2488,4942,6.912,20.643,1110,3.084,41.285,440,440,1817
1981,6111,12878,13220,350176,344802,657,4.981,599,4.541,36530,6878,29652,1.995,10.594,25733,6500,19233,1.885,7.463,10797,3.131,14.926,446,449,4032
1981,6112,449,517,35140,34600,28,5.442,23,4.470,4448,963,3485,2.783,12.856,3400,249,3151,0.720,9.827,1048,3.029,19.653,13,13,110
1981,6113,1962,2225,872270,849978,106,4.795,77,3.483,83164,3044,80120,0.358,9.784,37935,2000,35935,0.235,4.463,45229,5.321,8.926,44,46,451
1981,6114,1595,1775,29871,28663,284,16.091,264,14.958,6816,1879,4937,6.555,23.780,4426,2060,2366,7.187,15.442,2390,8.338,30.883,210,215,1397
1981,6115,4141,4661,46563,45703,601,13.079,469,10.207,9450,3227,6223,7.061,20.677,7664,2663,5001,5.827,16.769,1786,3.908,33.539,352,355,1852
1981,6116,10410,10888,107155,106581,1974,18.252,1828,16.902,24157,8999,15158,8.443,22.665,23270,7761,15509,7.282,21.833,887,0.832,43.666,1447,1457,5957
1981,6117,743,749,8699,8544,108,13.999,153,19.831,2168,608,1560,7.117,25.376,1858,700,1158,8.193,21.748,310,3.628,43.495,127,127,500
1981,6211,162059,166470,905430,880715,18406,11.369,9247,5.712,158804,67129,91675,7.622,18.031,109553,31604,77949,3.588,12.439,49251,5.592,24.878,7033,7075,23691
1981,6212,88485,89945,375338,365700,6607,7.451,4073,4.593,64194,20978,43216,5.736,17.554,44876,12327,32549,3.371,12.271,19318,5.282,24.543,3117,3137,9520
1981,6213,33120,34425,107551,102346,5349,16.107,2917,8.784,27612,13659,13953,13.346,26.979,17126,7186,9940,7.021,16.733,10486,10.246,33.467,2211,2220,5605
1981,6214,4653,5882,89516,85665,889,15.685,461,8.133,18622,7506,11116,8.762,21.738,10737,3912,6825,4.567,12.534,7885,9.205,25.068,331,333,2430
1981,6215,3809,4787,61577,59888,568,11.989,469,9.900,11292,3739,7553,6.243,18.855,7874,3578,4296,5.975,13.148,3418,5.707,26.296,313,324,1897
1981,6216,2772,3550,119340,107679,634,18.757,294,8.698,38467,15185,23282,14.102,35.724,14585,4048,10537,3.759,13.545,23882,22.179,27.090,162,162,1028
1981,6219,2634,2999,52693,51494,597,20.977,291,10.225,13098,5326,7772,10.343,25.436,10650,3498,7152,6.793,20.682,2448,4.754,41.364,191,191,2131
1981,6221,4073,5040,2905865,2832095,229,4.574,163,3.255,233533,51352,182181,1.813,8.246,84418,31302,53116,1.105,2.981,149115,5.265,5.962,108,110,21987
1981,6222,363,461,86093,86497,49,10.938,23,5.134,7638,2266,5372,2.620,8.830,8220,3428,4792,3.963,9.503,-582,-0.673,17.661,14,15,2861
1981,6223,200,228,49055,47415,22,10.000,6,2.727,4355,900,3455,1.898,9.185,1117,204,913,0.430,2.356,3238,6.829,4.712,D,D,D
1981,6231,8445,11462,886334,861231,1014,9.013,591,5.253,128273,62835,65438,7.296,14.894,76995,32023,44972,3.718,8.940,51278,5.954,17.880,427,439,22422
1981,6232,3275,4186,97781,93096,633,15.823,262,6.549,19370,8015,11355,8.609,20.806,9968,3564,6404,3.828,10.707,9402,10.099,21.414,203,204,2536
1981,6233,6556,7506,216101,210818,1020,13.898,686,9.347,34970,16321,18649,7.742,16.588,24407,11080,13327,5.256,11.577,10563,5.010,23.155,485,499,8200
1981,6239,2485,3016,76498,73128,329,11.168,189,6.415,13528,4084,9444,5.585,18.499,7012,2457,4555,3.360,9.589,6516,8.910,19.177,140,141,1769
1981,6241,11227,15454,244158,237732,1791,11.875,1048,6.948,46587,13575,33012,5.710,19.596,33782,7020,26762,2.953,14.210,12805,5.386,28.420,679,685,3571
1981,6242,3185,3818,45922,43500,414,11.099,238,6.381,9912,3385,6527,7.782,22.786,5055,1337,3718,3.074,11.621,4857,11.166,23.242,144,147,795
1981,6243,3379,4941,226656,226272,585,12.073,394,8.131,43239,12510,30729,5.529,19.109,41584,7241,34343,3.200,18.378,1655,0.731,36.756,183,186,2303
1981,6244,24940,29251,245743,241953,4119,14.357,2998,10.449,48789,21498,27291,8.885,20.165,41147,14698,26449,6.075,17.006,7642,3.158,34.012,2313,2335,9997
1981,7111,4242,4278,55613,53867,822,19.417,733,17.314,16702,6829,9873,12.678,31.006,13206,3763,9443,6.986,24.516,3496,6.490,49.032,520,520,2168
1981,7112,1992,2076,56798,56488,362,17.416,367,17.657,12180,4143,8037,7.334,21.562,11672,4106,7566,7.269,20.663,508,0.899,41.326,294,295,2815
1981,7113,1878,1911,29604,28470,327,17.094,331,17.303,9142,4028,5114,14.148,32.111,6682,2472,4210,8.683,23.470,2460,8.641,46.941,244,247,1698
1981,7114,1101,1113,11640,11399,249,23.315,159,14.888,3698,1919,1779,16.835,32.441,3322,1356,1966,11.896,29.143,376,3.299,58.286,119,119,985
1981,7115,5931,5949,53827,52329,1742,30.966,1095,19.465,13936,6584,7352,12.582,26.632,11004,3723,7281,7.115,21.028,2932,5.603,42.057,798,798,2449
1981,7121,1846,1961,33486,32521,150,7.665,142,7.256,5297,616,4681,1.894,16.288,3510,780,2730,2.398,10.793,1787,5.495,21.586,94,94,474
1981,7131,1498,1791,49201,49942,330,19.220,182,10.600,5368,1567,3801,3.138,10.749,6616,801,5815,1.604,13.247,-1248,-2.499,21.497,146,149,618
1981,7132,690,706,16972,16644,139,20.262,99,14.431,3623,1440,2183,8.652,21.768,2942,926,2016,5.564,17.676,681,4.092,35.352,78,78,782
1981,7139,28948,30478,438175,430320,3768,12.505,3078,10.215,81534,32704,48830,7.600,18.947,65410,19328,46082,4.492,15.200,16124,3.747,30.401,2291,2302,13228
1981,7211,28953,32908,1048297,1037047,3925,11.887,4148,12.562,194976,94871,100105,9.148,18.801,172679,59736,112943,5.760,16.651,22297,2.150,33.302,3117,3149,40296
1981,7212,3336,3547,18051,18057,464,13.117,445,12.580,4191,1558,2633,8.628,23.210,4205,1579,2626,8.745,23.288,-14,-0.078,46.421,315,315,1189
1981,7213,5330,5409,30773,31293,322,5.840,532,9.648,4096,945,3151,3.020,13.089,5111,2390,2721,7.638,16.333,-1015,-3.244,26.179,393,394,1972
1981,7223,12179,15189,259368,258335,2669,17.748,2368,15.746,57015,30903,26112,11.962,22.070,55011,22771,32240,8.815,21.294,2004,0.776,42.589,1744,1746,14207
1981,7224,63217,63989,349001,349079,9503,14.713,10703,16.571,95280,49706,45574,14.239,27.295,95261,43696,51565,12.518,27.289,19,0.005,54.579,8325,8349,33353
1981,7225,181470,236770,4053302,4008137,38685,16.510,33762,14.409,899926,518667,381259,12.940,22.452,809477,329451,480026,8.220,20.196,90449,2.257,40.392,24561,25178,222753
1981,8111,87620,91384,416499,418835,13973,15.326,13552,14.864,90207,43662,46545,10.425,21.538,95040,40476,54564,9.664,22.692,-4833,-1.154,43.075,10425,10470,31534
1981,8112,9532,10588,63451,62906,1247,11.622,1530,14.260,12605,6465,6140,10.277,20.038,11695,4822,6873,7.665,18.591,910,1.447,37.182,1207,1208,3040
1981,8113,17818,19037,152986,149653,2764,14.718,2249,11.976,32132,12701,19431,8.487,21.471,25539,8784,16755,5.870,17.066,6593,4.406,34.131,1670,1670,6051
1981,8114,21068,22682,135842,136167,3523,15.530,3529,15.557,26570,10999,15571,8.078,19.513,27174,10680,16494,7.843,19.956,-604,-0.444,39.026,2655,2657,7055
1981,8121,80461,88659,396463,399168,11404,12.738,13134,14.671,81160,40574,40586,10.165,20.332,86162,37751,48411,9.457,21.585,-5002,-1.253,40.665,10357,10480,29831
1981,8122,17401,19816,111162,110162,1237,6.214,1419,7.128,16442,4879,11563,4.429,14.925,14333,4395,9938,3.990,13.011,2109,1.914,26.022,1008,1040,3242
1981,8123,32926,38613,334434,335849,3953,10.175,4431,11.405,49098,19405,29693,5.778,14.619,51797,20540,31257,6.116,15.423,-2699,-0.804,29.238,3382,3524,15685
1981,8129,14356,20403,231037,211660,3973,20.155,2591,13.144,69218,27034,42184,12.772,32.703,31275,13927,17348,6.580,14.776,37943,17.926,29.552,1559,1614,8166
1981,8131,72049,72147,673961,664246,4376,6.126,2947,4.126,90232,18991,71241,2.859,13.584,71214,10574,60640,1.592,10.721,19018,2.863,21.442,1237,1237,4318
1981,8132,6957,7875,127024,126271,904,11.708,597,7.732,22197,7102,15095,5.624,17.579,20822,6324,14498,5.008,16.490,1375,1.089,32.980,406,407,3082
1981,8133,6662,7860,101777,100643,968,12.548,677,8.776,21746,7708,14038,7.659,21.607,19289,4270,15019,4.243,19.166,2457,2.441,38.332,431,440,2657
1981,8134,27950,29209,240150,238942,1786,6.123,1704,5.842,34282,8302,25980,3.474,14.347,31699,5083,26616,2.127,13.266,2583,1.081,26.533,1223,1224,3490
1981,8139,54954,57125,420064,425105,4265,7.463,4309,7.540,69825,16647,53178,3.916,16.425,79767,21282,58485,5.006,18.764,-9942,-2.339,32.851,3118,3126,16370
1982,1131,185,191,2187,2157,29,14.834,38,19.437,416,161,255,7.466,19.291,355,90,265,4.173,16.462,61,2.829,32.924,30,30,69
1982,1132,84,99,1699,1357,12,12.121,12,12.121,917,48,869,3.539,67.600,207,62,145,4.571,15.260,710,52.341,30.520,7,7,30
1982,1133,9891,10002,79593,84581,1266,12.131,2135,20.457,15095,5209,9886,6.159,17.847,24986,8387,16599,9.916,29.541,-9891,-11.694,35.694,1456,1456,5738
1982,1141,1355,1392,9681,9690,240,17.027,275,19.510,3219,960,2259,9.907,33.220,3217,1242,1975,12.817,33.199,2,0.021,66.398,214,214,996
1982,1142,130,132,696,634,28,21.622,23,17.761,297,209,88,32.991,46.882,178,80,98,12.628,28.098,119,18.785,56.196,18,18,60
1982,1151,3984,4419,54737,53444,623,14.177,574,13.062,16418,6208,10210,11.616,30.720,13742,4455,9287,8.336,25.713,2676,5.007,51.426,393,397,3115
1982,1152,1651,1673,11618,11220,262,15.698,254,15.219,3066,1292,1774,11.515,27.326,2277,1081,1196,9.635,20.294,789,7.032,40.588,189,190,571
1982,1153,693,706,9516,9349,140,19.580,158,22.098,3358,1991,1367,21.298,35.920,3130,1226,1904,13.114,33.481,228,2.439,66.963,108,108,798
1982,2111,7509,9559,184204,174010,1738,18.902,1010,10.984,52123,18439,33684,10.597,29.954,31713,12011,19702,6.902,18.225,20410,11.729,36.450,621,635,3995
1982,2121,3136,3870,240268,237027,826,21.700,699,18.363,42987,16802,26185,7.089,18.136,35988,14638,21350,6.176,15.183,6999,2.953,30.366,487,489,6569
1982,2122,665,843,70102,78332,208,25.045,183,22.035,5308,2549,2759,3.254,6.776,21886,3564,18322,4.550,27.940,-16578,-21.164,13.553,118,118,1246
1982,2123,3558,5008,104001,108836,347,6.852,460,9.083,14578,2966,11612,2.725,13.395,24465,5221,19244,4.797,22.479,-9887,-9.084,26.789,269,269,1789
1982,2131,11914,13531,416774,388744,3667,29.209,1714,13.652,143837,49789,94048,12.808,37.000,88565,37522,51043,9.652,22.782,55272,14.218,45.565,1259,1263,18605
1982,2211,1567,5718,570063,559429,107,1.873,94,1.646,34907,4061,30846,0.726,6.240,13877,2157,11720,0.386,2.481,21030,3.759,4.961,41,41,373
1982,2212,528,2360,144762,142804,64,2.714,60,2.545,9930,2502,7428,1.752,6.954,6248,778,5470,0.545,4.375,3682,2.578,8.750,31,31,147
1982,2213,3860,4162,32773,33286,278,6.674,285,6.842,3110,898,2212,2.698,9.343,4063,1857,2206,5.579,12.207,-953,-2.863,18.687,210,210,1070
1982,2361,80715,81118,423452,476298,12862,14.644,26288,29.930,118820,48580,70240,10.200,24.947,224373,97586,126787,20.488,47.108,-105553,-22.161,49.893,18220,18222,72108
1982,2362,30511,31083,546044,565056,4220,13.320,5419,17.104,128892,32368,96524,5.728,22.811,167687,36439,131248,6.449,29.676,-38795,-6.866,45.621,3922,3924,27682
1982,2371,12821,13145,297872,303743,1486,11.140,1874,14.049,66018,17473,48545,5.753,21.735,77760,16579,61181,5.458,25.601,-11742,-3.866,43.470,1341,1345,10733
1982,2372,6922,7012,46690,50532,1666,23.265,1964,27.426,14287,7448,6839,14.739,28.273,22079,10729,11350,21.232,43.693,-7792,-15.420,56.546,1455,1455,7281
1982,2373,9622,9880,187815,201045,891,8.808,1362,13.464,33903,7859,26044,3.909,16.863,60490,11470,49020,5.705,30.088,-26587,-13.224,33.727,956,957,6908
1982,2379,4322,4393,117532,118457,700,15.550,917,20.371,23815,5262,18553,4.442,20.104,25424,5189,20235,4.380,21.463,-1609,-1.358,40.209,669,669,3409
1982,2381,59223,59632,506017,531949,7608,12.273,12323,19.879,131446,37416,94030,7.034,24.710,183804,56974,126830,10.710,34.553,-52358,-9.843,49.421,8205,8210,38624
1982,2382,92993,94913,964661,980409,11249,11.726,13291,13.854,199066,49310,149756,5.030,20.304,231319,57926,173393,5.908,23.594,-32253,-3.290,40.609,9787,9791,43951
1982,2383,60350,60791,454317,478632,9005,14.239,13906,21.989,117476,36891,80585,7.708,24.544,165947,52209,113738,10.908,34.671,-48471,-10.127,49.088,9664,9668,38944
1982,2389,32917,33141,346363,350965,4606,13.621,5955,17.610,90189,22806,67383,6.498,25.697,98665,24776,73889,7.059,28.113,-8476,-2.415,51.395,4080,4080,17704
1982,3111,1381,2029,57654,58730,113,5.500,164,7.982,6373,2364,4009,4.025,10.851,8433,3011,5422,5.127,14.359,-2060,-3.508,21.703,96,96,867
1982,3112,524,885,81982,82849,50,5.612,62,6.958,7091,2098,4993,2.532,8.559,8736,1931,6805,2.331,10.544,-1645,-1.986,17.118,37,37,639
1982,3113,1348,1738,92109,91712,204,11.888,160,9.324,11751,1412,10339,1.540,12.813,10947,3053,7894,3.329,11.936,804,0.877,23.873,85,85,470
1982,3114,1190,1635,170432,173623,98,5.927,135,8.164,16852,3246,13606,1.870,9.706,23242,5422,17820,3.123,13.387,-6390,-3.680,19.412,75,76,1569
1982,3115,1841,2576,139795,140986,104,3.962,202,7.695,13023,2704,10319,1.918,9.237,15494,4310,11184,3.057,10.990,-2471,-1.753,18.474,123,123,1248
1982,3116,4225,4784,291568,293706,321,6.610,466,9.595,30667,7059,23608,2.403,10.441,35166,10587,24579,3.605,11.973,-4499,-1.532,20.883,339,343,4123
1982,3117,787,915,58756,58415,81,8.752,102,11.021,10528,1993,8535,3.412,18.023,9610,2904,6706,4.971,16.451,918,1.572,32.903,58,58,1038
1982,3118,8124,9649,299493,297032,1213,12.635,1116,11.624,37042,10747,26295,3.618,12.471,31788,11510,20278,3.875,10.702,5254,1.769,21.404,791,815,5965
1982,3119,2023,2413,128858,126672,253,10.628,188,7.898,19424,4267,15157,3.369,15.334,14707,4898,9809,3.867,11.610,4717,3.724,23.221,136,137,1859
1982,3121,2040,2614,179900,181288,159,5.984,245,9.221,16295,3967,12328,2.188,8.988,18968,6070,12898,3.348,10.463,-2673,-1.474,17.977,173,175,2920
1982,3122,107,169,45670,46658,9,5.217,16,9.275,2312,207,2105,0.444,4.955,4208,914,3294,1.959,9.019,-1896,-4.064,9.911,7,7,54
1982,3131,436,675,106536,111687,36,5.263,54,7.895,6990,2959,4031,2.649,6.259,17141,4339,12802,3.885,15.347,-10151,-9.089,12.517,27,27,942
1982,3132,1658,2069,312597,325215,134,6.398,185,8.833,14924,4277,10647,1.315,4.589,40315,7888,32427,2.425,12.396,-25391,-7.807,9.178,128,128,2767
1982,3133,3835,4302,132800,136889,319,7.548,168,3.975,11790,2913,8877,2.128,8.613,20091,4359,15732,3.184,14.677,-8301,-6.064,17.226,97,98,2006
1982,3141,3985,4264,101186,105046,441,10.120,628,14.412,11048,3566,7482,3.395,10.517,18752,4952,13800,4.714,17.851,-7704,-7.334,21.035,485,489,3399
1982,3149,3329,3448,120322,121075,357,10.238,435,12.475,18571,5477,13094,4.524,15.338,20291,6716,13575,5.547,16.759,-1720,-1.421,30.677,350,351,4192
1982,3151,1360,1486,142497,145925,92,6.091,141,9.335,12324,2662,9662,1.824,8.445,19278,3744,15534,2.566,13.211,-6954,-4.765,16.891,106,106,1801
1982,3152,15468,17351,1073486,1089282,1947,11.159,2142,12.276,142044,45912,96132,4.215,13.040,173140,58893,114247,5.407,15.895,-31096,-2.855,26.080,1725,1742,38564
1982,3159,1531,1635,58062,60464,174,10.561,199,12.079,7085,2028,5057,3.354,11.718,11993,2674,9319,4.422,19.835,-4908,-8.117,23.435,155,158,1459
1982,3161,334,378,19389,20109,29,7.562,40,10.430,2080,708,1372,3.521,10.344,3511,810,2701,4.028,17.460,-1431,-7.116,20.688,27,27,456
1982,3162,509,743,136534,140942,65,8.713,71,9.517,13055,3107,9948,2.204,9.263,22074,5038,17036,3.575,15.662,-9019,-6.399,18.525,45,46,2182
1982,3169,1304,1349,55420,56515,135,9.919,159,11.683,7068,1505,5563,2.663,12.506,9228,2378,6850,4.208,16.328,-2160,-3.822,25.013,130,130,1361
1982,3211,4932,5471,123209,135130,389,6.802,885,15.475,12565,4539,8026,3.359,9.298,36581,7916,28665,5.858,27.071,-24016,-17.773,18.597,614,616,4516
1982,3212,990,1293,79814,87327,66,4.925,160,11.940,5344,1553,3791,1.778,6.120,20544,4176,16368,4.782,23.525,-15200,-17.406,12.239,116,116,1466
1982,3219,8431,9162,233628,248947,963,10.412,1137,12.293,28677,9999,18678,4.017,11.519,59123,17040,42083,6.845,23.749,-30446,-12.230,23.039,819,822,8589
1982,3221,267,602,199039,202540,14,2.256,51,8.219,5745,838,4907,0.414,2.836,12670,2420,10250,1.195,6.256,-6925,-3.419,5.673,21,21,271
1982,3222,3611,5216,404600,411036,259,4.957,276,5.283,32075,5278,26797,1.284,7.803,44780,8636,36144,2.101,10.894,-12705,-3.091,15.607,174,180,2547
1982,3231,33321,34852,682292,680813,3905,11.353,2995,8.707,84496,23030,61466,3.383,12.411,81595,24581,57014,3.611,11.985,2901,0.426,23.970,2333,2338,15091
1982,3241,1366,2212,150259,156474,203,9.236,175,7.962,10530,3299,7231,2.108,6.730,22690,6068,16622,3.878,14.501,-12160,-7.771,13.459,91,95,1441
1982,3251,1143,2229,233549,233611,195,8.766,186,8.361,17369,4867,12502,2.083,7.435,17624,3116,14508,1.334,7.544,-255,-0.109,14.870,96,96,767
1982,3252,358,597,148267,152040,46,7.686,49,8.187,5983,1773,4210,1.166,3.935,13505,3599,9906,2.367,8.883,-7522,-4.947,7.870,25,25,244
1982,3253,734,1086,53826,54775,75,6.871,86,7.879,3944,1569,2375,2.864,7.200,5818,1649,4169,3.010,10.622,-1874,-3.421,14.401,46,46,372
1982,3254,960,1194,157302,158016,96,8.088,82,6.908,13795,2096,11699,1.326,8.730,15189,4301,10888,2.722,9.612,-1394,-0.882,17.460,45,45,742
1982,3255,1641,2086,73172,75651,118,5.602,159,7.548,5702,1256,4446,1.660,7.537,10698,2909,7789,3.845,14.141,-4996,-6.604,15.074,96,96,895
1982,3256,1991,2244,127240,127516,159,6.998,215,9.463,13891,4654,9237,3.650,10.894,14470,3597,10873,2.821,11.348,-579,-0.454,21.787,144,146,1753
1982,3259,1645,2137,93033,93033,220,10.336,203,9.537,11089,3067,8022,3.297,11.919,11014,3377,7637,3.630,11.839,75,0.081,23.678,107,107,916
1982,3261,9957,11418,491148,502080,1040,9.147,944,8.303,58387,18426,39961,3.670,11.629,80045,21868,58177,4.355,15.943,-21658,-4.314,23.258,667,674,10111
1982,3262,1850,2218,183855,189508,155,6.993,152,6.858,10850,2918,7932,1.540,5.725,22381,3978,18403,2.099,11.810,-11531,-6.085,11.451,105,105,1108
1982,3271,1291,1585,76511,82135,176,10.979,212,13.225,6560,2362,4198,2.876,7.987,17866,3381,14485,4.116,21.752,-11306,-13.765,15.974,145,145,957
1982,3272,1464,1742,155803,163792,180,10.297,192,10.984,9300,3009,6291,1.837,5.678,25268,3973,21295,2.426,15.427,-15968,-9.749,11.356,137,139,1403
1982,3273,7209,9119,164589,174241,552,5.983,765,8.292,19892,5108,14784,2.932,11.416,39343,7934,31409,4.553,22.580,-19451,-11.163,22.833,505,512,4894
1982,3274,247,346,16499,17574,40,11.429,48,13.714,730,389,341,2.213,4.154,2921,522,2399,2.970,16.621,-2191,-12.467,8.308,39,39,165
1982,3279,1842,2118,80206,84565,156,7.237,231,10.717,6497,2134,4363,2.524,7.683,15293,3261,12032,3.856,18.084,-8796,-10.401,15.366,158,162,1558
1982,3311,414,495,314613,344869,75,15.789,35,7.368,5393,1057,4336,0.306,1.564,65944,4138,61806,1.200,19.121,-60551,-17.558,3.128,19,19,645
1982,3312,507,690,87197,90170,37,5.351,40,5.785,8009,1189,6820,1.319,8.882,14294,1658,12636,1.839,15.852,-6285,-6.970,17.764,24,24,411
1982,3313,288,443,90827,96723,25,5.688,18,4.096,3279,700,2579,0.724,3.390,15026,925,14101,0.956,15.535,-11747,-12.145,6.780,9,9,198
1982,3314,786,989,109391,115754,94,9.438,108,10.843,5654,1126,4528,0.973,4.884,18114,3154,14960,2.725,15.649,-12460,-10.764,9.769,76,77,1032
1982,3315,2834,3196,253530,268761,150,4.632,235,7.256,16359,4110,12249,1.529,6.087,47010,9133,37877,3.398,17.491,-30651,-11.405,12.174,168,168,2799
1982,3321,3122,3354,152303,159212,224,6.705,198,5.926,11751,2663,9088,1.673,7.381,25552,5724,19828,3.595,16.049,-13801,-8.668,14.761,140,140,1845
1982,3322,1220,1359,84182,88920,98,7.238,88,6.499,5122,746,4376,0.839,5.760,14559,2562,11997,2.881,16.373,-9437,-10.613,11.521,64,64,928
1982,3323,9942,10818,348284,361286,794,7.294,930,8.543,40436,10542,29894,2.918,11.192,66554,14366,52188,3.976,18.421,-26118,-7.229,22.384,682,684,6842
1982,3324,1455,1849,151502,155473,120,6.481,125,6.751,13395,3399,9996,2.186,8.616,21358,3734,17624,2.402,13.737,-7963,-5.122,17.231,78,78,1013
1982,3325,906,979,70068,75638,84,8.615,76,7.795,4863,2315,2548,3.061,6.429,16243,3161,13082,4.179,21.475,-11380,-15.045,12.859,45,45,388
1982,3326,1565,1773,63013,66762,112,6.289,128,7.187,6471,1858,4613,2.783,9.693,14188,5809,8379,8.701,21.252,-7717,-11.559,19.385,93,94,4890
1982,3327,20882,21213,328125,337538,2374,11.309,1931,9.199,42473,13551,28922,4.015,12.583,61520,18789,42731,5.566,18.226,-19047,-5.643,25.166,1532,1533,13331
1982,3328,5328,5626,118471,120530,428,7.595,447,7.932,15030,4057,10973,3.366,12.470,19080,4330,14750,3.592,15.830,-4050,-3.360,24.940,336,338,2445
1982,3329,5282,5835,362273,367508,633,11.039,431,7.517,33743,10667,23076,2.903,9.182,44246,7401,36845,2.014,12.039,-10503,-2.858,18.363,294,294,2631
1982,3331,3321,3799,381178,391782,423,11.259,339,9.023,37953,7860,30093,2.006,9.687,59062,9887,49175,2.524,15.075,-21109,-5.388,19.375,239,239,4279
1982,3332,3684,3952,180741,190334,275,6.970,262,6.640,13581,3819,9762,2.006,7.135,32557,5846,26711,3.071,17.105,-18976,-9.970,14.271,187,187,2041
1982,3333,1946,2083,167071,169975,165,7.944,153,7.366,18341,6454,11887,3.797,10.790,23760,4192,19568,2.466,13.979,-5419,-3.188,21.581,98,98,936
1982,3334,1924,2156,172845,180972,211,9.708,246,11.318,17125,6602,10523,3.648,9.463,33201,8693,24508,4.804,18.346,-16076,-8.883,18.926,184,186,1727
1982,3335,9403,9872,261864,272294,731,7.403,735,7.444,22767,7038,15729,2.585,8.361,43377,10608,32769,3.896,15.930,-20610,-7.569,16.722,565,565,4218
1982,3336,717,880,170822,176143,43,4.909,35,3.995,9567,1130,8437,0.642,5.431,19926,1174,18752,0.667,11.312,-10359,-5.881,10.863,24,24,371
1982,3339,5419,6015,358643,368757,465,7.738,453,7.539,28901,6578,22323,1.784,7.837,48864,8130,40734,2.205,13.251,-19963,-5.414,15.675,320,322,4364
1982,3341,1408,1657,405085,397975,304,19.338,134,8.524,50964,12169,38795,3.058,12.806,36825,5340,31485,1.342,9.253,14139,3.553,18.506,96,96,1271
1982,3342,1753,1913,214102,211296,254,13.594,165,8.831,31598,8158,23440,3.861,14.954,25986,8596,17390,4.068,12.298,5612,2.656,24.597,104,104,2430
1982,3343,423,454,51982,54681,46,9.903,67,14.424,4332,726,3606,1.328,7.922,9774,1699,8075,3.107,17.875,-5442,-9.952,15.845,52,52,534
1982,3344,3827,4345,458637,459990,597,14.069,394,9.285,52661,14364,38297,3.123,11.448,55590,11696,43894,2.543,12.085,-2929,-0.637,22.897,282,284,5526
1982,3345,3706,4272,635249,627588,416,9.835,332,7.849,71245,14665,56580,2.337,11.352,55486,16223,39263,2.585,8.841,15759,2.511,17.682,220,220,2850
1982,3346,576,600,16782,18054,98,16.526,84,14.165,3178,1426,1752,7.899,17.603,5706,2043,3663,11.316,31.606,-2528,-14.003,35.206,58,58,787
1982,3351,1213,1340,84888,87803,94,6.958,116,8.586,6955,1726,5229,1.966,7.921,12928,3087,9841,3.516,14.724,-5973,-6.803,15.842,83,85,1320
1982,3352,348,456,119888,131252,40,8.811,36,7.930,3981,631,3350,0.481,3.033,26888,2195,24693,1.672,20.486,-22907,-17.453,6.066,21,21,140
1982,3353,1967,2472,275005,282151,193,7.860,160,6.516,23840,6107,17733,2.164,8.449,38393,5080,33313,1.800,13.607,-14553,-5.158,16.899,100,100,1411
1982,3359,1773,2177,209499,213027,217,10.128,148,6.908,20109,4673,15436,2.194,9.440,27063,4943,22120,2.320,12.704,-6954,-3.264,18.879,99,99,1321
1982,3361,172,229,227776,236294,30,12.903,37,15.914,18896,3040,15856,1.287,7.997,36246,506,35740,0.214,15.339,-17350,-7.343,15.994,29,29,269
1982,3362,1615,1791,90678,95266,152,8.333,218,11.952,10108,2004,8104,2.104,10.610,19062,5686,13376,5.969,20.009,-8954,-9.399,21.221,156,156,1570
1982,3363,3478,4198,552155,583810,318,7.549,347,8.237,30928,5697,25231,0.976,5.298,95697,9574,86123,1.640,16.392,-64769,-11.094,10.595,238,238,2749
1982,3364,1205,1433,648406,668684,109,7.644,95,6.662,48705,13895,34810,2.078,7.284,87714,35426,52288,5.298,13.117,-39009,-5.834,14.567,72,72,1001
1982,3365,175,204,41527,48836,13,6.265,20,9.639,925,452,473,0.926,1.894,15401,5825,9576,11.928,31.536,-14476,-29.642,3.788,6,6,61
1982,3366,1145,1240,200269,205373,117,9.334,144,11.488,18450,2705,15745,1.317,8.984,28492,4121,24371,2.007,13.873,-10042,-4.890,17.967,102,104,2019
1982,3369,411,422,28592,28599,62,14.486,74,17.290,3188,1427,1761,4.990,11.147,3088,1049,2039,3.668,10.798,100,0.350,21.595,54,54,603
1982,3371,11789,12384,333874,352385,1376,10.893,1873,14.827,32750,10601,22149,3.008,9.294,69517,20201,49316,5.733,19.728,-36767,-10.434,18.588,1407,1416,12228
1982,3372,2347,2480,120003,122184,200,8.005,237,9.486,13006,3344,9662,2.737,10.645,17204,4537,12667,3.713,14.080,-4198,-3.436,21.289,183,184,2707
1982,3379,1051,1182,36327,37729,90,7.519,120,10.025,3738,1206,2532,3.197,9.908,6521,1825,4696,4.837,17.284,-2783,-7.376,19.815,101,101,962
1982,3391,9519,10062,213299,211270,1327,13.371,1052,10.600,28957,10197,18760,4.827,13.706,24958,7270,17688,3.441,11.813,3999,1.893,23.627,799,803,3274
1982,3399,14004,14637,409302,419103,1780,12.164,1773,12.116,56103,18323,37780,4.372,13.386,75664,21537,54127,5.139,18.054,-19561,-4.667,26.773,1372,1375,12423
1982,4231,18601,21969,241836,247268,2101,9.494,2421,10.940,33700,11585,22115,4.685,13.629,44763,15432,29331,6.241,18.103,-11063,-4.474,27.258,1612,1633,7830
1982,4232,7235,8269,89521,90178,1016,12.272,1036,12.514,16730,5549,11181,6.153,18.552,17801,7542,10259,8.363,19.740,-1071,-1.188,37.104,683,689,3273
1982,4233,7115,9037,101185,105526,942,10.258,1235,13.448,16491,5353,11138,5.073,15.628,25152,8097,17055,7.673,23.835,-8661,-8.207,31.255,789,794,3763
1982,4234,18966,26139,435800,433764,4087,16.076,2656,10.447,85721,33256,52465,7.667,19.762,82561,28889,53672,6.660,19.034,3160,0.729,38.067,1585,1610,9786
1982,4235,6508,9044,138069,139437,976,10.863,857,9.539,20687,7229,13458,5.184,14.836,23384,6426,16958,4.609,16.770,-2697,-1.934,29.672,478,480,2829
1982,4236,13597,19321,248688,245990,2387,12.489,1971,10.312,50811,19434,31377,7.900,20.656,45272,16085,29187,6.539,18.404,5539,2.252,36.808,1183,1211,6643
1982,4237,10198,13215,143525,144454,1177,8.912,1162,8.798,22026,7298,14728,5.052,15.248,23864,7061,16803,4.888,16.520,-1838,-1.272,30.496,778,798,4484
1982,4238,46063,60204,669513,676804,5980,10.006,5101,8.535,100853,33471,67382,4.945,14.901,115580,35020,80560,5.174,17.077,-14727,-2.176,29.803,3212,3265,17737
1982,4239,21053,22768,208537,213912,3362,14.745,3428,15.034,39883,15839,24044,7.404,18.645,50535,16776,33759,7.842,23.624,-10652,-4.980,37.289,2606,2637,12031
1982,4241,7369,9908,143843,140530,1101,11.288,793,8.130,27600,7221,20379,5.138,19.640,20932,7501,13431,5.338,14.895,6668,4.745,29.790,474,484,3071
1982,4242,2576,3296,90624,89554,427,12.983,413,12.557,15903,5974,9929,6.671,17.758,13760,4697,9063,5.245,15.365,2143,2.393,30.730,288,290,1752
1982,4243,8536,9227,96111,96045,1461,15.821,1476,15.984,23514,8462,15052,8.810,24.482,23655,10515,13140,10.948,24.629,-141,-0.147,48.965,1080,1093,5061
1982,4244,26121,32143,574442,570149,3458,10.746,3531,10.973,95653,32134,63519,5.636,16.777,87137,31029,56108,5.442,15.283,8516,1.494,30.566,2489,2525,17879
1982,4245,8906,12097,110314,109880,741,6.075,944,7.739,18861,4566,14295,4.155,17.165,18055,5169,12886,4.704,16.432,806,0.734,32.863,616,643,3706
1982,4246,6603,9754,121587,119214,1215,12.699,843,8.811,22967,6489,16478,5.443,19.265,18034,6500,11534,5.452,15.127,4933,4.138,30.255,452,454,2237
1982,4247,11971,15395,160123,159561,1251,7.993,1762,11.258,34508,9501,25007,5.954,21.627,33441,11877,21564,7.444,20.958,1067,0.669,41.916,917,945,6169
1982,4248,4678,5841,136577,136560,324,5.508,407,6.919,14796,3766,11030,2.758,10.835,14789,4444,10345,3.254,10.830,7,0.005,21.659,276,280,2506
1982,4249,17081,20656,212339,214305,2325,11.220,2457,11.857,37018,12745,24273,5.947,17.274,41227,13972,27255,6.520,19.238,-4209,-1.964,34.547,1736,1744,7449
1982,4251,27170,29885,287479,287514,3552,12.026,2853,9.660,51749,16770,34979,5.833,17.999,51674,16970,34704,5.902,17.973,75,0.026,35.945,1860,1867,9658
1982,4411,36659,37627,733776,743278,3217,8.402,4541,11.860,89175,30185,58990,4.061,11.998,108005,40055,67950,5.389,14.531,-18830,-2.533,23.995,3672,3695,33542
1982,4412,11037,11425,70131,71415,1133,9.702,1640,14.043,14141,5003,9138,7.006,19.801,16747,6786,9961,9.502,23.450,-2606,-3.649,39.603,1263,1273,5256
1982,4413,42648,59686,420136,410139,7496,12.781,5426,9.251,86641,43058,43583,10.498,21.125,67992,24527,43465,5.980,16.578,18649,4.547,33.156,3356,3487,14553
1982,4421,22371,26744,203740,208639,2530,9.329,3279,12.091,33098,11639,21459,5.579,15.864,42825,13942,28883,6.682,20.526,-9727,-4.662,31.728,2395,2468,9754
1982,4422,19587,23109,124977,126735,3198,13.817,3272,14.136,26555,11418,15137,9.009,20.953,29942,11259,18683,8.884,23.626,-3387,-2.673,41.906,2401,2476,7536
1982,4431,27317,38785,212337,213035,6272,16.435,5027,13.173,51754,26318,25436,12.354,24.294,52923,19762,33161,9.276,24.842,-1169,-0.549,48.587,3130,3326,11874
1982,4441,55934,71253,637332,650246,5658,7.887,6635,9.248,88149,32375,55774,4.979,13.556,114412,32458,81954,4.992,17.595,-26263,-4.039,27.113,4596,4718,19945
1982,4442,15873,19377,144341,145780,1780,9.152,1924,9.893,24740,9027,15713,6.192,16.971,27690,8051,19639,5.523,18.994,-2950,-2.024,33.942,1371,1380,5103
1982,4451,62923,96262,1725690,1718371,10300,10.644,11316,11.694,274188,111576,162612,6.493,15.956,256503,98995,157508,5.761,14.927,17685,1.029,29.854,7722,7815,42682
1982,4452,22192,27227,166854,165672,4075,15.007,3928,14.466,40028,18818,21210,11.359,24.161,37600,16599,21001,10.019,22.696,2428,1.466,45.391,2927,2967,12092
1982,4453,28712,34212,166511,164771,4347,12.808,3800,11.197,36951,17484,19467,10.611,22.426,33551,12561,20990,7.623,20.362,3400,2.063,40.724,2988,3036,9947
1982,4461,49287,71115,583845,579788,7097,10.090,5534,7.868,97415,39475,57940,6.809,16.802,88396,27260,61136,4.702,15.246,9019,1.556,30.493,3733,3817,17229
1982,4471,102323,143666,857372,865495,16217,11.061,22111,15.081,190773,79782,110991,9.218,22.042,206218,90703,115515,10.480,23.827,-15445,-1.785,44.084,15614,16037,59561
1982,4481,58879,97233,784253,783007,11518,11.828,11811,12.129,154679,68460,86219,8.743,19.754,150903,54614,96289,6.975,19.272,3776,0.482,38.544,7699,8324,31061
1982,4482,12211,35761,188835,189983,4160,11.765,3358,9.497,40482,18953,21529,9.976,21.308,41648,11755,29893,6.187,21.922,-1166,-0.614,42.617,1549,1640,5328
1982,4483,17244,24729,145362,145474,2671,10.792,2711,10.954,27557,11758,15799,8.083,18.943,27811,10349,17462,7.114,19.118,-254,-0.175,37.886,1599,1642,5626
1982,4511,32175,42751,255146,252702,7673,18.361,5749,13.757,59860,31222,28638,12.355,23.688,56272,19811,36461,7.840,22.268,3588,1.420,44.536,4150,4266,13641
1982,4512,7522,10954,66963,67452,1494,13.812,1219,11.270,13423,5772,7651,8.557,19.900,14248,4451,9797,6.599,21.123,-825,-1.223,39.800,934,946,3379
1982,4522,447,6804,1083351,1096920,345,5.048,407,5.955,95609,41542,54067,3.787,8.716,125476,23324,102152,2.126,11.439,-29867,-2.723,17.432,34,36,1285
1982,4523,14346,29269,779464,792483,2454,8.282,3179,10.728,93337,38535,54802,4.863,11.778,120510,36325,84185,4.584,15.207,-27173,-3.429,23.556,1833,1887,11315
1982,4531,20085,21373,101434,101537,2647,12.306,2921,13.580,21591,7791,13800,7.673,21.264,21623,8362,13261,8.235,21.296,-32,-0.032,42.529,2242,2259,6367
1982,4532,23509,28784,173965,171530,4491,15.786,3822,13.434,41690,18200,23490,10.610,24.305,36628,13976,22652,8.148,21.354,5062,2.951,42.708,2947,2989,9322
1982,4533,8167,9532,41547,41483,1486,15.655,1406,14.812,9684,4400,5284,10.607,23.345,9577,3915,5662,9.438,23.087,107,0.258,46.174,1095,1107,2946
1982,4539,18243,20915,95446,96885,3467,16.136,4608,21.447,24830,11674,13156,12.049,25.628,27659,13800,13859,14.244,28.548,-2829,-2.920,51.257,3369,3457,10312
1982,4541,5646,7378,91008,92841,926,12.479,1011,13.624,14774,6120,8654,6.592,15.913,18694,7012,11682,7.553,20.136,-3920,-4.222,31.826,692,693,3049
1982,4542,4016,5432,80567,82768,569,10.441,604,11.084,11472,3754,7718,4.536,13.860,15834,4001,11833,4.834,19.131,-4362,-5.270,27.721,389,404,2036
1982,4543,17013,22768,202005,203170,2091,9.091,2557,11.117,38150,12904,25246,6.351,18.777,40541,12324,28217,6.066,19.954,-2391,-1.177,37.555,1740,1755,7267
1982,4811,1082,2669,284901,292191,369,14.233,216,8.332,17151,3862,13289,1.322,5.870,31478,2590,28888,0.886,10.773,-14327,-4.903,11.740,138,143,1400
1982,4812,414,587,12133,11413,94,15.852,106,17.875,2669,453,2216,3.969,23.386,1150,526,624,4.609,10.076,1519,13.309,20.152,80,80,372
1982,4831,406,667,37192,35954,63,9.403,69,10.299,6974,1233,5741,3.429,19.397,4679,1396,3283,3.883,13.014,2295,6.383,26.028,43,43,776
1982,4832,391,455,17272,18167,45,9.761,57,12.364,1916,700,1216,3.853,10.547,3722,671,3051,3.694,20.488,-1806,-9.941,21.094,40,40,385
1982,4841,21617,27295,502265,511545,4373,16.046,4290,15.741,69729,26544,43185,5.189,13.631,88366,24742,63624,4.837,17.274,-18637,-3.643,27.262,3229,3255,14720
1982,4842,37981,41746,498230,508013,6232,14.821,6838,16.262,83030,28947,54083,5.698,16.344,102548,32735,69813,6.444,20.186,-19518,-3.842,32.688,5343,5371,24167
1982,4851,393,431,24951,25329,47,10.892,48,11.124,2235,712,1523,2.811,8.824,3001,815,2186,3.218,11.848,-766,-3.024,17.648,38,38,504
1982,4852,344,693,29416,30442,26,3.667,58,8.181,2534,211,2323,0.693,8.324,4696,537,4159,1.764,15.426,-2162,-7.102,16.648,19,19,127
1982,4853,5370,5425,56106,58824,696,12.465,1013,18.143,10805,3836,6969,6.521,18.368,16235,6162,10073,10.475,27.599,-5430,-9.231,36.737,838,841,4338
1982,4854,3490,3681,93451,94286,269,7.189,391,10.449,12243,3630,8613,3.850,12.985,13905,5082,8823,5.390,14.748,-1662,-1.763,25.970,312,312,2769
1982,4855,501,540,11448,10858,87,16.493,62,11.754,3069,1926,1143,17.739,28.266,1841,875,966,8.059,16.956,1228,11.310,33.912,44,44,269
1982,4859,921,969,18901,19309,171,17.972,136,14.293,3141,1275,1866,6.603,16.267,3971,1058,2913,5.479,20.566,-830,-4.299,32.535,110,110,841
1982,4861,73,323,12623,12206,23,7.132,22,6.822,2057,853,1204,6.988,16.852,1246,594,652,4.866,10.208,811,6.644,20.416,7,7,296
1982,4862,227,1193,59303,57931,101,8.677,43,3.694,5438,1382,4056,2.386,9.387,2743,672,2071,1.160,4.735,2695,4.652,9.470,19,19,173
1982,4869,65,313,7136,7140,55,18.364,28,9.349,843,472,371,6.611,11.808,869,282,587,3.950,12.172,-26,-0.364,23.615,9,9,61
1982,4871,162,166,2716,2503,34,20.606,32,19.394,743,318,425,12.707,29.690,315,143,172,5.714,12.587,428,17.103,25.175,28,28,123
1982,4872,735,742,8445,8847,118,15.702,137,18.230,1517,474,1043,5.358,17.147,2250,1034,1216,11.688,25.432,-733,-8.285,34.294,114,114,679
1982,4879,51,65,651,669,8,11.852,13,19.259,160,14,146,2.094,23.934,199,162,37,24.233,29.768,-39,-5.834,47.868,12,12,99
1982,4881,1978,2499,55804,55550,364,14.639,339,13.634,8824,2903,5921,5.226,15.885,8316,3165,5151,5.698,14.970,508,0.914,29.941,250,251,1836
1982,4882,330,430,10974,12130,79,19.221,41,9.976,1865,901,964,7.428,15.375,4097,1443,2654,11.896,33.776,-2232,-18.401,30.750,26,26,980
1982,4883,2295,2722,119897,122062,341,12.658,285,10.579,21423,5789,15634,4.743,17.551,25829,5287,20542,4.331,21.161,-4406,-3.610,35.102,210,210,3340
1982,4884,2672,3251,39427,40307,508,15.745,459,14.226,6418,2343,4075,5.813,15.923,8265,2395,5870,5.942,20.505,-1847,-4.582,31.846,343,350,1272
1982,4885,4372,6141,85060,83290,875,14.574,601,10.010,15869,5117,10752,6.144,19.053,12080,4149,7931,4.981,14.504,3789,4.549,29.007,427,430,3093
1982,4889,349,356,6365,6265,54,15.297,48,13.598,1324,416,908,6.641,21.135,1108,277,831,4.422,17.687,216,3.448,35.374,39,39,207
1982,4921,1146,1788,63816,62516,316,17.798,291,16.390,8513,1762,6751,2.819,13.617,5861,1939,3922,3.102,9.375,2652,4.242,18.751,224,225,1457
1982,4922,668,668,4124,4090,222,31.851,280,40.172,1306,663,643,16.210,31.932,1232,785,447,19.193,30.122,74,1.809,60.244,235,235,660
1982,4931,6093,9710,376369,381558,919,9.580,685,7.141,54982,18244,36738,4.781,14.410,65335,10907,54428,2.859,17.123,-10353,-2.713,28.820,292,292,1974
1982,5111,12804,14570,595172,591564,1343,9.122,1648,11.194,57628,16326,41302,2.760,9.742,49980,14737,35243,2.491,8.449,7648,1.293,16.898,1321,1322,9402
1982,5112,7017,8257,122027,111521,2403,32.111,856,11.438,41549,19002,22547,17.039,37.257,20431,6531,13900,5.856,18.320,21118,18.936,36.641,547,557,2926
1982,5121,8636,14059,186789,188978,1994,14.253,1856,13.267,47833,17907,29926,9.476,25.311,52241,15457,36784,8.179,27.644,-4408,-2.333,50.623,1112,1150,8205
1982,5122,1826,1835,14465,14251,445,25.220,304,17.229,4305,2411,1894,16.918,30.208,3893,1634,2259,11.466,27.317,412,2.891,54.635,238,238,1056
1982,5151,5772,6836,209104,204885,803,11.944,577,8.582,29931,12371,17560,6.038,14.609,21696,8204,13492,4.004,10.589,8235,4.019,21.179,466,471,6134
1982,5152,9,9,53,53,D,D,4,38.095,19,D,17,D,35.849,16,13,3,24.528,30.189,3,5.660,60.377,4,4,13
1982,5173,2061,13698,964723,973334,373,2.722,386,2.817,72292,5122,67170,0.526,7.427,90729,4540,86189,0.466,9.321,-18437,-1.894,14.855,254,257,1964
1982,5174,649,1119,56777,59824,177,16.473,88,8.190,12462,3059,9403,5.113,20.831,18078,1621,16457,2.710,30.219,-5616,-9.388,41.662,71,71,1031
1982,5179,1033,2194,69685,75982,270,12.451,219,10.099,8734,1990,6744,2.619,11.495,20462,2200,18262,2.895,26.930,-11728,-15.435,22.990,171,171,1665
1982,5182,5687,7472,210637,204314,1275,17.489,912,12.509,48787,18498,30289,9.054,23.878,36626,10866,25760,5.318,17.926,12161,5.952,35.853,561,583,4845
1982,5191,1890,2109,22361,21988,214,10.092,237,11.177,3511,1076,2435,4.894,15.968,2822,1088,1734,4.948,12.834,689,3.134,25.669,172,172,749
1982,5211,30,66,24624,25026,5,7.752,D,D,198,27,171,0.108,0.791,983,D,834,D,3.928,-785,-3.137,1.582,D,D,D
1982,5221,20596,66419,1848302,1831185,2571,3.907,1357,2.062,155460,31957,123503,1.745,8.490,121243,22062,99181,1.205,6.621,34217,1.869,13.242,834,881,13617
1982,5222,23295,41251,337431,345558,2516,5.918,5042,11.860,48104,16026,32078,4.638,13.921,64703,27703,37000,8.017,18.724,-16599,-4.804,27.841,1539,1575,7251
1982,5223,3014,3408,43242,43402,643,18.965,608,17.932,8139,3161,4978,7.283,18.753,8395,2960,5435,6.820,19.343,-256,-0.590,37.506,463,464,2164
1982,5231,5242,9918,227816,223605,1418,14.727,839,8.714,29355,7990,21365,3.573,13.128,21250,5182,16068,2.317,9.503,8105,3.625,19.007,595,610,3208
1982,5232,116,131,6143,6287,18,13.900,15,11.583,242,40,202,0.636,3.849,528,81,447,1.288,8.398,-286,-4.549,7.698,13,13,70
1982,5239,11457,11825,136469,121541,2695,23.784,1707,15.065,55398,23990,31408,19.738,45.580,25119,10116,15003,8.323,20.667,30279,24.913,41.334,1372,1372,6260
1982,5241,6108,30179,1221739,1241680,1765,5.837,1880,6.218,112650,33851,78799,2.726,9.072,151430,37789,113641,3.043,12.196,-38780,-3.123,18.145,425,438,2745
1982,5242,88061,92710,910916,875041,10553,11.399,10285,11.110,203185,59870,143315,6.842,23.220,130504,52808,77696,6.035,14.914,72681,8.306,29.828,7482,7485,34125
1982,5259,612,805,10340,11009,87,10.943,67,8.428,1779,402,1377,3.652,16.160,3074,2329,745,21.156,27.924,-1295,-11.764,32.320,54,54,138
1982,5311,98211,100173,495646,501230,11625,11.377,15632,15.299,106297,43707,62590,8.720,21.207,116690,52124,64566,10.399,23.281,-10393,-2.074,42.415,12804,12827,40570
1982,5312,29899,30999,155898,161939,4820,15.089,6710,21.006,35525,15526,19999,9.588,21.937,47657,18343,29314,11.327,29.429,-12132,-7.492,43.875,5203,5212,14014
1982,5313,20141,20814,190570,191184,3289,15.500,4100,19.322,42515,17076,25439,8.932,22.238,43669,17588,26081,9.200,22.841,-1154,-0.604,44.475,3160,3161,12967
1982,5321,5311,8944,99342,100413,1222,13.705,1167,13.088,18772,7470,11302,7.439,18.695,20882,8095,12787,8.062,20.796,-2110,-2.101,37.390,725,755,3593
1982,5322,9191,11048,98086,96512,2167,20.084,1650,15.293,25743,11175,14568,11.579,26.674,22494,9348,13146,9.686,23.307,3249,3.366,46.614,1249,1253,6537
1982,5323,2571,2896,21613,21515,549,19.873,282,10.208,5106,2202,2904,10.235,23.732,4942,1321,3621,6.140,22.970,164,0.762,45.940,201,201,718
1982,5324,4449,5103,51908,50685,844,17.120,498,10.101,12318,4704,7614,9.281,24.303,9872,2620,7252,5.169,19.477,2446,4.826,38.955,363,363,1508
1982,5331,879,937,10906,10327,187,20.493,138,15.123,2942,1211,1731,11.727,28.488,1775,843,932,8.163,17.188,1167,11.300,34.376,109,109,514
1982,5411,113148,116607,613244,602215,16619,14.516,12386,10.818,124726,55164,69562,9.160,20.711,102985,37268,65717,6.188,17.101,21741,3.610,34.202,9407,9458,29738
1982,5412,49790,53681,445624,417741,9118,17.448,6272,12.002,114634,41333,73301,9.894,27.441,60598,21798,38800,5.218,14.506,54036,12.935,29.012,4688,4720,16714
1982,5413,45684,49634,659647,666724,8214,16.865,6355,13.048,128433,53009,75424,7.951,19.263,142759,41861,100898,6.279,21.412,-14326,-2.149,38.527,4460,4481,27052
1982,5414,15388,15706,102179,98710,3356,22.493,1784,11.957,27599,12729,14870,12.895,27.960,20990,7134,13856,7.227,21.264,6609,6.695,42.529,1345,1351,4903
1982,5415,2713,3724,43079,40693,1281,34.224,1319,35.239,15588,10130,5458,24.894,38.307,10381,5716,4665,14.047,25.511,5207,12.796,51.022,1133,1134,4101
1982,5416,7371,7632,75749,79614,2303,26.275,4569,52.128,25289,12709,12580,15.963,31.765,33212,21066,12146,26.460,41.716,-7923,-9.952,63.529,3754,3760,17111
1982,5417,2658,3520,299385,299249,472,12.856,775,21.109,51676,12230,39446,4.087,17.269,50901,26240,24661,8.769,17.010,775,0.259,34.019,484,488,3765
1982,5418,18901,20768,260313,255884,3542,17.324,2897,14.169,54474,20638,33836,8.065,21.289,45890,17410,28480,6.804,17.934,8584,3.355,35.868,2169,2189,11138
1982,5419,24673,26873,160590,159993,3603,13.605,2821,10.653,31893,12469,19424,7.793,19.934,30957,10039,20918,6.275,19.349,936,0.585,38.698,2103,2109,7620
1982,5511,22131,42820,2807631,2794058,4660,11.058,3305,7.842,522373,182875,339498,6.545,18.696,492294,116340,375954,4.164,17.619,30079,1.077,35.239,644,657,8487
1982,5611,424,444,12363,15226,121,13.102,1080,116.946,4048,2058,1990,13.517,26.587,9813,9114,699,59.860,64.451,-5765,-37.864,53.174,881,883,5832
1982,5612,59,62,4810,5645,11,12.717,60,69.364,2617,210,2407,3.720,46.364,4066,2319,1747,41.084,72.035,-1449,-25.671,92.727,28,29,395
1982,5613,10128,13806,563394,561705,2497,18.420,1997,14.731,147869,44317,103552,7.890,26.325,144109,29144,114965,5.188,25.656,3760,0.669,51.311,1466,1479,17853
1982,5614,20609,22703,222767,219718,4144,18.938,2503,11.438,50305,19103,31202,8.694,22.895,44332,12395,31937,5.641,20.177,5973,2.718,40.354,1866,1875,7608
1982,5615,18018,21102,151651,148414,3168,15.524,1777,8.708,32453,12838,19615,8.650,21.867,26189,8492,17697,5.722,17.646,6264,4.221,35.292,1310,1325,6150
1982,5616,17735,20692,541412,531160,3909,19.917,1777,9.054,109433,33188,76245,6.248,20.603,89687,24587,65100,4.629,16.885,19746,3.718,33.770,1224,1226,13369
1982,5617,51253,54074,679968,671646,10870,20.230,10184,18.954,175644,69015,106629,10.276,26.151,159121,62998,96123,9.380,23.691,16523,2.460,47.382,8016,8031,34949
1982,5619,18117,19295,214120,206434,4096,22.702,1591,8.818,53448,19756,33692,9.570,25.891,38211,9121,29090,4.418,18.510,15237,7.381,37.020,1143,1143,6265
1982,5621,5149,5299,93376,94482,660,12.419,691,13.002,13593,4342,9251,4.596,14.387,15722,4945,10777,5.234,16.640,-2129,-2.253,28.774,553,553,4118
1982,5622,2100,2530,41476,40914,296,11.788,258,10.275,6986,1958,5028,4.786,17.075,5859,2653,3206,6.484,14.320,1127,2.755,28.641,185,185,1120
1982,5629,3934,4128,34195,34497,632,15.358,606,14.727,7459,2960,4499,8.580,21.622,8006,3616,4390,10.482,23.208,-547,-1.586,43.244,456,456,2720
1982,6111,12550,12878,352454,350223,613,4.759,620,4.813,33798,5245,28553,1.498,9.650,29532,5396,24136,1.541,8.432,4266,1.218,16.865,451,452,3908
1982,6112,434,529,36028,35674,45,8.604,33,6.310,4454,624,3830,1.749,12.485,3729,868,2861,2.433,10.453,725,2.032,20.906,25,25,680
1982,6113,1981,2262,916486,908853,84,3.726,69,3.061,76729,5214,71515,0.574,8.442,61292,2976,58316,0.327,6.744,15437,1.699,13.488,44,44,882
1982,6114,1602,1819,29508,29341,319,17.722,281,15.611,6229,2171,4058,7.399,21.230,5944,1873,4071,6.384,20.258,285,0.971,40.517,217,217,1229
1982,6115,4508,5294,51618,50789,641,12.255,514,9.827,10765,3944,6821,7.766,21.196,9072,2660,6412,5.237,17.862,1693,3.333,35.725,398,398,1898
1982,6116,10391,10888,102088,102707,1924,17.697,1892,17.403,24252,9060,15192,8.821,23.613,25196,8317,16879,8.098,24.532,-944,-0.919,47.226,1470,1477,6026
1982,6117,447,456,6784,6610,77,15.431,163,32.665,1610,886,724,13.405,24.359,1263,706,557,10.682,19.109,347,5.250,38.218,131,131,523
1982,6211,170260,175029,948392,931554,19252,11.259,11172,6.534,164258,63633,100625,6.831,17.633,131487,38435,93052,4.126,14.115,32771,3.518,28.230,8869,8913,30753
1982,6212,90198,92075,399224,387596,7118,7.822,4975,5.467,74524,24178,50346,6.238,19.227,51565,15908,35657,4.104,13.304,22959,5.923,26.608,3923,3936,12850
1982,6213,35470,37084,116087,111640,5853,16.304,3485,9.708,31055,15044,16011,13.475,27.817,22079,9298,12781,8.329,19.777,8976,8.040,39.554,2624,2650,7277
1982,6214,4682,5912,89372,88045,806,13.885,592,10.198,16540,6716,9824,7.628,18.786,13926,5792,8134,6.578,15.817,2614,2.969,31.634,413,423,3805
1982,6215,3781,4764,62313,61633,563,11.814,566,11.877,11851,4234,7617,6.870,19.228,10401,5182,5219,8.408,16.876,1450,2.353,33.751,372,388,2689
1982,6216,2897,3872,147789,135660,721,19.434,397,10.701,44935,17689,27246,13.039,33.123,20894,5487,15407,4.045,15.402,24041,17.722,30.804,274,275,2216
1982,6219,2760,3181,65528,59826,534,17.290,349,11.300,20402,7794,12608,13.028,34.103,9115,3977,5138,6.648,15.236,11287,18.867,30.472,251,251,2301
1982,6221,3871,4943,3032533,2967857,218,4.434,166,3.376,219499,45567,173932,1.535,7.396,88770,26419,62351,0.890,2.991,130729,4.405,5.982,113,113,17679
1982,6222,379,496,93155,89086,56,11.679,23,4.797,12548,2645,9903,2.969,14.085,4451,1705,2746,1.914,4.996,8097,9.089,9.993,13,13,1119
1982,6223,206,250,47042,48040,35,14.706,11,4.622,3777,905,2872,1.884,7.862,5912,535,5377,1.114,12.307,-2135,-4.444,15.725,7,7,494
1982,6231,8599,12074,934636,921564,958,8.045,627,5.265,122587,56905,65682,6.175,13.302,96049,35075,60974,3.806,10.422,26538,2.880,20.845,469,472,25562
1982,6232,3336,4413,100462,97724,547,12.731,314,7.308,17175,6525,10650,6.677,17.575,11707,3749,7958,3.836,11.980,5468,5.595,23.959,240,240,2917
1982,6233,6624,7673,217449,217713,857,11.209,802,10.490,31924,12811,19113,5.884,14.663,32454,12935,19519,5.941,14.907,-530,-0.243,29.327,568,571,9404
1982,6239,2431,2979,72029,70700,266,9.006,215,7.279,10950,3481,7469,4.924,15.488,8269,2600,5669,3.678,11.696,2681,3.792,23.392,145,146,1551
1982,6241,12120,16636,242022,246331,1587,9.632,1267,7.690,40741,11213,29528,4.552,16.539,49430,9025,40405,3.664,20.067,-8689,-3.527,33.078,788,816,5424
1982,6242,3350,4003,41612,42988,377,9.511,299,7.543,6783,2214,4569,5.150,15.779,9513,2226,7287,5.178,22.130,-2730,-6.351,31.558,194,196,1790
1982,6243,3534,5167,216141,231676,493,9.466,575,11.041,34756,6287,28469,2.714,15.002,65839,13498,52341,5.826,28.419,-31083,-13.417,30.004,277,283,9058
1982,6244,25525,30322,260264,254129,4169,13.950,3296,11.029,59865,24516,35349,9.647,23.557,46694,15957,30737,6.279,18.374,13171,5.183,36.748,2581,2637,12195
1982,7111,4351,4400,61258,59702,804,18.319,782,17.817,18484,4237,14247,7.097,30.961,15159,4848,10311,8.120,25.391,3325,5.569,50.783,596,598,3726
1982,7112,1980,2081,57488,57393,361,17.289,375,17.960,11466,3983,7483,6.940,19.978,11323,3684,7639,6.419,19.729,143,0.249,39.458,272,273,2967
1982,7113,1830,1868,28645,28568,317,16.862,341,18.138,7532,2502,5030,8.758,26.365,7394,2846,4548,9.962,25.882,138,0.483,51.764,273,273,2515
1982,7114,1218,1228,12845,12792,242,20.091,195,16.189,3878,2016,1862,15.760,30.317,3672,1468,2204,11.476,28.707,206,1.610,57.413,145,145,1286
1982,7115,5353,5369,51272,51815,1567,28.608,1784,32.570,11567,5097,6470,9.837,22.324,12654,5476,7178,10.568,24.421,-1087,-2.098,44.647,1333,1333,3871
1982,7121,1810,1934,33878,33875,155,8.042,142,7.367,5185,855,4330,2.524,15.306,5154,800,4354,2.362,15.215,31,0.092,30.430,94,94,523
1982,7131,2063,2514,54543,51750,919,42.360,230,10.602,9099,4348,4751,8.402,17.583,3633,1015,2618,1.961,7.020,5466,10.562,14.041,188,189,863
1982,7132,746,767,17212,16611,165,22.267,113,15.250,4411,1309,3102,7.881,26.555,3237,1417,1820,8.531,19.488,1174,7.068,38.975,95,95,1001
1982,7139,29974,31720,452773,445057,4355,13.970,3265,10.473,88001,34341,53660,7.716,19.773,72722,21860,50862,4.912,16.340,15279,3.433,32.680,2502,2516,16840
1982,7211,28285,32431,1083292,1070316,3884,11.896,4324,13.243,209744,93630,116114,8.748,19.596,184735,74812,109923,6.990,17.260,25009,2.337,34.520,3262,3303,46756
1982,7212,3406,3656,20037,19242,491,13.454,478,13.098,6354,2241,4113,11.647,33.022,4898,1479,3419,7.687,25.455,1456,7.567,50.911,323,323,1054
1982,7213,4791,4897,22539,22680,296,5.955,443,8.913,3653,1075,2578,4.740,16.107,3926,1236,2690,5.450,17.311,-273,-1.204,32.214,321,321,867
1982,7223,12147,15265,262996,261437,2520,16.486,2562,16.760,64524,33210,31314,12.703,24.681,61101,24098,37003,9.218,23.371,3423,1.309,46.743,1980,1989,15861
1982,7224,59158,59969,321265,322864,8860,14.535,10834,17.773,90185,48416,41769,14.996,27.933,93276,42884,50392,13.282,28.890,-3091,-0.957,55.866,8595,8619,34116
1982,7225,182623,240632,4133702,4108015,37943,15.820,36361,15.160,971601,506509,465092,12.330,23.651,916274,375552,540722,9.142,22.305,55327,1.347,44.609,27110,27630,249346
1982,8111,87761,91806,420649,417566,13815,15.064,13623,14.854,98723,43299,55424,10.369,23.642,92450,41284,51166,9.887,22.140,6273,1.502,44.280,10429,10466,32414
1982,8112,9173,10109,59495,58745,1209,11.803,1477,14.420,12299,4006,8293,6.819,20.936,10977,4398,6579,7.487,18.686,1322,2.250,37.372,1164,1167,3023
1982,8113,17959,19030,145196,145679,2755,14.599,2438,12.919,30036,12022,18014,8.252,20.618,30931,9883,21048,6.784,21.232,-895,-0.614,41.236,1798,1800,6795
1982,8114,20694,22373,128858,130510,3425,15.231,3652,16.241,24884,10522,14362,8.062,19.067,28204,12004,16200,9.198,21.611,-3320,-2.544,38.134,2832,2833,7711
1982,8121,77250,85350,380188,382968,10873,12.560,13304,15.369,79857,37878,41979,9.891,20.852,85012,40195,44817,10.496,22.198,-5155,-1.346,41.704,10609,10681,30339
1982,8122,17032,19690,112071,111680,1298,6.563,1471,7.438,17636,4476,13160,4.008,15.792,16817,4899,11918,4.387,15.058,819,0.733,30.117,1018,1029,3462
1982,8123,32257,38040,332839,333876,4273,11.140,4909,12.798,52355,20312,32043,6.084,15.681,54609,21845,32764,6.543,16.356,-2254,-0.675,31.362,3688,3787,15409
1982,8129,18355,24799,282858,279538,5018,21.031,3141,13.164,76078,34536,41542,12.355,27.216,68087,16251,51836,5.814,24.357,7991,2.859,48.714,1684,1720,8244
1982,8131,75100,75214,714547,698677,5473,7.419,2588,3.508,106854,22866,83988,3.273,15.294,74608,9575,65033,1.370,10.678,32246,4.615,21.357,1114,1114,4628
1982,8132,6605,7625,116311,120169,673,8.841,648,8.512,17214,4124,13090,3.432,14.325,24892,5549,19343,4.618,20.714,-7678,-6.389,28.650,414,420,3970
1982,8133,6308,7549,83204,88012,909,12.143,783,10.460,14361,4788,9573,5.440,16.317,23742,4702,19040,5.342,26.976,-9381,-10.659,32.634,461,468,2961
1982,8134,28064,29350,244348,244344,1660,5.644,1783,6.062,35276,7054,28222,2.887,14.437,35081,5300,29781,2.169,14.357,195,0.080,28.714,1252,1254,3765
1982,8139,55092,57307,437001,433812,4147,7.222,4369,7.609,79963,19249,60714,4.437,18.433,73265,14103,59162,3.251,16.889,6698,1.544,33.777,3121,3126,9793
1983,1131,206,212,2405,2309,42,20.690,24,11.823,821,345,476,14.945,35.564,609,391,218,16.937,26.381,212,9.183,52.762,19,19,77
1983,1132,76,91,1284,1494,6,6.250,16,16.667,160,22,138,1.473,10.713,569,43,526,2.879,38.098,-409,-27.385,21.426,14,14,39
1983,1133,10031,10137,82152,81086,1610,15.969,1500,14.878,20468,6480,13988,7.992,25.242,18321,6741,11580,8.313,22.595,2147,2.648,45.189,1082,1083,5020
1983,1141,1294,1326,8349,9023,229,16.869,292,21.510,2392,925,1467,10.252,26.510,3697,1421,2276,15.749,40.973,-1305,-14.463,53.020,210,212,944
1983,1142,130,131,621,643,22,16.667,24,18.182,192,93,99,14.463,29.860,225,97,128,15.086,34.992,-33,-5.132,59.720,14,14,65
1983,1151,3991,4407,51481,53460,567,12.757,642,14.445,12825,4973,7852,9.302,23.990,16784,5679,11105,10.623,31.396,-3959,-7.406,47.980,422,425,2785
1983,1152,1715,1738,12461,12267,285,16.618,239,13.936,2776,1158,1618,9.440,22.630,2401,670,1731,5.462,19.573,375,3.057,39.146,190,190,556
1983,1153,693,706,9901,9678,142,20.142,140,19.858,3117,1301,1816,13.444,32.209,2694,1198,1496,12.379,27.838,423,4.371,55.676,106,106,997
1983,2111,7725,9770,169864,177573,1338,13.724,1297,13.303,31906,12051,19855,6.787,17.968,47246,14047,33199,7.911,26.607,-15340,-8.639,35.936,895,900,5603
1983,2121,2755,3455,185260,212882,504,13.722,940,25.592,20603,9924,10679,4.662,9.678,76203,20273,55930,9.523,35.796,-55600,-26.118,19.356,676,678,8895
1983,2122,545,698,46019,57894,118,15.385,256,33.377,3309,2060,1249,3.558,5.716,27047,4026,23021,6.954,46.718,-23738,-41.003,11.431,174,174,945
1983,2123,3533,4967,96266,100472,389,7.753,490,9.766,13353,3862,9491,3.844,13.290,21626,6153,15473,6.124,21.525,-8273,-8.234,26.581,275,280,2256
1983,2131,11299,12774,291762,355613,1969,15.002,2671,20.350,50499,22560,27939,6.344,14.201,178071,43820,134251,12.322,50.074,-127572,-35.874,28.401,1916,1925,24614
1983,2211,1549,5728,581458,575697,187,3.282,125,2.194,40206,11809,28397,2.051,6.984,28670,3359,25311,0.583,4.980,11536,2.004,9.960,32,32,228
1983,2212,522,2357,139968,141462,100,4.250,92,3.910,8286,1906,6380,1.347,5.857,10993,1357,9636,0.959,7.771,-2707,-1.914,11.715,25,25,95
1983,2213,3699,4005,30355,30374,298,7.494,241,6.061,3327,1284,2043,4.227,10.954,3357,1376,1981,4.530,11.052,-30,-0.099,21.907,169,172,725
1983,2361,80808,81175,440918,433835,16638,20.463,16902,20.788,154901,60625,94276,13.974,35.705,140757,60903,79854,14.038,32.445,14144,3.260,64.890,11669,11675,44658
1983,2362,31435,32014,503242,529824,4492,14.101,4178,13.115,115654,29480,86174,5.564,21.829,169627,30511,139116,5.759,32.016,-53973,-10.187,43.658,2875,2877,18952
1983,2371,12663,12971,290625,312204,1435,10.989,1611,12.336,52099,15733,36366,5.039,16.688,95401,15827,79574,5.069,30.557,-43302,-13.870,33.375,1166,1166,9397
1983,2372,7093,7187,52884,50465,1702,23.879,1583,22.210,18589,9346,9243,18.520,36.835,13540,5589,7951,11.075,26.830,5049,10.005,53.661,1190,1190,4150
1983,2373,9517,9772,182742,185409,983,10.025,1050,10.708,40039,7931,32108,4.278,21.595,45381,8547,36834,4.610,24.476,-5342,-2.881,43.190,758,761,5727
1983,2379,4271,4338,102361,109607,690,15.770,765,17.484,21073,4616,16457,4.211,19.226,35305,6414,28891,5.852,32.211,-14232,-12.985,38.452,538,538,3339
1983,2381,60294,60677,515908,512051,9713,16.136,8747,14.531,154446,45178,109268,8.823,30.162,146499,42704,103795,8.340,28.610,7947,1.552,57.221,6123,6123,31790
1983,2382,93572,95507,927829,947569,12157,12.766,11603,12.184,190146,50870,139276,5.368,20.067,229944,51162,178782,5.399,24.267,-39798,-4.200,40.133,8479,8485,37796
1983,2383,60314,60742,457548,456691,10679,17.582,10669,17.566,135939,43239,92700,9.468,29.766,134039,42384,91655,9.281,29.350,1900,0.416,58.700,7498,7510,31653
1983,2389,33027,33254,315366,329982,5096,15.333,5061,15.227,75440,22397,53043,6.787,22.862,104262,26949,77313,8.167,31.596,-28822,-8.734,45.724,3628,3628,18216
1983,3111,1361,1990,53505,54247,91,4.522,136,6.758,4665,648,4017,1.195,8.600,6177,1562,4615,2.879,11.387,-1512,-2.787,17.199,74,75,792
1983,3112,529,884,73947,75592,47,5.320,46,5.207,4808,1026,3782,1.357,6.361,8129,1581,6548,2.092,10.754,-3321,-4.393,12.721,27,27,665
1983,3113,1347,1724,84871,88035,216,12.713,166,9.770,7792,1802,5990,2.047,8.851,14298,5357,8941,6.085,16.241,-6506,-7.390,17.702,96,96,583
1983,3114,1237,1711,173296,176337,109,6.332,130,7.552,18792,2687,16105,1.524,10.657,24569,5331,19238,3.023,13.933,-5777,-3.276,21.314,73,73,2012
1983,3115,1838,2557,135430,137063,133,5.167,167,6.488,12121,2847,9274,2.077,8.843,15482,4259,11223,3.107,11.296,-3361,-2.452,17.687,100,100,1551
1983,3116,4318,4901,317384,321749,321,6.508,384,7.785,29727,7301,22426,2.269,9.239,38478,8763,29715,2.724,11.959,-8751,-2.720,18.478,269,270,3362
1983,3117,776,896,47800,47274,72,7.996,81,8.995,8692,2536,6156,5.365,18.387,7820,2295,5525,4.855,16.542,872,1.845,33.084,55,56,1591
1983,3118,8450,9934,296426,296882,1354,13.839,1054,10.773,34090,10277,23813,3.462,11.483,34573,11705,22868,3.943,11.645,-483,-0.163,22.965,750,770,6779
1983,3119,2099,2461,122519,124925,208,8.464,201,8.179,13156,3162,9994,2.531,10.531,18072,5295,12777,4.239,14.466,-4916,-3.935,21.062,135,139,2638
1983,3121,2011,2572,174646,177765,149,5.733,203,7.811,13751,2659,11092,1.496,7.735,20102,5258,14844,2.958,11.308,-6351,-3.573,15.471,127,129,1978
1983,3122,108,167,43376,44366,14,8.408,13,7.808,3778,594,3184,1.339,8.516,5978,2204,3774,4.968,13.474,-2200,-4.959,17.031,6,6,51
1983,3131,454,680,104289,106086,42,6.136,51,7.451,7588,2172,5416,2.047,7.153,11246,3672,7574,3.461,10.601,-3658,-3.448,14.305,21,21,405
1983,3132,1711,2110,291765,303535,132,6.178,185,8.659,17670,2991,14679,0.985,5.821,40741,10762,29979,3.546,13.422,-23071,-7.601,11.643,114,115,2183
1983,3133,4123,4620,134781,136621,378,8.378,162,3.590,12075,3106,8969,2.273,8.838,15610,2823,12787,2.066,11.426,-3535,-2.587,17.677,100,100,1350
1983,3141,3902,4195,109920,109260,384,8.957,568,13.249,15385,3059,12326,2.800,14.081,14127,5454,8673,4.992,12.930,1258,1.151,25.860,442,447,3678
1983,3149,3413,3531,116151,118865,444,12.675,388,11.076,17671,7068,10603,5.946,14.867,23242,7513,15729,6.321,19.553,-5571,-4.687,29.733,291,291,3943
1983,3151,1361,1486,140756,142320,99,6.593,130,8.658,12608,1721,10887,1.209,8.859,15767,4542,11225,3.191,11.079,-3159,-2.220,17.718,105,105,1601
1983,3152,12372,14002,868458,895426,1721,12.011,2374,16.568,114250,39054,75196,4.362,12.759,168628,67310,101318,7.517,18.832,-54378,-6.073,25.519,1927,1950,42048
1983,3159,1596,1690,56433,57579,203,12.076,185,11.005,7809,2201,5608,3.823,13.562,10090,3183,6907,5.528,17.524,-2281,-3.962,27.124,141,142,1561
1983,3161,343,385,18974,19376,28,7.245,31,8.021,1858,342,1516,1.765,9.589,2671,396,2275,2.044,13.785,-813,-4.196,19.179,26,27,311
1983,3162,515,751,126853,132717,44,5.816,55,7.270,10141,1643,8498,1.238,7.641,21612,4580,17032,3.451,16.284,-11471,-8.643,15.282,36,37,1044
1983,3169,1317,1367,50975,53929,148,10.756,166,12.064,5232,1631,3601,3.024,9.702,11151,2578,8573,4.780,20.677,-5919,-10.976,19.403,138,138,1635
1983,3211,4804,5324,127051,125521,464,8.574,640,11.826,22466,5007,17459,3.989,17.898,19479,7193,12286,5.731,15.519,2987,2.380,31.037,434,437,3826
1983,3212,1010,1264,79917,76693,113,8.943,112,8.864,13339,3790,9549,4.942,17.393,6864,2169,4695,2.828,8.950,6475,8.443,17.900,76,76,694
1983,3219,8431,9184,246451,243228,1002,10.862,1084,11.751,43452,10772,32680,4.429,17.865,36868,13700,23168,5.633,15.158,6584,2.707,30.316,812,813,7863
1983,3221,278,612,197536,198037,27,4.419,25,4.092,9114,4866,4248,2.457,4.602,10334,1470,8864,0.742,5.218,-1220,-0.616,9.204,10,10,147
1983,3222,3561,5111,382129,389919,212,4.121,280,5.442,25697,4247,21450,1.089,6.590,41424,13036,28388,3.343,10.624,-15727,-4.033,13.181,177,186,2926
1983,3231,34488,36037,676247,676816,4215,11.911,2916,8.240,81436,24513,56923,3.622,12.032,82404,24367,58037,3.600,12.175,-968,-0.143,24.064,2311,2316,14921
1983,3241,1354,2158,143720,147136,152,6.934,220,10.036,10774,2191,8583,1.489,7.323,17537,5400,12137,3.670,11.919,-6763,-4.596,14.645,107,109,1281
1983,3251,1153,2246,247041,255868,156,6.935,163,7.246,11700,3051,8649,1.192,4.573,29494,8429,21065,3.294,11.527,-17794,-6.954,9.145,75,75,840
1983,3252,510,780,150033,156348,43,5.523,40,5.138,6263,1996,4267,1.277,4.006,18765,3034,15731,1.941,12.002,-12502,-7.996,8.012,15,15,134
1983,3253,718,1071,48634,51636,58,5.365,78,7.216,2801,772,2029,1.495,5.425,8962,1965,6997,3.805,17.356,-6161,-11.932,10.849,44,44,552
1983,3254,1005,1239,159423,158684,126,10.315,91,7.450,13121,3365,9756,2.121,8.269,11430,2686,8744,1.693,7.203,1691,1.066,14.406,57,57,605
1983,3255,1625,2068,72132,72865,105,5.047,130,6.248,7091,1880,5211,2.580,9.732,8657,2280,6377,3.129,11.881,-1566,-2.149,19.463,78,83,725
1983,3256,2023,2280,122480,125290,175,7.719,149,6.573,10499,1633,8866,1.303,8.380,15871,2678,13193,2.137,12.667,-5372,-4.288,16.760,107,107,754
1983,3259,1707,2222,96606,98604,238,10.828,190,8.644,8938,3149,5789,3.194,9.065,13057,2712,10345,2.750,13.242,-4119,-4.177,18.129,124,125,1316
1983,3261,9820,11284,487603,487419,957,8.486,944,8.371,67269,18652,48617,3.827,13.801,67011,19041,47970,3.906,13.748,258,0.053,27.496,660,665,8577
1983,3262,1900,2256,171126,177351,204,9.115,168,7.507,11893,3246,8647,1.830,6.706,24448,5875,18573,3.313,13.785,-12555,-7.079,13.412,103,103,1904
1983,3271,1297,1579,72818,75019,184,11.620,193,12.188,7571,1450,6121,1.933,10.092,12090,2705,9385,3.606,16.116,-4519,-6.024,20.184,143,143,1110
1983,3272,1501,1786,148527,152257,192,10.805,174,9.792,10272,2207,8065,1.450,6.746,17812,4676,13136,3.071,11.699,-7540,-4.952,13.493,122,122,1898
1983,3273,7107,8997,162786,165296,569,6.272,718,7.915,25135,5810,19325,3.515,15.206,30102,7243,22859,4.382,18.211,-4967,-3.005,30.412,472,477,3592
1983,3274,244,340,15704,15938,37,10.866,38,11.160,1623,242,1381,1.518,10.183,1997,483,1514,3.030,12.530,-374,-2.347,20.366,27,27,65
1983,3279,1832,2111,77280,79775,179,8.437,200,9.427,7094,2069,5025,2.594,8.893,11960,2867,9093,3.594,14.992,-4866,-6.100,17.785,131,131,956
1983,3311,401,487,232050,273722,49,9.909,64,12.942,5447,1648,3799,0.602,1.990,89644,2113,87531,0.772,32.750,-84197,-30.760,3.980,45,45,637
1983,3312,500,683,64156,73908,46,6.735,46,6.735,4344,1026,3318,1.388,5.878,24104,2853,21251,3.860,32.614,-19760,-26.736,11.755,24,26,417
1983,3313,294,447,82820,86860,29,6.510,26,5.836,4124,942,3182,1.085,4.748,12014,1043,10971,1.201,13.831,-7890,-9.084,9.496,14,14,181
1983,3314,780,972,97137,104599,72,7.295,102,10.334,4831,1054,3777,1.008,4.619,19752,4576,15176,4.375,18.884,-14921,-14.265,9.237,69,70,688
1983,3315,2802,3125,200743,228100,165,5.210,249,7.862,11196,2480,8716,1.087,4.908,65815,11219,54596,4.918,28.854,-54619,-23.945,9.817,159,159,3621
1983,3321,3125,3350,133977,144218,177,5.262,205,6.094,8534,2026,6508,1.405,5.917,29126,4269,24857,2.960,20.196,-20592,-14.278,11.835,161,161,2693
1983,3322,1216,1341,78328,81747,68,5.024,93,6.871,6121,1120,5001,1.370,7.488,13013,1393,11620,1.704,15.919,-6892,-8.431,14.975,59,59,424
1983,3323,9913,10753,309314,329684,757,6.999,882,8.155,36493,7854,28639,2.382,11.069,77286,13988,63298,4.243,23.442,-40793,-12.373,22.138,630,636,6995
1983,3324,1437,1816,128194,139635,105,5.699,158,8.575,7790,2326,5464,1.666,5.579,30504,6604,23900,4.729,21.846,-22714,-16.267,11.158,93,93,1854
1983,3325,916,986,71145,71746,79,8.000,82,8.304,6065,1414,4651,1.971,8.453,7178,2001,5177,2.789,10.005,-1113,-1.551,16.907,53,53,1239
1983,3326,1568,1777,61002,62037,136,7.675,126,7.111,7703,2046,5657,3.298,12.417,9769,2313,7456,3.728,15.747,-2066,-3.330,24.834,83,87,1250
1983,3327,20731,21074,290382,315809,1658,7.726,2429,11.319,29234,9095,20139,2.880,9.257,80239,15526,64713,4.916,25.407,-51005,-16.151,18.514,1767,1768,10701
1983,3328,5341,5644,110531,114414,420,7.436,429,7.595,13761,3884,9877,3.395,12.027,21567,5031,16536,4.397,18.850,-7806,-6.823,24.055,311,315,3226
1983,3329,4942,5494,323505,348765,651,11.936,571,10.469,28290,9625,18665,2.760,8.111,79136,10620,68516,3.045,22.690,-50846,-14.579,16.223,418,418,5112
1983,3331,3147,3579,250258,313760,253,6.877,453,12.313,13275,4754,8521,1.515,4.231,140623,14459,126164,4.608,44.819,-127348,-40.588,8.462,313,314,3570
1983,3332,3679,3934,156683,168428,288,7.299,311,7.882,13397,4847,8550,2.878,7.954,36950,5811,31139,3.450,21.938,-23553,-13.984,15.908,218,220,2336
1983,3333,1990,2118,160028,162672,159,7.530,146,6.915,18333,3691,14642,2.269,11.270,23891,5530,18361,3.399,14.687,-5558,-3.417,22.540,93,93,1082
1983,3334,1850,2079,155965,165637,161,7.596,242,11.418,12982,2960,10022,1.787,7.838,32519,5989,26530,3.616,19.633,-19537,-11.795,15.675,174,174,1259
1983,3335,9434,9883,214393,241971,591,5.911,820,8.202,14693,4295,10398,1.775,6.072,69379,11924,57455,4.928,28.673,-54686,-22.600,12.144,573,577,4915
1983,3336,732,902,142789,159079,40,4.442,37,4.109,3147,564,2583,0.355,1.978,35942,680,35262,0.427,22.594,-32795,-20.616,3.957,27,27,283
1983,3339,5879,6469,303166,338783,382,5.823,564,8.598,18819,6472,12347,1.910,5.555,89776,13346,76430,3.939,26.500,-70957,-20.945,11.110,368,368,3748
1983,3341,1459,1664,334417,332364,294,18.404,161,10.078,46253,10013,36240,3.013,13.916,40904,10183,30721,3.064,12.307,5349,1.609,24.614,116,116,2162
1983,3342,1805,2012,268478,272886,197,9.830,181,9.032,32997,11424,21573,4.186,12.092,41650,9873,31777,3.618,15.263,-8653,-3.171,24.184,143,143,2678
1983,3343,408,436,47138,49099,45,10.124,62,13.948,3940,1663,2277,3.387,8.025,7711,3167,4544,6.450,15.705,-3771,-7.680,16.049,42,42,715
1983,3344,4093,4635,458921,471357,591,12.988,422,9.274,43136,11108,32028,2.357,9.151,67725,15378,52347,3.262,14.368,-24589,-5.217,18.303,296,297,3669
1983,3345,3848,4423,623018,632383,420,9.567,354,8.064,58287,15904,42383,2.515,9.217,76531,23710,52821,3.749,12.102,-18244,-2.885,18.434,222,223,3907
1983,3346,631,656,16855,16812,127,20.143,76,12.054,4313,1364,2949,8.113,25.655,4192,756,3436,4.497,24.935,121,0.720,49.871,54,54,291
1983,3351,1185,1304,77154,79214,97,7.379,118,8.977,6381,1077,5304,1.360,8.055,10461,2508,7953,3.166,13.206,-4080,-5.151,16.111,89,89,1342
1983,3352,332,435,111690,115614,23,5.157,45,10.090,8822,308,8514,0.266,7.631,16386,2325,14061,2.011,14.173,-7564,-6.542,15.261,34,34,570
1983,3353,1973,2457,236985,256639,149,6.031,176,7.124,12202,1556,10646,0.606,4.755,51009,8065,42944,3.143,19.876,-38807,-15.121,9.509,101,101,1046
1983,3359,1915,2316,204761,211844,242,10.579,185,8.087,16890,3768,13122,1.779,7.973,31155,5557,25598,2.623,14.707,-14265,-6.734,15.946,111,111,1714
1983,3361,184,241,217758,223047,40,16.985,29,12.314,21961,1501,20460,0.673,9.846,32839,7327,25512,3.285,14.723,-10878,-4.877,19.692,20,20,619
1983,3362,1640,1808,88839,90057,171,9.421,185,10.193,13020,2518,10502,2.796,14.458,15658,4322,11336,4.799,17.387,-2638,-2.929,28.915,136,137,1139
1983,3363,3568,4269,544948,548087,376,8.865,321,7.568,49454,7040,42414,1.284,9.023,55194,15716,39478,2.867,10.070,-5740,-1.047,18.046,228,230,7787
1983,3364,1220,1461,638487,642170,121,8.288,119,8.151,49421,3619,45802,0.564,7.696,58101,3302,54799,0.514,9.048,-8680,-1.352,15.392,80,80,993
1983,3365,171,210,25416,33503,20,9.390,26,12.207,689,502,187,1.498,2.057,16872,1938,14934,5.785,50.360,-16183,-48.303,4.113,15,15,221
1983,3366,1134,1228,160444,181119,128,10.310,155,12.485,16754,1562,15192,0.862,9.250,57634,6756,50878,3.730,31.821,-40880,-22.571,18.501,112,112,2658
1983,3369,437,448,36118,34123,69,15.664,54,12.259,8174,3777,4397,11.069,23.955,4129,538,3591,1.577,12.101,4045,11.854,24.201,41,41,364
1983,3371,11678,12286,336063,336636,1420,11.489,1567,12.679,44692,12799,31893,3.802,13.276,45448,16800,28648,4.991,13.501,-756,-0.225,26.552,1195,1204,10670
1983,3372,2387,2518,116068,118327,236,9.444,198,7.923,13508,3893,9615,3.290,11.416,18063,4206,13857,3.555,15.265,-4555,-3.850,22.832,161,162,1971
1983,3379,1067,1202,37052,36840,109,9.129,93,7.789,5137,1023,4114,2.777,13.944,4736,1357,3379,3.684,12.856,401,1.089,25.712,71,71,659
1983,3391,9783,10338,217635,218687,1276,12.518,987,9.683,23507,6901,16606,3.156,10.749,25664,6458,19206,2.953,11.736,-2157,-0.986,21.498,723,724,3182
1983,3399,14384,15010,393409,407283,1861,12.459,1715,11.482,46791,15291,31500,3.754,11.489,74774,18195,56579,4.467,18.359,-27983,-6.871,22.977,1340,1342,10373
1983,4231,18602,21909,234861,237952,2238,10.219,2219,10.133,33780,11607,22173,4.878,14.196,39836,13463,26373,5.658,16.741,-6056,-2.545,28.392,1491,1524,7974
1983,4232,7090,8109,86349,87400,940,11.533,1023,12.551,13896,4308,9588,4.929,15.899,15993,5113,10880,5.850,18.299,-2097,-2.399,31.799,737,748,3244
1983,4233,7064,8706,98620,98777,1055,12.104,1075,12.334,17108,5227,11881,5.292,17.320,17326,6700,10626,6.783,17.541,-218,-0.221,34.640,706,719,3978
1983,4234,20781,28214,457684,448386,4452,16.279,2721,9.949,90306,33219,57087,7.409,20.140,71145,24326,46819,5.425,15.867,19161,4.273,31.734,1688,1713,9320
1983,4235,6368,8775,120172,128865,903,10.188,1079,12.174,14395,6161,8234,4.781,11.171,31806,10485,21321,8.136,24.682,-17411,-13.511,22.341,577,591,4604
1983,4236,14049,19684,245736,247473,2355,12.059,2044,10.467,42480,14516,27964,5.866,17.166,45739,17246,28493,6.969,18.482,-3259,-1.317,34.331,1164,1200,7401
1983,4237,10352,13396,138188,141593,1173,8.753,1183,8.828,17768,5676,12092,4.009,12.549,24631,8013,16618,5.659,17.396,-6863,-4.847,25.097,760,795,5011
1983,4238,45711,59736,606348,636702,5438,9.084,5692,9.508,77698,29797,47901,4.680,12.203,138973,35371,103602,5.555,21.827,-61275,-9.624,24.406,3527,3608,18836
1983,4239,21435,23092,200088,204688,3503,15.211,3377,14.664,37856,13760,24096,6.722,18.495,47007,17096,29911,8.352,22.965,-9151,-4.471,36.989,2603,2631,11776
1983,4241,7555,10119,138192,140978,988,9.858,794,7.923,18324,5897,12427,4.183,12.998,23973,6543,17430,4.641,17.005,-5649,-4.007,25.996,508,512,2738
1983,4242,2687,3398,93582,92903,419,12.478,339,10.095,14376,2964,11412,3.190,15.474,12973,3040,9933,3.272,13.964,1403,1.510,27.928,234,234,1323
1983,4243,8463,9092,94225,94965,1551,17.073,1536,16.908,21715,9424,12291,9.924,22.866,23227,9879,13348,10.403,24.459,-1512,-1.592,45.733,1140,1151,5733
1983,4244,26857,32858,575336,578441,3433,10.482,3217,9.823,82549,23851,58698,4.123,14.271,88757,29468,59289,5.094,15.344,-6208,-1.073,28.542,2314,2351,16059
1983,4245,8287,11419,100823,103954,709,6.114,1064,9.175,14086,3956,10130,3.806,13.550,20277,5874,14403,5.651,19.506,-6191,-5.956,27.101,695,746,3939
1983,4246,6281,9424,112760,116248,1129,12.043,1030,10.987,18267,6110,12157,5.256,15.714,25192,7203,17989,6.196,21.671,-6925,-5.957,31.428,564,578,2708
1983,4247,11692,15010,148577,154038,1051,6.902,1488,9.771,23210,6882,16328,4.468,15.068,33948,11455,22493,7.437,22.039,-10738,-6.971,30.136,947,963,6827
1983,4248,4647,5776,137181,136981,361,6.212,431,7.417,15759,3812,11947,2.783,11.505,15383,5740,9643,4.190,11.230,376,0.274,22.460,275,284,2727
1983,4249,17706,21253,211773,213090,2693,12.764,2385,11.304,35592,13549,22043,6.358,16.703,38385,14440,23945,6.776,18.014,-2793,-1.311,33.406,1655,1673,7401
1983,4251,27440,30059,274188,278314,3394,11.409,2774,9.325,43430,15058,28372,5.410,15.605,51291,15316,35975,5.503,18.429,-7861,-2.825,31.209,1769,1778,8594
1983,4411,36513,37533,747271,741858,3818,10.149,3993,10.614,100512,33778,66734,4.553,13.549,89835,38075,51760,5.132,12.109,10677,1.439,24.219,3297,3313,31881
1983,4412,10946,11374,70437,70359,1268,11.113,1340,11.744,14454,5103,9351,7.253,20.543,14308,5620,8688,7.988,20.336,146,0.208,40.671,1052,1062,4436
1983,4413,43374,60749,422143,421266,5856,9.728,4756,7.900,68082,25724,42358,6.106,16.161,66446,22704,43742,5.389,15.773,1636,0.388,31.546,3044,3141,13737
1983,4421,21903,26322,197168,200381,2667,10.056,3067,11.564,32790,11871,20919,5.924,16.364,39093,14951,24142,7.461,19.509,-6303,-3.146,32.728,2207,2293,9893
1983,4422,19849,23504,129010,127378,3337,14.306,2981,12.780,28514,12394,16120,9.730,22.385,24976,9597,15379,7.534,19.608,3538,2.778,39.216,2121,2217,6579
1983,4431,28374,40074,221991,218469,5341,13.440,4673,11.759,51047,21508,29539,9.845,23.366,43915,18068,25847,8.270,20.101,7132,3.265,40.203,2861,3016,10161
1983,4441,56239,71655,650156,646986,5881,8.203,5962,8.316,99006,32455,66551,5.016,15.303,92707,28949,63758,4.474,14.329,6299,0.974,28.658,4090,4197,16903
1983,4442,16287,19799,141658,143603,2090,10.639,1780,9.061,21924,7975,13949,5.554,15.267,25774,7718,18056,5.375,17.948,-3850,-2.681,30.534,1227,1246,4698
1983,4451,63784,96545,1770615,1748006,11625,12.065,11241,11.666,284940,138921,146019,7.947,16.301,241099,100959,140140,5.776,13.793,43841,2.508,27.586,7232,7450,41913
1983,4452,22951,28012,173359,170410,4379,15.840,3645,13.185,41610,19385,22225,11.376,24.418,35596,15422,20174,9.050,20.889,6014,3.529,41.777,2715,2804,11227
1983,4453,28989,34377,168669,167659,3846,11.210,3709,10.811,36204,12951,23253,7.725,21.594,34181,13322,20859,7.946,20.387,2023,1.207,40.775,2778,2812,9308
1983,4461,46492,65911,569962,568279,6803,10.381,6048,9.229,89571,37304,52267,6.564,15.762,85856,31272,54584,5.503,15.108,3715,0.654,30.216,3842,4005,17752
1983,4471,100025,141889,840943,849262,17477,12.246,19139,13.410,180454,83965,96489,9.887,21.248,197063,82450,114613,9.708,23.204,-16609,-1.956,42.497,12611,12893,50349
1983,4481,57800,96091,781155,782757,10353,10.709,11523,11.919,153823,65320,88503,8.345,19.651,159598,56716,102882,7.246,20.389,-5775,-0.738,39.303,7265,7790,30288
1983,4482,12289,35602,184432,186709,3683,10.320,3856,10.805,36762,15898,20864,8.515,19.689,40951,15847,25104,8.488,21.933,-4189,-2.244,39.379,1389,1547,5359
1983,4483,17603,25216,145299,145319,2935,11.749,2465,9.867,28109,12972,15137,8.927,19.343,28368,9918,18450,6.825,19.521,-259,-0.178,38.686,1491,1567,5775
1983,4511,31739,42480,261043,257169,5801,13.686,5616,13.249,55774,23030,32744,8.955,21.688,48265,20214,28051,7.860,18.768,7509,2.920,37.536,4042,4199,13319
1983,4512,7657,11402,70346,68526,1618,14.461,1192,10.653,16040,6887,9153,10.050,23.407,12512,4444,8068,6.485,18.259,3528,5.148,36.518,868,892,2892
1983,4522,470,6669,1018450,1050801,347,5.149,487,7.227,79662,34407,45255,3.274,7.581,142585,51973,90612,4.946,13.569,-62923,-5.988,15.162,18,22,474
1983,4523,14247,28574,740232,759724,2553,8.829,3240,11.204,83251,36849,46402,4.850,10.958,122781,45053,77728,5.930,16.161,-39530,-5.203,21.916,1580,1617,6854
1983,4531,20912,22255,104172,102929,3334,15.272,2486,11.387,22518,9658,12860,9.383,21.877,20057,7558,12499,7.343,19.486,2461,2.391,38.973,1883,1907,5659
1983,4532,24427,30006,186425,180312,4707,16.012,3490,11.872,46697,25422,21275,14.099,25.898,34987,13698,21289,7.597,19.404,11710,6.494,38.807,2546,2626,9118
1983,4533,8419,9902,42570,42193,1673,17.214,1307,13.448,11052,5328,5724,12.628,26.194,10387,3306,7081,7.835,24.618,665,1.576,49.236,952,952,2235
1983,4539,23414,28350,122005,119481,4537,16.377,3243,11.706,31172,14802,16370,12.389,26.090,26266,10360,15906,8.671,21.983,4906,4.106,43.967,2287,2371,7239
1983,4541,5694,7357,92781,92320,958,12.976,1010,13.680,19113,6715,12398,7.274,20.703,18039,7290,10749,7.896,19.540,1074,1.163,39.079,658,663,2820
1983,4542,3970,5226,78108,79380,533,10.011,729,13.693,12574,3525,9049,4.441,15.840,15156,5691,9465,7.169,19.093,-2582,-3.253,31.681,385,388,1723
1983,4543,17144,22910,199439,201077,2343,10.256,2214,9.691,33160,11477,21683,5.708,16.491,36734,12578,24156,6.255,18.269,-3574,-1.777,32.982,1515,1545,6738
1983,4811,1101,2748,290186,287795,361,13.316,287,10.586,36898,12324,24574,4.282,12.821,30933,6691,24242,2.325,10.748,5965,2.073,21.497,128,128,1022
1983,4812,425,601,13094,12616,105,17.647,93,15.630,2463,478,1985,3.789,19.524,1475,607,868,4.812,11.692,988,7.832,23.384,66,66,523
1983,4831,383,648,33352,34181,55,8.378,72,10.967,6414,2843,3571,8.318,18.765,7875,1919,5956,5.614,23.039,-1461,-4.274,37.530,33,33,268
1983,4832,385,446,15290,16309,35,7.761,45,9.978,1242,475,767,2.913,7.615,3277,404,2873,2.477,20.093,-2035,-12.478,15.231,29,29,211
1983,4841,21859,27435,482947,493072,4517,16.489,4436,16.193,72120,25115,47005,5.094,14.627,93400,31387,62013,6.366,18.942,-21280,-4.316,29.253,3080,3106,14998
1983,4842,37965,41603,479678,489506,6249,14.980,6474,15.519,85444,29705,55739,6.068,17.455,105756,34544,71212,7.057,21.605,-20312,-4.149,34.910,4786,4801,21369
1983,4851,404,438,27557,26305,46,10.514,45,10.286,5144,3151,1993,11.979,19.555,2434,1068,1366,4.060,9.253,2710,10.302,18.506,35,38,1035
1983,4852,353,695,28317,28984,37,5.324,37,5.324,3030,1402,1628,4.837,10.454,4404,1039,3365,3.585,15.195,-1374,-4.741,20.908,19,19,153
1983,4853,5306,5358,52689,54350,831,15.406,903,16.741,9334,3509,5825,6.456,17.174,12719,4680,8039,8.611,23.402,-3385,-6.228,34.348,765,765,4044
1983,4854,3466,3665,93268,93188,301,8.193,319,8.683,10798,3004,7794,3.224,11.587,10673,3671,7002,3.939,11.453,125,0.134,22.906,269,269,2303
1983,4855,518,551,11930,11678,87,15.949,76,13.932,2564,608,1956,5.207,21.957,2019,963,1056,8.247,17.290,545,4.667,34.579,53,53,369
1983,4859,967,1014,23666,21638,178,17.953,133,13.414,7345,1362,5983,6.295,33.946,3017,1360,1657,6.285,13.943,4328,20.002,27.887,102,104,1168
1983,4861,74,323,12099,12396,29,9.006,27,8.385,1563,716,847,5.776,12.609,2198,493,1705,3.977,17.732,-635,-5.123,25.218,5,5,128
1983,4862,235,1275,60465,60010,123,9.968,41,3.323,5254,3048,2206,5.079,8.755,4366,886,3480,1.476,7.276,888,1.480,14.551,19,19,105
1983,4869,65,329,7545,7370,45,13.997,30,9.331,1430,885,545,12.009,19.404,1084,508,576,6.893,14.709,346,4.695,29.419,6,6,61
1983,4871,173,179,2851,2794,31,17.816,21,12.069,634,221,413,7.911,22.696,535,87,448,3.114,19.152,99,3.544,38.303,15,15,67
1983,4872,719,725,7665,7979,113,15.511,120,16.472,1389,520,869,6.518,17.409,2012,793,1219,9.939,25.218,-623,-7.808,34.819,89,89,633
1983,4879,57,71,820,729,9,13.235,3,4.412,238,29,209,3.981,32.670,59,3,56,0.412,8.099,179,24.571,16.198,D,D,D
1983,4881,2005,2558,57569,56790,364,14.376,312,12.322,10278,3312,6966,5.832,18.098,8735,2138,6597,3.765,15.381,1543,2.717,30.763,230,232,1420
1983,4882,337,435,10193,11186,72,16.628,68,15.704,1468,549,919,4.908,13.124,3520,1308,2212,11.693,31.468,-2052,-18.344,26.247,42,42,757
1983,4883,2229,2654,107534,113458,322,12.001,380,14.163,16378,5330,11048,4.698,14.435,28370,5421,22949,4.778,25.005,-11992,-10.570,28.871,254,255,3038
1983,4884,2749,3268,36607,38082,465,14.270,446,13.687,5787,2330,3457,6.118,15.196,8755,3496,5259,9.180,22.990,-2968,-7.794,30.392,302,337,2374
1983,4885,4709,6537,82197,83812,1060,16.678,697,10.967,14232,5967,8265,7.120,16.981,17483,4907,12576,5.855,20.860,-3251,-3.879,33.962,496,498,2713
1983,4889,381,388,5358,5862,79,21.095,52,13.885,1183,336,847,5.732,20.183,2154,818,1336,13.955,36.748,-971,-16.566,40.365,45,45,576
1983,4921,1256,1909,64187,63507,415,22.481,289,15.655,9829,3687,6142,5.806,15.477,8277,2874,5403,4.526,13.033,1552,2.444,26.067,192,192,1170
1983,4922,879,884,5881,5115,420,53.846,212,27.179,2794,2229,565,43.582,54.629,1214,708,506,13.843,23.736,1580,30.893,47.473,187,187,634
1983,4931,5959,9417,358684,366813,744,7.815,950,9.979,50871,13448,37423,3.666,13.868,66871,18598,48273,5.070,18.230,-16000,-4.362,27.737,326,341,2922
1983,5111,13139,14995,601429,602990,1583,10.642,1343,9.029,48004,14051,33953,2.330,7.961,51030,13859,37171,2.298,8.463,-3026,-0.502,15.922,1059,1060,8598
1983,5112,7091,8353,131205,127338,1358,16.368,1245,15.006,31321,7604,23717,5.972,24.597,23805,9613,14192,7.549,18.694,7516,5.902,37.389,845,858,4054
1983,5121,8811,14068,176792,182606,2178,15.477,2187,15.541,43912,16207,27705,8.875,24.047,55076,15029,40047,8.230,30.161,-11164,-6.114,48.095,1132,1216,7926
1983,5122,1596,1601,11553,11236,465,30.333,329,21.461,3589,1677,1912,14.926,31.943,2977,1193,1784,10.618,26.496,612,5.447,52.993,270,270,863
1983,5151,6003,7060,216417,212640,817,11.761,590,8.493,31629,13489,18140,6.344,14.874,23948,9633,14315,4.530,11.262,7681,3.612,22.525,443,444,7105
1983,5152,8,8,36,42,3,37.500,3,37.500,8,6,2,14.286,19.048,22,7,15,16.667,52.381,-14,-33.333,38.095,3,3,7
1983,5173,2369,12001,942955,964833,1302,10.135,2994,23.305,457360,34526,422834,3.578,47.403,512436,221739,290697,22.982,53.111,-55076,-5.708,94.806,152,152,1318
1983,5174,658,1211,56206,56586,184,15.794,92,7.897,15847,5280,10567,9.331,28.005,16469,13571,2898,23.983,29.104,-622,-1.099,56.010,50,50,931
1983,5179,1121,2262,60881,65842,426,19.077,368,16.480,22554,4787,17767,7.270,34.255,33505,12970,20535,19.699,50.887,-10951,-16.632,68.510,129,129,1113
1983,5182,5782,7556,221263,216394,1201,16.029,1074,14.334,48678,17071,31607,7.889,22.495,39069,13406,25663,6.195,18.055,9609,4.441,36.109,669,675,5275
1983,5191,2045,2476,28798,28460,280,11.585,162,6.703,3952,1449,2503,5.091,13.886,3231,494,2737,1.736,11.353,721,2.533,22.706,121,121,390
1983,5211,37,75,24518,24585,10,13.986,3,4.196,742,384,358,1.562,3.018,886,213,673,0.866,3.604,-144,-0.586,6.036,D,D,D
1983,5221,20315,68067,1867267,1858536,3911,5.816,2271,3.377,202430,57080,145350,3.071,10.892,186032,41588,144444,2.238,10.010,16398,0.882,20.019,941,1056,20456
1983,5222,22877,40056,357696,347745,2809,6.907,4035,9.922,72103,20462,51641,5.884,20.734,52273,23714,28559,6.819,15.032,19830,5.702,30.064,1661,1676,6554
1983,5223,3101,3519,43082,41733,847,25.111,555,16.454,10991,4370,6621,10.471,26.337,8032,5083,2949,12.180,19.246,2959,7.090,38.493,388,388,1480
1983,5231,5646,10636,250753,239398,1754,17.057,1048,10.192,49912,14477,35435,6.047,20.849,27210,8920,18290,3.726,11.366,22702,9.483,22.732,613,625,3859
1983,5232,119,133,6682,6424,21,15.909,19,14.394,793,152,641,2.366,12.345,285,124,161,1.930,4.437,508,7.908,8.874,12,12,43
1983,5239,13540,13916,178829,158061,3981,30.835,1970,15.259,70056,37120,32936,23.485,44.322,29238,12712,16526,8.042,18.498,40818,25.824,36.996,1564,1571,7303
1983,5241,6226,30894,1255712,1240541,3376,11.052,2680,8.774,168982,52143,116839,4.203,13.622,140337,40415,99922,3.258,11.313,28645,2.309,22.625,382,387,3279
1983,5242,94576,99287,982000,890315,16986,17.807,9190,9.634,328171,130457,197714,14.653,36.860,141727,71975,69752,8.084,15.919,186444,20.941,31.837,6776,6790,56504
1983,5259,654,849,10210,10301,102,12.304,62,7.479,2536,1114,1422,10.815,24.620,2526,226,2300,2.194,24.523,10,0.097,49.046,47,48,152
1983,5311,97216,99343,494423,494637,12320,12.361,12963,13.007,103905,48923,54982,9.891,21.006,104026,46186,57840,9.337,21.031,-121,-0.024,42.013,10442,10461,36164
1983,5312,30083,31170,159421,157796,5459,17.550,5331,17.138,41157,19129,22028,12.123,26.082,38089,16751,21338,10.616,24.138,3068,1.944,48.276,3903,3909,11340
1983,5313,20480,21163,199627,195583,3749,17.860,3405,16.221,46762,19858,26904,10.153,23.909,38908,17723,21185,9.062,19.893,7854,4.016,39.787,2550,2552,10726
1983,5321,5364,8809,101701,100125,1164,13.156,1242,14.037,25816,7259,18557,7.250,25.784,22681,11439,11242,11.425,22.653,3135,3.131,45.305,651,670,3186
1983,5322,10157,12148,101385,102299,2478,20.974,1811,15.329,24719,10093,14626,9.866,24.164,26860,9341,17519,9.131,26.256,-2141,-2.093,48.327,1268,1290,6388
1983,5323,2677,3022,20754,21029,532,18.089,370,12.581,4871,2241,2630,10.657,23.164,5476,1747,3729,8.308,26.041,-605,-2.877,46.328,276,281,1250
1983,5324,4915,5669,52259,52396,1066,19.818,486,9.035,12376,5705,6671,10.888,23.620,12832,3143,9689,5.999,24.490,-456,-0.870,47.240,301,302,1943
1983,5331,869,927,10176,10526,141,15.016,165,17.572,2370,896,1474,8.513,22.517,3096,1120,1976,10.641,29.414,-726,-6.898,45.033,126,126,744
1983,5411,118561,122240,643357,626747,17204,14.435,11095,9.309,121065,48233,72832,7.696,19.316,87931,32460,55471,5.179,14.030,33134,5.287,28.059,8300,8357,25139
1983,5412,50409,53276,422729,416415,9302,17.891,6737,12.957,79804,33067,46737,7.941,19.165,66566,30018,36548,7.209,15.985,13238,3.179,31.971,4974,5084,23423
1983,5413,46835,51407,613399,629793,8042,15.843,6746,13.290,108526,40484,68042,6.428,17.232,141828,35490,106338,5.635,22.520,-33302,-5.288,34.464,4645,4677,20706
1983,5414,11693,11939,80531,82708,2209,18.348,2410,20.017,17149,7223,9926,8.733,20.734,21366,8731,12635,10.556,25.833,-4217,-5.099,41.469,1908,1909,6375
1983,5415,5044,5996,54109,49492,3020,61.923,782,16.034,21568,13895,7673,28.076,43.579,12732,7819,4913,15.799,25.726,8836,17.854,51.451,460,467,1607
1983,5416,28375,29490,245935,232175,8390,31.469,2732,10.247,77018,40075,36943,17.261,33.172,49321,14550,34771,6.267,21.243,27697,11.929,42.486,1849,1853,9920
1983,5417,5586,6830,391443,393815,1168,18.007,481,7.415,42008,15960,26048,4.053,10.667,47555,10923,36632,2.774,12.075,-5547,-1.409,21.334,226,230,1459
1983,5418,22227,24234,293492,290052,4140,17.516,2944,12.456,55506,22040,33466,7.599,19.137,48684,19475,29209,6.714,16.785,6822,2.352,33.569,2206,2220,12030
1983,5419,27177,29860,198286,191818,4350,15.057,2409,8.339,45854,18455,27399,9.621,23.905,32457,8953,23504,4.667,16.921,13397,6.984,33.841,1733,1754,6353
1983,5511,22683,42569,2751064,2780568,4164,9.754,4405,10.319,445061,134943,310118,4.853,16.006,503635,121085,382550,4.355,18.113,-58574,-2.107,32.012,644,660,7382
1983,5611,8505,8943,115606,107427,2063,25.507,353,4.364,32830,14713,18117,13.696,30.560,16542,2949,13593,2.745,15.398,16288,15.162,30.797,159,159,2061
1983,5612,133,137,7604,6492,64,55.172,22,18.966,4526,3905,621,60.151,69.717,2339,287,2052,4.421,36.029,2187,33.688,72.058,14,14,196
1983,5613,11125,14668,542868,549523,2480,16.895,2501,17.039,152749,38658,114091,7.035,27.797,165453,36649,128804,6.669,30.109,-12704,-2.312,55.593,1647,1665,20558
1983,5614,16765,18693,189076,191654,3069,16.407,3093,16.536,39058,14403,24655,7.515,20.379,44612,18457,26155,9.630,23.277,-5554,-2.898,40.759,2399,2408,11201
1983,5615,18822,21967,156255,152746,3313,15.538,2023,9.488,35128,13315,21813,8.717,22.998,28011,12822,15189,8.394,18.338,7117,4.659,36.677,1437,1475,6750
1983,5616,10188,12214,369235,368946,2263,18.314,2549,20.628,84079,27343,56736,7.411,22.789,82243,35506,46737,9.624,22.291,1836,0.498,44.583,1954,1967,18430
1983,5617,54821,57783,700679,690992,13145,23.649,8747,15.737,162703,63834,98869,9.238,23.546,143581,48188,95393,6.974,20.779,19122,2.767,41.558,6794,6806,34963
1983,5619,10431,11312,150160,151727,2111,18.173,2719,23.407,34386,11447,22939,7.544,22.663,37595,16367,21228,10.787,24.778,-3209,-2.115,45.326,2129,2132,10483
1983,5621,5187,5335,91467,92283,657,12.387,595,11.218,12483,3033,9450,3.287,13.527,14331,4827,9504,5.231,15.529,-1848,-2.003,27.054,472,472,3313
1983,5622,2093,2565,43031,42229,290,11.379,257,10.084,7869,2692,5177,6.375,18.634,6241,2414,3827,5.717,14.779,1628,3.855,29.558,185,185,1012
1983,5629,4067,4282,40584,37575,679,16.140,529,12.574,14229,9689,4540,25.786,37.868,7868,2677,5191,7.124,20.939,6361,16.929,41.879,390,391,1835
1983,6111,12779,13121,358063,352280,722,5.557,467,3.594,36316,7247,29069,2.057,10.309,24593,4612,19981,1.309,6.981,11723,3.328,13.962,355,355,3469
1983,6112,432,527,35551,34675,40,7.626,35,6.673,5189,524,4665,1.511,14.965,3531,1264,2267,3.645,10.183,1658,4.782,20.367,22,22,190
1983,6113,1993,2327,919081,901327,139,6.070,65,2.838,76383,7879,68504,0.874,8.475,40675,1147,39528,0.127,4.513,35708,3.962,9.026,39,40,695
1983,6114,1734,2000,32769,31209,420,21.961,245,12.810,7536,2717,4819,8.706,24.147,4493,1338,3155,4.287,14.397,3043,9.751,28.793,193,193,919
1983,6115,4004,4526,45960,45435,563,12.405,588,12.956,10240,3789,6451,8.339,22.538,9272,3640,5632,8.011,20.407,968,2.131,40.814,408,430,2589
1983,6116,10765,11280,103336,103237,2102,18.963,1711,15.436,20976,9524,11452,9.225,20.318,20852,7625,13227,7.386,20.198,124,0.120,40.397,1328,1342,5942
1983,6117,1232,1264,11039,11031,306,26.574,81,7.034,2798,1383,1415,12.538,25.366,2742,826,1916,7.488,24.858,56,0.508,49.717,55,55,204
1983,6211,177261,182651,986926,959919,17952,10.038,10315,5.768,172880,68912,103968,7.179,18.010,118630,34763,83867,3.621,12.358,54250,5.652,24.717,8115,8165,26381
1983,6212,92618,94759,418554,409018,7168,7.672,4521,4.839,69930,23695,46235,5.793,17.097,50745,14377,36368,3.515,12.407,19185,4.691,24.813,3511,3553,11290
1983,6213,38625,40395,129816,123503,6495,16.759,3217,8.301,33222,16871,16351,13.660,26.900,20599,8411,12188,6.810,16.679,12623,10.221,33.358,2271,2304,6308
1983,6214,5092,6524,111221,106866,1135,18.177,575,9.209,23791,10250,13541,9.591,22.263,14943,5075,9868,4.749,13.983,8848,8.280,27.966,358,361,2439
1983,6215,3939,4938,63400,62994,639,13.168,468,9.645,10711,3347,7364,5.313,17.003,10022,3704,6318,5.880,15.909,689,1.094,31.819,324,337,2721
1983,6216,3297,4353,161208,153971,842,20.427,380,9.219,39983,13984,25999,9.082,25.968,25242,5069,20173,3.292,16.394,14741,9.574,32.788,244,248,2534
1983,6219,3099,3601,69272,68527,728,21.415,325,9.560,14665,6142,8523,8.963,21.400,13094,4119,8975,6.011,19.108,1571,2.293,38.216,227,227,3090
1983,6221,3834,4976,3111028,3064506,241,4.868,190,3.838,216956,87281,129675,2.848,7.080,124620,31535,93085,1.029,4.067,92336,3.013,8.133,91,96,15896
1983,6222,387,523,100632,97323,58,11.361,33,6.464,11500,6666,4834,6.849,11.816,4858,1728,3130,1.776,4.992,6642,6.825,9.983,22,22,1333
1983,6223,201,243,50409,48920,12,4.898,16,6.531,4384,1487,2897,3.040,8.962,1408,208,1200,0.425,2.878,2976,6.083,5.756,8,8,44
1983,6231,8528,12290,953979,946088,950,7.795,746,6.121,115875,48882,66993,5.167,12.248,99113,38053,61060,4.022,10.476,16762,1.772,20.952,469,501,23428
1983,6232,3725,4973,112664,106942,753,16.055,187,3.987,23853,11386,12467,10.647,22.305,12314,2021,10293,1.890,11.515,11539,10.790,23.029,124,126,1455
1983,6233,6894,7927,221178,219514,1068,13.691,815,10.448,34026,14128,19898,6.436,15.501,30552,16172,14380,7.367,13.918,3474,1.583,27.836,519,536,11678
1983,6239,2563,3158,76030,74323,372,12.117,196,6.384,12061,4854,7207,6.531,16.228,8565,2480,6085,3.337,11.524,3496,4.704,23.048,125,125,1418
1983,6241,12805,17591,246925,244387,2218,12.964,1253,7.324,50960,17726,33234,7.253,20.852,45518,9811,35707,4.015,18.625,5442,2.227,37.251,672,700,5163
1983,6242,3547,4239,41632,41730,544,13.210,302,7.334,7942,3134,4808,7.510,19.032,8156,1955,6201,4.685,19.545,-214,-0.513,38.064,160,163,885
1983,6243,3643,5320,229204,222647,603,11.497,453,8.637,52152,9016,43136,4.049,23.424,38294,7514,30780,3.375,17.199,13858,6.224,34.399,203,215,3244
1983,6244,27129,31957,266801,263470,4690,15.063,3047,9.786,54336,24038,30298,9.124,20.623,48142,15348,32794,5.825,18.272,6194,2.351,36.545,2212,2256,10484
1983,7111,4281,4331,59858,59167,741,17.021,786,18.054,17013,5144,11869,8.694,28.754,15650,4512,11138,7.626,26.451,1363,2.304,52.901,565,566,2965
1983,7112,2065,2151,59394,58063,400,18.944,321,15.202,11641,4216,7425,7.261,20.049,8966,3129,5837,5.389,15.442,2675,4.607,30.884,243,245,1390
1983,7113,1907,1942,28227,28354,369,19.411,287,15.097,8231,3735,4496,13.173,29.029,8549,3079,5470,10.859,30.151,-318,-1.122,58.059,205,205,2022
1983,7114,1052,1069,11014,11071,231,21.865,206,19.498,3365,1784,1581,16.114,30.395,3556,1402,2154,12.664,32.120,-191,-1.725,60.789,165,165,1248
1983,7115,7431,7453,58376,55945,2754,40.885,1320,19.596,17100,9177,7923,16.404,30.566,12276,4728,7548,8.451,21.943,4824,8.623,43.886,935,935,3627
1983,7121,2047,2195,35212,35705,190,8.813,112,5.195,3457,610,2847,1.708,9.682,4406,721,3685,2.019,12.340,-949,-2.658,19.365,65,66,282
1983,7131,2296,2748,59761,57307,707,26.750,497,18.804,11989,3533,8456,6.165,20.921,6825,2300,4525,4.013,11.910,5164,9.011,23.819,394,398,1549
1983,7132,758,776,16263,16641,165,21.768,129,17.018,2670,1016,1654,6.106,16.045,3483,1181,2302,7.097,20.931,-813,-4.886,32.090,106,106,980
1983,7139,30982,32804,448747,449724,4726,14.681,3500,10.873,80511,34834,45677,7.746,17.902,82436,25801,56635,5.737,18.330,-1925,-0.428,35.805,2639,2656,18290
1983,7211,28729,32969,1062942,1072297,4308,13.155,3865,11.802,176384,87083,89301,8.121,16.449,195978,73049,122929,6.812,18.276,-19594,-1.827,32.898,2795,2827,43313
1983,7212,3539,3790,20147,20189,571,15.378,417,11.231,5547,2303,3244,11.407,27.476,5543,2031,3512,10.060,27.456,4,0.020,54.912,256,256,1446
1983,7213,4754,4860,23233,22846,310,6.351,353,7.231,4231,1284,2947,5.620,18.520,3415,973,2442,4.259,14.948,816,3.572,29.896,263,266,782
1983,7223,12550,15801,273075,267900,2921,18.814,2370,15.265,67863,35176,32687,13.130,25.332,57214,23336,33878,8.711,21.357,10649,3.975,42.713,1706,1715,14348
1983,7224,59331,60130,324526,324757,9796,16.285,9841,16.360,91476,52684,38792,16.223,28.168,91648,42150,49498,12.979,28.220,-172,-0.053,56.335,7938,7959,33599
1983,7225,191282,251119,4283903,4207918,44174,17.974,33464,13.616,1019801,557404,462397,13.247,24.235,865370,363973,501397,8.650,20.565,154431,3.670,41.131,23747,24301,225965
1983,8111,92110,96345,432675,427505,16089,17.090,11684,12.411,98618,48259,50359,11.289,23.068,88395,35751,52644,8.363,20.677,10223,2.391,41.354,8936,8993,27753
1983,8112,9413,10522,65691,62816,1701,16.499,1276,12.377,15858,9261,6597,14.743,25.245,10178,4146,6032,6.600,16.203,5680,9.042,32.406,940,952,2816
1983,8113,17909,18980,132934,139777,2639,13.884,2693,14.168,24094,8881,15213,6.354,17.237,37580,12387,25193,8.862,26.886,-13486,-9.648,34.475,2062,2065,8979
1983,8114,21186,22856,129889,129592,3851,17.025,3378,14.934,26025,11931,14094,9.207,20.082,25238,10110,15128,7.801,19.475,787,0.607,38.950,2426,2438,6492
1983,8121,79585,88404,426362,417616,12057,13.677,11559,13.112,98205,45071,53134,10.792,23.516,80918,36140,44778,8.654,19.376,17287,4.139,38.752,8880,8968,26594
1983,8122,17108,19824,112669,112203,1410,7.142,1245,6.307,16536,5318,11218,4.740,14.738,15686,4284,11402,3.818,13.980,850,0.758,27.960,814,840,2772
1983,8123,32554,38362,328624,331289,4753,12.436,4468,11.690,51660,21897,29763,6.610,15.594,56897,23249,33648,7.018,17.174,-5237,-1.581,31.187,3251,3394,15142
1983,8129,12460,19156,200690,200937,4065,21.593,3404,18.082,48458,19167,29291,9.539,24.116,50020,23792,26228,11.841,24.893,-1562,-0.777,48.232,2062,2119,15115
1983,8131,79337,79451,747561,730771,7260,9.387,3037,3.927,100495,23255,77240,3.182,13.752,67051,10805,56246,1.479,9.175,33444,4.577,18.351,1607,1607,6651
1983,8132,6894,7865,108587,107716,807,10.416,573,7.395,18725,3939,14786,3.657,17.384,16848,4566,12282,4.239,15.641,1877,1.743,31.282,317,337,2692
1983,8133,6546,7742,81843,82640,935,12.231,740,9.680,15058,4243,10815,5.134,18.221,16856,4667,12189,5.647,20.397,-1798,-2.176,36.443,404,422,2371
1983,8134,28351,29682,245685,244471,2054,6.963,1687,5.719,35413,9031,26382,3.694,14.486,33013,6502,26511,2.660,13.504,2400,0.982,27.008,1152,1154,3848
1983,8139,55022,57207,440287,438621,4446,7.762,4586,8.007,77725,23608,54117,5.382,17.720,74417,17123,57294,3.904,16.966,3308,0.754,33.932,3224,3236,11752
1984,1131,218,223,2120,2272,43,19.725,33,15.138,521,191,330,8.407,22.931,848,563,285,24.780,37.324,-327,-14.393,45.863,23,23,184
1984,1132,78,93,1265,1275,13,14.130,11,11.957,174,76,98,5.963,13.652,194,87,107,6.826,15.222,-20,-1.569,27.305,8,8,55
1984,1133,10635,10738,90225,86280,1918,18.358,1337,12.797,24028,7939,16089,9.201,27.849,16022,5610,10412,6.502,18.570,8006,9.279,37.140,998,1000,4128
1984,1141,1258,1274,8645,8509,214,16.474,264,20.323,3088,931,2157,10.941,36.291,2817,1223,1594,14.373,33.106,271,3.185,66.212,167,167,707
1984,1142,125,126,532,574,19,14.902,22,17.255,99,45,54,7.840,17.247,184,104,80,18.118,32.056,-85,-14.808,34.495,17,17,64
1984,1151,4050,4449,52050,51665,559,12.631,512,11.569,13947,5548,8399,10.738,26.995,13440,3186,10254,6.167,26.014,507,0.981,52.027,342,345,2367
1984,1152,1779,1800,13324,12905,297,16.789,235,13.284,2833,895,1938,6.935,21.953,2000,783,1217,6.067,15.498,833,6.455,30.996,178,178,576
1984,1153,752,764,10012,9961,176,23.881,122,16.554,3109,1227,1882,12.319,31.213,3000,1184,1816,11.887,30.119,109,1.094,60.238,86,86,1054
1984,2111,7970,9950,186688,176624,1267,12.784,1189,11.997,52201,8999,43202,5.095,29.555,33518,10822,22696,6.127,18.977,18683,10.578,37.954,775,791,4444
1984,2121,2744,3450,183633,184463,569,16.450,587,16.970,31854,9066,22788,4.915,17.269,33083,10665,22418,5.782,17.935,-1229,-0.666,34.537,451,451,6251
1984,2122,542,698,46382,46128,155,22.190,156,22.334,8119,1807,6312,3.917,17.601,7762,2212,5550,4.795,16.827,357,0.774,33.654,111,114,899
1984,2123,3543,4999,98692,97705,426,8.540,404,8.099,16362,3808,12554,3.897,16.746,14246,4244,10002,4.344,14.581,2116,2.166,29.161,246,248,1159
1984,2131,10972,12621,284046,286427,2051,16.203,2125,16.788,65584,20907,44677,7.299,22.897,70649,24932,45717,8.704,24.666,-5065,-1.768,45.795,1616,1625,14323
1984,2211,1606,5813,586349,583940,222,3.854,117,2.031,30272,7869,22403,1.348,5.184,25468,3075,22393,0.527,4.361,4804,0.823,8.723,36,36,278
1984,2212,545,2420,140428,139769,162,6.802,85,3.569,8118,2684,5434,1.920,5.808,6646,1639,5007,1.173,4.755,1472,1.053,9.510,23,23,144
1984,2213,3703,4007,29528,29184,355,8.999,231,5.856,3409,1122,2287,3.845,11.681,2766,980,1786,3.358,9.478,643,2.203,18.956,172,172,719
1984,2361,90654,91024,543556,494854,21965,25.303,13531,15.587,218019,85589,132430,17.296,44.057,120538,49193,71345,9.941,24.358,97481,19.699,48.717,9742,9744,37540
1984,2362,33820,34417,562941,535019,5789,17.322,3796,11.358,173454,39306,134148,7.347,32.420,117235,24583,92652,4.595,21.912,56219,10.508,43.825,2750,2753,18161
1984,2371,12891,13209,299407,295332,1757,13.413,1537,11.734,70609,13597,57012,4.604,23.908,63086,13488,49598,4.567,21.361,7523,2.547,42.722,1164,1164,9043
1984,2372,8057,8169,68747,61120,2299,29.853,1363,17.699,28429,13817,14612,22.606,46.513,13148,5378,7770,8.799,21.512,15281,25.002,43.024,1059,1060,4119
1984,2373,9770,10051,204037,193662,1237,12.474,968,9.762,57902,11825,46077,6.106,29.899,37403,8816,28587,4.552,19.314,20499,10.585,38.627,712,712,6235
1984,2379,4458,4564,95632,98813,922,20.735,687,15.450,23551,6049,17502,6.122,23.834,30533,4316,26217,4.368,30.900,-6982,-7.066,47.668,509,510,2638
1984,2381,64642,65021,596862,555818,12115,19.289,7686,12.238,211802,61822,149980,11.123,38.106,129577,42166,87411,7.586,23.313,82225,14.794,46.626,5675,5676,32489
1984,2382,99578,101494,1038603,983318,15651,15.887,9694,9.840,280950,69459,211491,7.064,28.572,170039,45009,125030,4.577,17.292,110911,11.279,34.585,7411,7417,34752
1984,2383,65024,65434,533158,495425,13614,21.596,8825,13.999,188460,57703,130757,11.647,38.040,113055,37485,75570,7.566,22.820,75405,15.220,45.640,6572,6575,28898
1984,2389,34633,34913,346185,331018,5969,17.521,4279,12.560,103649,28184,75465,8.514,31.312,73750,20027,53723,6.050,22.280,29899,9.032,44.560,3142,3143,14388
1984,3111,1328,1950,53141,53501,107,5.427,150,7.608,5535,1606,3929,3.002,10.346,6281,1603,4678,2.996,11.740,-746,-1.394,20.691,103,103,655
1984,3112,545,891,69185,71383,56,6.321,46,5.192,4178,784,3394,1.098,5.853,8604,2202,6402,3.085,12.053,-4426,-6.200,11.706,24,24,154
1984,3113,1435,1804,87431,86140,234,13.247,159,9.001,10695,2637,8058,3.061,12.416,8223,2402,5821,2.788,9.546,2472,2.870,19.092,108,110,970
1984,3114,1238,1707,176340,175274,123,7.187,132,7.713,23347,2997,20350,1.710,13.320,21414,4525,16889,2.582,12.217,1933,1.103,24.435,74,74,969
1984,3115,1814,2516,133837,134315,137,5.405,174,6.865,12273,2208,10065,1.644,9.137,13171,3259,9912,2.426,9.806,-898,-0.669,18.275,116,117,1320
1984,3116,4287,4877,328893,322971,345,7.054,373,7.626,38126,7165,30961,2.218,11.805,26678,7798,18880,2.414,8.260,11448,3.545,16.520,263,266,3426
1984,3117,769,879,45103,46585,52,5.813,83,9.279,6445,635,5810,1.363,13.835,9376,2202,7174,4.727,20.127,-2931,-6.292,27.670,53,55,1072
1984,3118,8729,10214,301962,300775,1430,14.184,1166,11.565,34606,12547,22059,4.172,11.506,32108,12867,19241,4.278,10.675,2498,0.831,21.350,862,874,7628
1984,3119,2074,2435,125230,123895,198,8.087,225,9.189,16675,5953,10722,4.805,13.459,14027,5731,8296,4.626,11.322,2648,2.137,22.643,160,162,2085
1984,3121,1996,2559,172997,173520,177,6.913,180,7.030,15669,3922,11747,2.260,9.030,16748,5195,11553,2.994,9.652,-1079,-0.622,18.060,124,124,2744
1984,3122,106,160,41334,42358,8,4.893,15,9.174,2781,77,2704,0.182,6.565,4970,600,4370,1.416,11.733,-2189,-5.168,13.131,8,8,19
1984,3131,465,682,108001,105815,38,5.580,36,5.286,11365,1583,9782,1.496,10.740,6902,2741,4161,2.590,6.523,4463,4.218,13.045,20,20,629
1984,3132,1716,2103,298904,295393,143,6.787,151,7.167,28254,3379,24875,1.144,9.565,21366,6286,15080,2.128,7.233,6888,2.332,14.466,100,100,1543
1984,3133,4361,4891,140824,137376,452,9.504,182,3.827,18260,3680,14580,2.679,13.292,11481,3511,7970,2.556,8.357,6779,4.935,16.715,113,113,1458
1984,3141,3931,4222,122291,116315,476,11.314,446,10.601,22292,4050,18242,3.482,19.165,10369,5250,5119,4.514,8.915,11923,10.251,17.829,346,346,2370
1984,3149,3631,3750,128443,122648,562,15.414,354,9.709,25267,7542,17725,6.149,20.601,13663,5828,7835,4.752,11.140,11604,9.461,22.280,290,291,4037
1984,3151,1373,1497,150738,146028,142,9.505,136,9.103,20791,4842,15949,3.316,14.238,11629,4775,6854,3.270,7.964,9162,6.274,15.927,110,110,1816
1984,3152,12147,13751,918399,894045,1771,12.756,2036,14.665,157538,46851,110687,5.240,17.621,109286,47241,62045,5.284,12.224,48252,5.397,24.448,1730,1743,34226
1984,3159,1709,1802,61522,58988,290,16.590,182,10.412,12030,3858,8172,6.540,20.394,6900,2448,4452,4.150,11.697,5130,8.697,23.395,146,146,1745
1984,3161,354,388,18392,18753,38,9.857,33,8.560,2117,442,1675,2.357,11.289,2834,739,2095,3.941,15.112,-717,-3.823,22.578,24,24,426
1984,3162,496,711,120152,123310,42,5.761,78,10.700,10528,2277,8251,1.847,8.538,16993,4751,12242,3.853,13.781,-6465,-5.243,17.076,47,49,1615
1984,3169,1266,1313,49976,50559,135,10.090,185,13.827,7364,2001,5363,3.958,14.565,8445,2501,5944,4.947,16.703,-1081,-2.138,29.130,151,153,1768
1984,3211,4951,5446,140952,134026,623,11.570,500,9.286,26062,6326,19736,4.720,19.445,12147,4083,8064,3.046,9.063,13915,10.382,18.126,374,375,2167
1984,3212,1083,1333,87335,83705,156,11.986,93,7.146,13843,2474,11369,2.956,16.538,6424,2314,4110,2.764,7.675,7419,8.863,15.349,56,56,579
1984,3219,8689,9444,281893,264468,1184,12.707,931,9.992,63030,13782,49248,5.211,23.833,28259,9664,18595,3.654,10.685,34771,13.148,21.370,712,718,6099
1984,3221,244,574,197734,198028,16,2.749,32,5.498,7495,718,6777,0.363,3.785,8051,2184,5867,1.103,4.066,-556,-0.281,7.570,14,14,254
1984,3222,3646,5212,401894,392494,291,5.623,218,4.212,41045,5564,35481,1.418,10.457,22388,6499,15889,1.656,5.704,18657,4.753,11.408,148,150,2602
1984,3231,35946,37523,721213,699387,4448,12.090,2981,8.103,109626,24276,85350,3.471,15.675,65633,24714,40919,3.534,9.384,43993,6.290,18.769,2386,2389,14158
1984,3241,1372,2204,137673,140594,226,10.386,170,7.813,10023,3322,6701,2.363,7.129,15917,5011,10906,3.564,11.321,-5894,-4.192,14.258,81,82,1079
1984,3251,1179,2254,247200,245672,154,6.863,134,5.971,20207,10587,9620,4.309,8.225,17347,3512,13835,1.430,7.061,2860,1.164,14.122,54,56,552
1984,3252,375,609,139264,139305,42,6.914,39,6.420,8610,1884,6726,1.352,6.181,8469,2079,6390,1.492,6.079,141,0.101,12.159,18,18,530
1984,3253,702,1046,46906,47704,84,7.955,104,9.848,3502,755,2747,1.583,7.341,5117,1636,3481,3.429,10.727,-1615,-3.385,14.682,42,42,295
1984,3254,1038,1267,161776,161675,133,10.598,109,8.685,13955,2261,11694,1.398,8.632,13390,3609,9781,2.232,8.282,565,0.349,16.564,70,70,1197
1984,3255,1678,2126,73683,72913,144,6.860,90,4.288,8625,2048,6577,2.809,11.829,7075,2481,4594,3.403,9.703,1550,2.126,19.407,50,52,481
1984,3256,2076,2322,123447,123026,204,8.870,160,6.957,11715,1825,9890,1.483,9.522,10814,3718,7096,3.022,8.790,901,0.732,17.580,113,120,1202
1984,3259,1759,2287,98069,96397,233,10.376,150,6.680,11341,2918,8423,3.027,11.765,8010,1648,6362,1.710,8.309,3331,3.456,16.619,109,109,673
1984,3261,10233,11817,569090,535703,1104,9.456,820,7.024,110552,19823,90729,3.700,20.637,44016,16426,27590,3.066,8.217,66536,12.420,16.433,597,599,7681
1984,3262,1951,2318,183698,177253,216,9.445,154,6.734,24482,4186,20296,2.362,13.812,11701,5091,6610,2.872,6.601,12781,7.211,13.203,101,101,922
1984,3271,1330,1607,80844,76817,197,12.417,156,9.833,13271,2328,10943,3.031,17.276,5304,1366,3938,1.778,6.905,7967,10.371,13.809,115,115,620
1984,3272,1521,1792,153870,151110,195,10.949,173,9.714,18388,2307,16081,1.527,12.169,12618,4718,7900,3.122,8.350,5770,3.818,16.700,124,124,972
1984,3273,7034,9010,176780,169468,657,7.304,627,6.971,35737,7554,28183,4.457,21.088,21161,5942,15219,3.506,12.487,14576,8.601,24.973,409,416,3197
1984,3274,239,335,16908,16263,36,10.714,38,11.310,2505,681,1824,4.187,15.403,1282,720,562,4.427,7.883,1223,7.520,15.766,30,30,113
1984,3279,1870,2145,81900,79492,218,10.283,168,7.925,12186,2429,9757,3.056,15.330,7473,2660,4813,3.346,9.401,4713,5.929,18.802,117,119,661
1984,3311,339,417,243056,237195,39,9.209,52,12.279,26045,3363,22682,1.418,10.980,14382,2139,12243,0.902,6.063,11663,4.917,12.127,32,33,333
1984,3312,500,674,70224,67358,49,7.254,52,7.698,10326,1169,9157,1.736,15.330,4624,1609,3015,2.389,6.865,5702,8.465,13.730,32,33,393
1984,3313,305,463,92466,88272,34,7.464,19,4.171,13079,2508,10571,2.841,14.817,4802,2117,2685,2.398,5.440,8277,9.377,10.880,7,7,119
1984,3314,792,980,98548,96795,99,10.180,84,8.638,12412,2286,10126,2.362,12.823,9214,2715,6499,2.805,9.519,3198,3.304,19.038,54,55,585
1984,3315,2815,3128,226417,213591,181,5.789,178,5.693,43691,8516,35175,3.987,20.455,18214,10009,8205,4.686,8.528,25477,11.928,17.055,115,116,1861
1984,3321,3177,3396,149435,141304,253,7.507,201,5.964,26468,4130,22338,2.923,18.731,10207,3681,6526,2.605,7.223,16261,11.508,14.447,145,146,1873
1984,3322,1225,1350,81263,79836,103,7.655,94,6.986,9135,1532,7603,1.919,11.442,6210,2188,4022,2.741,7.778,2925,3.664,15.557,66,66,1282
1984,3323,9975,10800,328258,318905,933,8.653,897,8.319,58693,11111,47582,3.484,18.405,40029,12839,27190,4.026,12.552,18664,5.853,25.104,685,690,6856
1984,3324,1423,1788,127464,127884,94,5.199,134,7.412,13614,1977,11637,1.546,10.646,14674,5457,9217,4.267,11.475,-1060,-0.829,21.291,84,84,1601
1984,3325,950,1021,77329,74186,105,10.458,71,7.072,11215,1859,9356,2.506,15.117,4989,1760,3229,2.372,6.725,6226,8.392,13.450,53,53,567
1984,3326,1647,1858,68624,64955,164,8.989,97,5.317,13093,1654,11439,2.546,20.157,5664,2475,3189,3.810,8.720,7429,11.437,17.440,61,62,1222
1984,3327,21044,21364,329912,309734,2132,10.059,1792,8.455,68477,10901,57576,3.519,22.108,28013,10479,17534,3.383,9.044,40464,13.064,18.088,1411,1411,7205
1984,3328,5442,5765,129785,120837,493,8.633,384,6.724,27722,4630,23092,3.832,22.942,9848,3717,6131,3.076,8.150,17874,14.792,16.300,312,312,2723
1984,3329,5220,5745,351026,337213,737,13.074,521,9.243,54982,12755,42227,3.782,16.305,27936,9055,18881,2.685,8.284,27046,8.020,16.569,390,390,3738
1984,3331,3100,3489,249079,250599,310,8.776,397,11.238,35470,4303,31167,1.717,14.154,38551,11897,26654,4.747,15.384,-3081,-1.229,28.308,254,254,2216
1984,3332,3731,3988,168956,161987,326,8.238,265,6.696,29032,7293,21739,4.502,17.922,15455,4872,10583,3.008,9.541,13577,8.382,19.082,191,192,2012
1984,3333,2056,2187,165592,163726,201,9.318,141,6.537,22072,8571,13501,5.235,13.481,18097,8755,9342,5.347,11.053,3975,2.428,22.106,100,101,1451
1984,3334,1784,2011,167530,161477,167,8.158,239,11.676,24550,2281,22269,1.413,15.203,12330,5072,7258,3.141,7.636,12220,7.568,15.272,176,177,1498
1984,3335,9482,9892,229517,221588,714,7.234,669,6.778,38925,5385,33540,2.430,17.566,23033,7534,15499,3.400,10.395,15892,7.172,20.789,498,499,3451
1984,3336,744,907,150643,146698,46,5.086,41,4.533,17959,1174,16785,0.800,12.242,10229,2007,8222,1.368,6.973,7730,5.269,13.946,18,18,139
1984,3339,5907,6478,319574,312778,477,7.379,449,6.946,45630,8532,37098,2.728,14.589,32350,10492,21858,3.354,10.343,13280,4.246,20.686,306,306,2885
1984,3341,1639,1853,362719,348775,346,19.504,188,10.598,65937,15557,50380,4.460,18.905,38502,9803,28699,2.811,11.039,27435,7.866,22.078,123,125,1958
1984,3342,1862,2069,293699,283275,221,10.786,181,8.834,49957,7106,42851,2.509,17.636,28591,6941,21650,2.450,10.093,21366,7.543,20.186,117,117,1892
1984,3343,397,423,48530,47683,43,10.035,54,12.602,6507,862,5645,1.808,13.646,4727,2557,2170,5.362,9.913,1780,3.733,19.827,37,37,284
1984,3344,4342,4910,537429,496900,737,15.469,446,9.361,110616,23698,86918,4.769,22.261,29694,10243,19451,2.061,5.976,80922,16.285,11.952,326,326,3466
1984,3345,4000,4595,660211,644675,452,10.004,298,6.596,85568,25880,59688,4.014,13.273,55050,17644,37406,2.737,8.539,30518,4.734,17.078,180,180,1488
1984,3346,618,641,18945,17832,90,13.889,104,16.049,4643,2130,2513,11.945,26.038,2365,1044,1321,5.855,13.263,2278,12.775,26.526,69,69,479
1984,3351,1190,1307,83894,81051,103,7.884,102,7.807,12440,1091,11349,1.346,15.348,6731,2287,4444,2.822,8.305,5709,7.044,16.609,78,78,965
1984,3352,349,449,126544,119004,39,8.794,28,6.313,21718,1335,20383,1.122,18.250,6801,1562,5239,1.313,5.715,14917,12.535,11.430,22,22,210
1984,3353,1985,2466,249122,242475,177,7.204,159,6.471,33963,5299,28664,2.185,14.007,20422,5633,14789,2.323,8.422,13541,5.585,16.845,103,103,801
1984,3359,1988,2396,227314,216453,260,11.024,185,7.844,35585,4909,30676,2.268,16.440,13796,4498,9298,2.078,6.374,21789,10.066,12.747,133,134,1706
1984,3361,192,249,261740,239741,32,13.035,25,10.183,48216,3141,45075,1.310,20.112,4686,2686,2000,1.120,1.955,43530,18.157,3.909,20,20,221
1984,3362,1738,1920,118138,103407,253,13.562,144,7.719,35252,6272,28980,6.065,34.091,6001,2382,3619,2.304,5.803,29251,28.287,11.607,106,107,1267
1984,3363,3676,4371,648254,597363,425,9.821,338,7.811,128125,21850,106275,3.658,21.448,25803,14127,11676,2.365,4.319,102322,17.129,8.639,230,230,3446
1984,3364,1216,1471,669856,666311,114,7.774,105,7.160,52917,10475,42442,1.572,7.942,46805,16171,30634,2.427,7.025,6112,0.917,14.049,68,68,861
1984,3365,167,201,29094,27218,13,6.341,21,10.244,5793,191,5602,0.702,21.284,1866,752,1114,2.763,6.856,3927,14.428,13.712,12,12,129
1984,3366,1128,1224,164225,161861,144,11.798,137,11.225,25235,3048,22187,1.883,15.591,20208,3459,16749,2.137,12.485,5027,3.106,24.970,103,103,1577
1984,3369,445,456,38585,37381,63,13.938,55,12.168,5248,662,4586,1.771,14.039,2703,492,2211,1.316,7.231,2545,6.808,14.462,43,43,376
1984,3371,12203,12841,378371,357320,1904,15.154,1350,10.745,72458,18263,54195,5.111,20.278,30310,13880,16430,3.884,8.483,42148,11.796,16.965,1063,1068,8900
1984,3372,2519,2653,135356,125579,309,11.926,185,7.140,28944,4912,24032,3.911,23.049,9340,3931,5409,3.130,7.438,19604,15.611,14.875,148,150,3144
1984,3379,1087,1205,41234,39086,115,9.540,116,9.623,7672,1332,6340,3.408,19.629,3340,1640,1700,4.196,8.545,4332,11.083,17.091,78,93,1181
1984,3391,9887,10424,226316,220598,1203,11.608,1082,10.440,32787,7350,25437,3.332,14.863,21652,7312,14340,3.315,9.815,11135,5.048,19.630,821,824,4120
1984,3399,14785,15389,418556,406510,2000,13.173,1588,10.459,74916,17274,57642,4.249,18.429,50738,21187,29551,5.212,12.481,24178,5.948,24.963,1275,1277,8677
1984,4231,18953,22234,251132,242815,2286,10.355,1970,8.924,42016,11326,30690,4.664,17.304,25582,9667,15915,3.981,10.536,16434,6.768,21.071,1424,1452,6349
1984,4232,7262,8255,93568,90047,1063,13.003,903,11.046,18793,4457,14336,4.950,20.870,11668,4596,7072,5.104,12.958,7125,7.913,25.915,667,671,2633
1984,4233,7311,8938,112701,105820,1136,12.865,921,10.430,25453,5794,19659,5.475,24.053,11775,4813,6962,4.548,11.127,13678,12.926,22.255,617,619,2993
1984,4234,22146,29950,504424,482290,4848,16.674,3097,10.652,114789,45070,69719,9.345,23.801,70980,31280,39700,6.486,14.717,43809,9.084,29.435,1898,1940,10771
1984,4235,6470,8819,127518,124076,917,10.435,855,9.729,21504,5350,16154,4.312,17.331,14637,6632,8005,5.345,11.797,6867,5.535,23.594,511,536,3496
1984,4236,14534,20532,287484,267027,2633,13.090,1798,8.939,76169,34912,41257,13.074,28.525,34066,13074,20992,4.896,12.758,42103,15.767,25.515,1206,1228,6553
1984,4237,10435,13521,146117,142402,1195,8.879,1071,7.958,23838,6484,17354,4.553,16.740,16413,5951,10462,4.179,11.526,7425,5.214,23.052,785,796,3626
1984,4238,45955,59856,627000,616508,5425,9.075,5276,8.825,103380,28565,74815,4.633,16.769,82253,28211,54042,4.576,13.342,21127,3.427,26.684,3337,3423,15880
1984,4239,22192,23802,221176,210782,3844,16.402,3111,13.275,52180,15914,36266,7.550,24.755,31195,13448,17747,6.380,14.800,20985,9.956,29.599,2451,2469,9181
1984,4241,7804,10358,145095,141515,1060,10.366,796,7.784,23224,6662,16562,4.708,16.411,16171,6384,9787,4.511,11.427,7053,4.984,22.854,495,500,3299
1984,4242,2715,3438,97170,95035,453,13.316,381,11.199,13241,5103,8138,5.370,13.933,9096,3437,5659,3.617,9.571,4145,4.362,19.143,276,277,2093
1984,4243,8558,9195,102504,98649,1572,17.217,1443,15.804,25698,7297,18401,7.397,26.050,17888,8229,9659,8.342,18.133,7810,7.917,36.266,1140,1151,5291
1984,4244,27131,33249,601560,589941,3532,10.677,3195,9.658,97782,25042,72740,4.245,16.575,74499,25869,48630,4.385,12.628,23283,3.947,25.256,2395,2429,16033
1984,4245,8122,11201,98068,99608,625,5.529,831,7.351,13073,3673,9400,3.687,13.124,16109,4680,11429,4.698,16.172,-3036,-3.048,26.249,546,578,3224
1984,4246,6866,10199,116332,115910,1174,11.696,852,8.488,19034,5725,13309,4.939,16.421,18436,5033,13403,4.342,15.906,598,0.516,31.811,504,535,2594
1984,4247,11371,14678,147291,146648,982,6.624,1277,8.614,25623,5692,19931,3.881,17.473,24058,8325,15733,5.677,16.405,1565,1.067,32.811,778,809,4972
1984,4248,4574,5701,141066,139509,343,5.975,422,7.351,17193,4034,13159,2.892,12.324,14055,5447,8608,3.904,10.075,3138,2.249,20.149,315,323,3556
1984,4249,18211,21787,226019,219360,2878,13.392,2285,10.633,41865,13310,28555,6.068,19.085,28618,10490,18128,4.782,13.046,13247,6.039,26.092,1691,1696,6735
1984,4251,28240,30899,290705,282602,3562,11.699,2659,8.733,52920,17030,35890,6.026,18.726,36683,12560,24123,4.444,12.980,16237,5.746,25.961,1823,1834,7990
1984,4411,37457,38494,839595,794831,4245,11.157,3353,8.813,148775,38571,110204,4.853,18.718,59507,26064,33443,3.279,7.487,89268,11.231,14.974,2776,2786,20634
1984,4412,11101,11524,79431,74973,1374,11.998,1229,10.732,19474,5535,13939,7.383,25.975,10594,4633,5961,6.180,14.130,8880,11.844,28.261,980,991,3830
1984,4413,44640,62584,456432,439909,6275,10.171,4500,7.294,84001,31415,52586,7.141,19.095,50661,19910,30751,4.526,11.516,33340,7.579,23.033,3092,3212,13104
1984,4421,22073,26567,212002,204666,3003,11.357,2752,10.408,42819,14006,28813,6.843,20.921,28041,12595,15446,6.154,13.701,14778,7.221,27.402,1976,2067,8641
1984,4422,20628,24553,143120,136114,3702,15.410,2644,11.006,35064,13432,21632,9.868,25.761,21023,8581,12442,6.304,15.445,14041,10.316,30.890,1988,2033,6324
1984,4431,29730,41912,249056,235889,6078,14.827,4242,10.348,63022,27175,35847,11.520,26.717,36909,15413,21496,6.534,15.647,26113,11.070,31.294,2891,3060,10396
1984,4441,57007,72573,702835,677096,6300,8.728,5524,7.653,126888,38487,88401,5.684,18.740,75366,26305,49061,3.885,11.131,51522,7.609,22.262,3991,4042,16998
1984,4442,16571,20062,145708,143589,2101,10.564,1753,8.814,24723,7853,16870,5.469,17.218,20337,6551,13786,4.562,14.163,4386,3.055,28.327,1273,1292,4504
1984,4451,63935,96519,1854215,1812497,10931,11.327,10909,11.304,299563,129215,170348,7.129,16.528,217615,88819,128796,4.900,12.006,81948,4.521,24.013,7578,7735,41185
1984,4452,23289,28264,179430,176439,4267,15.166,4009,14.249,41475,18952,22523,10.741,23.507,35624,15948,19676,9.039,20.191,5851,3.316,40.381,2996,3033,11621
1984,4453,28949,34334,168487,168655,3903,11.361,3942,11.475,32518,13655,18863,8.096,19.281,32835,13636,19199,8.085,19.469,-317,-0.188,38.562,3067,3104,9768
1984,4461,47589,68498,609361,590227,7316,10.878,4833,7.186,110809,45412,65397,7.694,18.774,71041,26285,44756,4.453,12.036,39768,6.738,24.072,3438,3523,16565
1984,4471,97492,139623,878837,860290,15357,10.913,17560,12.478,192241,76372,115869,8.877,22.346,155430,73154,82276,8.503,18.067,36811,4.279,36.134,11949,12207,47544
1984,4481,57485,96881,781070,781053,11552,11.972,10781,11.173,154485,71062,83423,9.098,19.779,152137,50225,101912,6.430,19.478,2348,0.301,38.957,7096,7544,28601
1984,4482,12506,36065,195317,190035,3655,10.198,3209,8.953,41924,17559,24365,9.240,22.061,31221,12178,19043,6.408,16.429,10703,5.632,32.858,1385,1477,5110
1984,4483,18108,25714,147642,146594,2942,11.545,2481,9.736,27893,10325,17568,7.043,19.027,25530,10041,15489,6.850,17.416,2363,1.612,34.831,1608,1662,5665
1984,4511,32167,42867,268624,265136,5748,13.458,5437,12.730,53481,22854,30627,8.620,20.171,46396,19291,27105,7.276,17.499,7085,2.672,34.998,3905,4069,12724
1984,4512,7850,11794,76965,75722,1600,13.756,1274,10.953,15902,6477,9425,8.554,21.001,13284,5916,7368,7.813,17.543,2618,3.457,35.086,919,962,3442
1984,4522,458,6766,1091979,1054657,422,6.287,315,4.693,127673,44936,82737,4.261,12.106,53768,15395,38373,1.460,5.098,73905,7.007,10.196,25,25,539
1984,4523,14487,29158,793068,766185,3153,10.926,2551,8.840,117184,50108,67076,6.540,15.294,63999,21959,42040,2.866,8.353,53185,6.942,16.706,1477,1512,5457
1984,4531,21892,23205,111681,108043,3399,14.941,2487,10.932,24799,9754,15045,9.028,22.953,17593,6961,10632,6.443,16.283,7206,6.670,32.567,1937,1965,5541
1984,4532,25883,31616,204058,195499,5226,16.946,3672,11.907,49079,19708,29371,10.081,25.104,32126,14214,17912,7.271,16.433,16953,8.672,32.866,2771,2859,9624
1984,4533,8854,10371,46222,44394,1787,17.652,1292,12.762,11156,5426,5730,12.223,25.130,7577,3546,4031,7.988,17.068,3579,8.062,34.136,1024,1025,2352
1984,4539,24669,29933,136870,129628,5281,18.096,3783,12.963,39572,18727,20845,14.447,30.527,24634,12735,11899,9.824,19.004,14938,11.524,38.007,2704,2773,9282
1984,4541,5928,7527,96662,94394,1141,15.347,956,12.859,18816,7047,11769,7.466,19.933,14324,5856,8468,6.204,15.175,4492,4.759,30.349,625,629,2201
1984,4542,4075,5377,80297,78577,614,11.578,466,8.787,11891,3256,8635,4.144,15.133,8327,2882,5445,3.668,10.597,3564,4.536,21.195,337,346,1695
1984,4543,17214,23048,206165,202711,2188,9.525,2032,8.846,34273,11474,22799,5.660,16.907,27216,10057,17159,4.961,13.426,7057,3.481,26.852,1498,1508,6386
1984,4811,1074,2820,298143,295249,364,13.070,294,10.557,30217,3894,26323,1.319,10.234,24979,3241,21738,1.098,8.460,5238,1.774,16.921,149,149,1546
1984,4812,444,651,17704,15484,133,21.111,91,14.444,5534,722,4812,4.663,35.741,996,376,620,2.428,6.433,4538,29.309,12.865,65,70,303
1984,4831,370,615,31829,32685,51,8.089,82,13.006,5025,1787,3238,5.467,15.374,6680,1791,4889,5.480,20.438,-1655,-5.063,30.748,36,36,385
1984,4832,375,432,15837,15493,37,8.457,48,10.971,2756,506,2250,3.266,17.789,2160,613,1547,3.957,13.942,596,3.847,27.884,32,32,409
1984,4841,22996,28591,532059,507120,5121,18.293,3927,14.028,113302,31985,81317,6.307,22.342,63198,28187,35011,5.558,12.462,50104,9.880,24.924,2832,2856,14043
1984,4842,39323,42891,523686,502283,7188,17.005,5944,14.062,119244,31112,88132,6.194,23.740,76903,33877,43026,6.745,15.311,42341,8.430,30.621,4530,4557,19715
1984,4851,403,434,27729,27656,39,8.935,44,10.080,2166,814,1352,2.943,7.832,2054,814,1240,2.943,7.427,112,0.405,14.854,34,34,555
1984,4852,341,678,24601,25271,103,15.408,84,12.565,3504,1741,1763,6.889,13.866,4908,1558,3350,6.165,19.422,-1404,-5.556,27.732,31,31,416
1984,4853,5175,5227,52430,52258,851,16.078,983,18.572,10966,4104,6862,7.853,20.984,10783,4658,6125,8.913,20.634,183,0.350,41.268,836,836,4030
1984,4854,3432,3633,95820,94258,287,7.869,315,8.637,13177,3080,10097,3.268,13.980,9945,3607,6338,3.827,10.551,3232,3.429,21.102,261,261,2756
1984,4855,586,623,12977,12471,132,22.468,61,10.383,3137,1431,1706,11.475,25.155,2132,462,1670,3.705,17.096,1005,8.059,34.193,45,45,399
1984,4859,1023,1075,25457,24736,209,19.933,156,14.878,4438,1674,2764,6.768,17.942,2980,1747,1233,7.063,12.047,1458,5.894,24.095,133,133,1553
1984,4861,71,310,11557,11901,10,3.145,26,8.176,926,51,875,0.429,7.781,1572,515,1057,4.328,13.210,-646,-5.428,15.562,6,6,64
1984,4862,237,1288,58194,59585,91,7.118,72,5.632,5016,1557,3459,2.613,8.418,7617,3952,3665,6.633,12.784,-2601,-4.365,16.837,23,24,1785
1984,4869,69,349,7565,7555,35,10.324,15,4.425,759,339,420,4.487,10.047,742,225,517,2.978,9.822,17,0.225,19.644,4,4,56
1984,4871,193,199,2798,2833,46,24.147,29,15.223,681,319,362,11.260,24.038,742,229,513,8.083,26.191,-61,-2.153,48.076,23,23,202
1984,4872,721,730,7900,7750,138,18.917,137,18.780,1918,560,1358,7.226,24.748,1640,705,935,9.097,21.161,278,3.587,42.323,107,107,550
1984,4879,55,71,1075,948,10,14.085,10,14.085,318,62,256,6.544,33.562,58,29,29,3.061,6.121,260,27.441,12.243,7,7,25
1984,4881,2065,2633,62280,59627,413,15.989,313,12.118,12749,4190,8559,7.027,21.381,7475,2656,4819,4.454,12.536,5274,8.845,25.073,224,225,1286
1984,4882,343,441,10933,10604,60,13.746,51,11.684,2503,700,1803,6.602,23.605,1838,298,1540,2.810,17.334,665,6.272,34.668,33,33,166
1984,4883,2173,2589,110006,108575,302,11.531,362,13.822,27954,8191,19763,7.544,25.746,25406,5042,20364,4.644,23.400,2548,2.347,46.799,243,246,2352
1984,4884,2902,3542,41017,39849,654,19.126,409,11.961,8875,3750,5125,9.411,22.272,6445,1993,4452,5.001,16.174,2430,6.098,32.348,308,309,1159
1984,4885,5169,7009,88275,84939,1249,18.449,771,11.388,20491,6989,13502,8.228,24.124,13833,5023,8810,5.914,16.286,6658,7.839,32.572,498,503,2761
1984,4889,387,389,4641,5015,80,20.672,76,19.638,931,429,502,8.555,18.566,1702,862,840,17.190,33.942,-771,-15.375,37.132,55,58,718
1984,4921,1375,2163,68601,66414,534,26.234,279,13.707,13254,4349,8905,6.548,19.957,8939,1947,6992,2.932,13.460,4315,6.497,26.919,197,200,1138
1984,4922,1145,1203,9790,7492,557,53.713,225,21.697,5902,4483,1419,59.837,78.777,1194,696,498,9.290,15.937,4708,62.840,31.874,191,191,616
1984,4931,5969,9360,378068,368741,679,7.231,739,7.870,62372,14382,47990,3.900,16.915,43406,11978,31428,3.248,11.771,18966,5.143,23.543,276,285,2102
1984,5111,13586,15526,625925,614464,1839,12.042,1331,8.715,67514,17940,49574,2.920,10.987,45147,14623,30524,2.380,7.347,22367,3.640,14.695,1098,1101,8184
1984,5112,7135,8416,145073,136729,1384,16.521,1306,15.590,41205,12806,28399,9.366,30.136,24428,10580,13848,7.738,17.866,16777,12.270,35.732,913,927,5475
1984,5121,9068,14064,184100,181230,2013,14.309,2021,14.366,46747,12906,33841,7.121,25.794,40762,12796,27966,7.061,22.492,5985,3.302,44.984,1093,1148,6404
1984,5122,1805,1809,13616,12580,516,30.425,290,17.099,4729,1973,2756,15.684,37.591,2627,1054,1573,8.378,20.882,2102,16.709,41.765,227,227,815
1984,5151,6250,7344,226689,222329,946,13.130,668,9.271,33481,15125,18356,6.803,15.059,24820,11228,13592,5.050,11.164,8661,3.896,22.327,508,511,6863
1984,5152,13,13,84,60,7,66.667,D,D,49,30,19,50.000,81.667,2,D,0,D,3.333,47,78.333,6.667,D,D,D
1984,5173,2854,15012,944213,946189,4610,34.166,1572,11.650,332107,248335,83772,26.246,35.099,334122,113410,220712,11.986,35.312,-2015,-0.213,70.199,223,223,1832
1984,5174,686,1257,60232,57933,184,14.935,134,10.877,15137,4463,10674,7.704,26.129,10505,3779,6726,6.523,18.133,4632,7.996,36.266,79,79,1778
1984,5179,1299,2646,70050,65615,683,27.821,301,12.261,27312,17828,9484,27.171,41.625,17535,5936,11599,9.047,26.724,9777,14.901,53.448,132,134,1064
1984,5182,5835,7724,238046,230011,1193,15.630,1011,13.245,48023,17515,30508,7.615,20.879,31953,10105,21848,4.393,13.892,16070,6.987,27.784,630,637,3760
1984,5191,2224,2654,29722,29020,402,15.728,206,8.059,4965,1612,3353,5.555,17.109,3523,1379,2144,4.752,12.140,1442,4.969,24.280,149,149,694
1984,5211,36,77,24159,24349,D,D,5,6.536,540,D,455,D,2.218,923,108,815,0.444,3.791,-383,-1.573,4.436,4,4,63
1984,5221,20365,69533,1907015,1889210,3617,5.255,2208,3.208,222157,59628,162529,3.156,11.759,186328,40672,145656,2.153,9.863,35829,1.897,19.725,845,911,20224
1984,5222,22979,40271,393324,374809,3658,9.114,3391,8.448,81783,28873,52910,7.703,21.820,44477,18599,25878,4.962,11.867,37306,9.953,23.733,1553,1587,6992
1984,5223,3572,4017,48984,45558,1043,27.677,546,14.489,13901,6568,7333,14.417,30.513,6956,2561,4395,5.621,15.269,6945,15.244,30.537,411,411,1720
1984,5231,6275,11933,285114,268048,2309,20.448,1027,9.095,62085,20327,41758,7.583,23.162,27820,10124,17696,3.777,10.379,34265,12.783,20.758,641,659,4279
1984,5232,127,142,6737,6724,21,15.385,10,7.326,551,146,405,2.171,8.195,521,271,250,4.031,7.749,30,0.446,15.498,8,8,266
1984,5239,14496,14893,205489,200394,3602,25.004,2627,18.236,83182,30419,52763,15.180,41.509,71413,37216,34197,18.571,35.636,11769,5.873,71.273,2120,2122,31808
1984,5241,6510,30942,1251639,1254011,2641,8.542,2590,8.377,149000,48967,100033,3.905,11.882,153359,40659,112700,3.242,12.229,-4359,-0.348,23.764,365,370,5555
1984,5242,96516,101343,736962,728975,14606,14.626,11640,11.656,198125,81210,116915,11.140,27.179,183833,114779,69054,15.745,25.218,14292,1.961,50.436,9010,9019,94713
1984,5259,691,894,8765,8408,127,14.581,81,9.300,1993,942,1051,11.204,23.705,1246,571,675,6.792,14.820,747,8.885,29.640,57,58,463
1984,5311,98030,100209,510714,500835,13986,14.028,12974,13.013,117585,53721,63864,10.726,23.478,98280,49397,48883,9.863,19.623,19305,3.855,39.246,10451,10457,36095
1984,5312,32407,33693,180944,170497,6849,21.099,4384,13.506,55717,24128,31589,14.152,32.679,34545,14693,19852,8.618,20.261,21172,12.418,40.523,3431,3437,10576
1984,5313,22408,23273,227568,214337,4842,21.753,2813,12.638,61436,24017,37419,11.205,28.663,34866,14016,20850,6.539,16.267,26570,12.396,32.534,2157,2163,10497
1984,5321,5612,9076,109120,105540,1384,15.453,1144,12.774,23378,7644,15734,7.243,22.151,16198,7051,9147,6.681,15.348,7180,6.803,30.696,678,729,4091
1984,5322,11430,14380,136131,119735,4138,31.209,1896,14.300,58841,37936,20905,31.683,49.143,24182,10622,13560,8.871,20.196,34659,28.947,40.393,1384,1399,6929
1984,5323,2872,3517,28935,25121,831,25.335,357,10.884,11556,7260,4296,28.901,46.002,3630,1204,2426,4.793,14.450,7926,31.552,28.901,262,265,830
1984,5324,5568,6781,71970,62070,1654,26.566,544,8.738,29948,19369,10579,31.205,48.249,9101,3666,5435,5.906,14.663,20847,33.587,29.325,349,350,1855
1984,5331,873,917,11195,10554,141,15.452,132,14.466,2793,1011,1782,9.580,26.465,1500,581,919,5.505,14.213,1293,12.252,28.427,103,103,440
1984,5411,121937,125614,698323,671109,15057,12.149,11697,9.438,132546,44273,88273,6.597,19.750,78249,31065,47184,4.629,11.660,54297,8.091,23.319,8605,8663,23654
1984,5412,53787,56665,440185,431851,9723,17.685,6348,11.547,82173,34237,47936,7.928,19.028,65197,31828,33369,7.370,15.097,16976,3.931,30.194,4647,4706,25425
1984,5413,50152,54908,698350,669269,9172,17.207,5965,11.190,162193,48830,113363,7.296,24.234,103866,31996,71870,4.781,15.519,58327,8.715,31.039,4220,4263,17941
1984,5414,12489,12716,88207,84046,2445,19.822,1683,13.644,23041,8263,14778,9.832,27.415,14767,5916,8851,7.039,17.570,8274,9.845,35.140,1293,1299,4616
1984,5415,8010,9072,82713,68312,4184,55.465,1127,14.940,38515,24333,14182,35.620,56.381,9863,5034,4829,7.369,14.438,28652,41.943,28.876,822,825,3135
1984,5416,32093,33247,275395,253501,9279,29.666,5342,17.079,99460,42762,56698,16.869,39.235,55078,25209,29869,9.944,21.727,44382,17.508,43.454,4112,4123,17358
1984,5417,5913,7191,406975,398479,1160,16.466,868,12.321,55935,18477,37458,4.637,14.037,39429,10059,29370,2.524,9.895,16506,4.142,19.790,558,560,2675
1984,5418,23557,25665,328849,310059,4457,17.879,2983,11.966,78802,25948,52854,8.369,25.415,41040,17338,23702,5.592,13.236,37762,12.179,26.472,2278,2283,11265
1984,5419,28627,31554,210635,204304,4415,14.379,2714,8.839,49335,18487,30848,9.049,24.148,36606,14112,22494,6.907,17.917,12729,6.230,35.835,2004,2022,7670
1984,5511,23398,43591,2851828,2797586,4347,10.098,3258,7.569,471911,136317,335594,4.873,16.869,363594,84569,279025,3.023,12.997,108317,3.872,25.993,713,731,8541
1984,5611,9229,9673,134028,124731,2103,22.403,1531,16.310,41836,18525,23311,14.852,33.541,23297,8283,15014,6.641,18.678,18539,14.863,37.356,1150,1153,6265
1984,5612,158,174,12175,9161,87,61.268,23,16.197,6187,4502,1685,49.146,67.540,361,150,211,1.637,3.941,5826,63.599,7.882,19,19,144
1984,5613,12040,15816,722521,642653,3040,19.884,1985,12.984,260083,59833,200250,9.310,40.470,99707,28715,70992,4.468,15.515,160376,24.955,31.030,1402,1418,14296
1984,5614,17346,19363,198331,191021,3160,16.652,2387,12.579,45341,14925,30416,7.813,23.736,30907,12328,18579,6.454,16.180,14434,7.556,32.360,1836,1860,8102
1984,5615,20382,23723,176283,166433,3667,16.047,1924,8.420,42949,15323,27626,9.207,25.806,23236,9203,14033,5.530,13.961,19713,11.844,27.922,1376,1410,6625
1984,5616,10761,12849,400257,384825,2277,18.157,1660,13.237,86397,24163,62234,6.279,22.451,54874,18234,36640,4.738,14.259,31523,8.192,28.519,1255,1256,12164
1984,5617,59727,62793,770452,736055,14474,24.024,9386,15.579,195071,62564,132507,8.500,26.502,125943,50112,75831,6.808,17.111,69128,9.392,34.221,7405,7419,35499
1984,5619,11079,11932,159997,151436,2136,18.388,1504,12.948,42660,12375,30285,8.172,28.170,25436,9196,16240,6.073,16.797,17224,11.374,33.593,1127,1133,5536
1984,5621,5354,5480,101517,97340,733,13.525,612,11.293,18884,3600,15284,3.698,19.400,10550,4512,6038,4.635,10.838,8334,8.562,21.677,473,475,2522
1984,5622,2056,2589,45186,43976,264,10.256,234,9.091,8972,3190,5782,7.254,20.402,6481,2698,3783,6.135,14.738,2491,5.664,29.475,167,167,1446
1984,5629,4191,4434,39464,40070,684,15.697,531,12.186,11322,4708,6614,11.750,28.256,12669,2993,9676,7.470,31.618,-1347,-3.362,56.512,404,404,2301
1984,6111,13038,13442,368931,362918,822,6.192,490,3.691,37049,6818,30231,1.879,10.209,25209,6329,18880,1.744,6.946,11840,3.262,13.892,371,371,4260
1984,6112,421,531,35874,35413,47,8.927,38,7.217,4443,1458,2985,4.117,12.546,3626,674,2952,1.903,10.239,817,2.307,20.478,26,27,346
1984,6113,2012,2352,913972,904089,101,4.320,73,3.122,75040,2306,72734,0.255,8.300,55378,1836,53542,0.203,6.125,19662,2.175,12.251,46,46,716
1984,6114,1930,2228,37081,35183,484,22.890,257,12.154,8622,3235,5387,9.195,24.506,4759,1432,3327,4.070,13.526,3863,10.980,27.053,202,202,850
1984,6115,4109,4640,48159,46953,623,13.600,505,11.024,10751,3574,7177,7.612,22.898,8373,3379,4994,7.197,17.833,2378,5.065,35.666,365,379,2807
1984,6116,11243,11767,107952,105821,2217,19.238,1731,15.021,23092,8468,14624,8.002,21.822,18698,7959,10739,7.521,17.670,4394,4.152,35.339,1373,1379,5914
1984,6117,1332,1369,12707,11899,279,21.104,185,13.994,3774,1729,2045,14.531,31.718,2091,958,1133,8.051,17.574,1683,14.145,35.147,131,131,758
1984,6211,179944,185553,1061704,1032029,14489,7.869,11641,6.322,177572,57114,120458,5.534,17.206,117483,40885,76598,3.962,11.384,60089,5.822,22.767,9184,9253,31985
1984,6212,94471,96679,440340,429591,6408,6.694,4498,4.699,70267,20797,49470,4.841,16.357,48968,14704,34264,3.423,11.399,21299,4.958,22.797,3438,3476,11447
1984,6213,41725,43537,145295,137305,6541,15.584,3412,8.129,37054,16506,20548,12.021,26.987,20877,8835,12042,6.435,15.205,16177,11.782,30.410,2465,2507,6729
1984,6214,5520,7105,111873,104310,1236,18.218,595,8.770,27346,14349,12997,13.756,26.216,12139,4772,7367,4.575,11.637,15207,14.579,23.275,392,396,2718
1984,6215,4162,5195,68914,66095,749,14.773,499,9.842,14107,5262,8845,7.961,21.344,8686,3517,5169,5.321,13.142,5421,8.202,26.284,350,389,2163
1984,6216,3886,5156,192778,177465,1208,25.383,414,8.699,53060,20898,32162,11.776,29.899,22067,6343,15724,3.574,12.435,30993,17.464,24.869,276,282,3286
1984,6219,3557,4133,78846,73483,892,23.034,371,9.580,21184,8266,12918,11.249,28.828,10553,4111,6442,5.594,14.361,10631,14.467,28.722,257,260,3034
1984,6221,3789,5018,3145793,3135496,208,4.160,173,3.460,173030,67099,105931,2.140,5.518,149960,29112,120848,0.928,4.783,23070,0.736,9.565,112,112,19231
1984,6222,394,540,129487,115192,43,8.136,20,3.784,33409,28881,4528,25.072,29.003,5916,1781,4135,1.546,5.136,27493,23.867,10.272,11,11,663
1984,6223,200,243,64246,57311,6,2.459,8,3.279,15912,11747,4165,20.497,27.765,1622,342,1280,0.597,2.830,14290,24.934,5.660,3,3,105
1984,6231,8380,12315,972127,962910,840,6.825,824,6.695,114641,44141,70500,4.584,11.906,95858,45083,50775,4.682,9.955,18783,1.951,19.910,554,569,27644
1984,6232,4105,5486,125978,119329,770,14.714,264,5.045,24885,9953,14932,8.341,20.854,11858,4517,7341,3.785,9.937,13027,10.917,19.874,169,170,2844
1984,6233,7235,8327,223165,222572,1155,14.205,763,9.384,29905,11228,18677,5.045,13.436,28898,16441,12457,7.387,12.984,1007,0.452,25.967,524,527,11421
1984,6239,2726,3352,80479,78165,369,11.336,175,5.376,11650,4092,7558,5.235,14.904,6927,1759,5168,2.250,8.862,4723,6.042,17.724,112,112,1158
1984,6241,13672,18585,256758,251303,2224,12.303,1209,6.688,44031,12660,31371,5.038,17.521,33418,8084,25334,3.217,13.298,10613,4.223,26.596,720,760,4378
1984,6242,3903,4648,45477,43343,670,15.075,263,5.917,9307,2608,6699,6.017,21.473,4986,1571,3415,3.625,11.504,4321,9.969,23.007,163,164,752
1984,6243,3816,5463,229593,229557,588,10.906,445,8.254,36882,7839,29043,3.415,16.067,36828,6925,29903,3.017,16.043,54,0.024,32.086,212,233,3409
1984,6244,29124,34192,295644,281276,5344,16.159,3101,9.377,67558,26618,40940,9.463,24.018,38478,15698,22780,5.581,13.680,29080,10.339,27.360,2420,2440,11529
1984,7111,4424,4470,59631,59642,822,18.665,690,15.668,14728,5064,9664,8.491,24.694,14679,3690,10989,6.187,24.612,49,0.082,49.224,518,519,2683
1984,7112,2047,2128,61229,60259,357,16.663,386,18.016,13568,4205,9363,6.978,22.516,12142,3576,8566,5.934,20.150,1426,2.366,40.299,277,278,1603
1984,7113,1940,1974,31579,29838,379,19.361,346,17.676,10231,3634,6597,12.179,34.289,6719,2971,3748,9.957,22.519,3512,11.770,45.037,263,264,2257
1984,7114,1101,1118,11748,11438,221,20.220,171,15.645,3555,1181,2374,10.326,31.082,2936,1480,1456,12.940,25.670,619,5.412,51.340,116,116,1020
1984,7115,8747,8775,72812,65468,3088,38.308,1660,20.593,25655,11217,14438,17.134,39.187,10810,5331,5479,8.143,16.512,14845,22.675,33.024,1229,1229,3853
1984,7121,2134,2286,36157,35462,237,10.649,116,5.212,4228,737,3491,2.078,11.923,2810,563,2247,1.588,7.924,1418,3.999,15.848,88,88,381
1984,7131,1894,2365,57625,58611,380,14.879,758,29.679,5795,2181,3614,3.721,9.887,7802,3013,4789,5.141,13.311,-2007,-3.424,19.774,652,655,2569
1984,7132,732,753,18534,17506,116,15.085,148,19.246,4169,980,3189,5.598,23.815,2184,813,1371,4.644,12.476,1985,11.339,24.952,117,117,557
1984,7139,31426,33362,470405,459174,4554,13.774,3956,11.965,93373,34859,58514,7.592,20.335,70807,25346,45461,5.520,15.421,22566,4.914,30.841,3052,3081,18818
1984,7211,29097,33471,1139668,1101520,4621,13.896,4185,12.585,225013,104470,120543,9.484,20.428,149061,65558,83503,5.952,13.532,75952,6.895,27.065,3068,3100,42019
1984,7212,3632,3888,21627,20890,559,14.554,465,12.106,6054,2183,3871,10.450,28.980,4596,1817,2779,8.698,22.001,1458,6.979,44.002,322,324,1217
1984,7213,4648,4759,22660,22826,310,6.457,394,8.207,3622,1126,2496,4.933,15.868,4000,1243,2757,5.446,17.524,-378,-1.656,31.736,279,279,965
1984,7223,12780,16218,285039,279475,2896,18.077,2501,15.611,67348,32429,34919,11.604,24.098,56510,26858,29652,9.610,20.220,10838,3.878,40.440,1860,1866,15272
1984,7224,57492,58274,323631,323918,8789,14.844,10663,18.008,88402,45632,42770,14.088,27.291,88770,47095,41675,14.539,27.405,-368,-0.114,54.583,8591,8614,38071
1984,7225,197094,259246,4596489,4442870,44009,17.241,36028,14.114,1084979,572682,512297,12.890,24.421,778623,375890,402733,8.461,17.525,306356,6.895,35.050,26392,26965,234821
1984,8111,97322,101689,485796,459500,17656,17.822,12410,12.527,128144,55484,72660,12.075,27.888,75397,35990,39407,7.832,16.409,52747,11.479,32.817,9618,9672,28466
1984,8112,9710,10947,74229,69746,1687,15.705,1276,11.879,19244,10342,8902,14.828,27.592,10334,3958,6376,5.675,14.817,8910,12.775,29.633,970,972,2577
1984,8113,18566,19616,142954,137634,2813,14.579,2172,11.257,32037,10072,21965,7.318,23.277,21416,8072,13344,5.865,15.560,10621,7.717,31.120,1672,1677,6008
1984,8114,22186,23775,139241,134626,4032,17.287,3131,13.424,31556,12337,19219,9.164,23.440,22212,10135,12077,7.528,16.499,9344,6.941,32.998,2359,2372,6191
1984,8121,80331,89199,444875,436134,12384,13.942,11640,13.104,101573,46394,55179,10.638,23.289,83360,39870,43490,9.142,19.113,18213,4.176,38.227,9261,9431,30195
1984,8122,17423,20098,115682,114167,1520,7.625,1191,5.975,17144,5494,11650,4.812,15.017,14089,4502,9587,3.943,12.341,3055,2.676,24.681,809,833,3222
1984,8123,32690,38536,340896,335201,4671,12.144,4524,11.762,57995,23017,34978,6.867,17.302,46786,19876,26910,5.930,13.958,11209,3.344,27.915,3468,3598,15091
1984,8129,13302,20206,206571,204008,3853,19.570,2817,14.308,45775,19038,26737,9.332,22.438,40732,17442,23290,8.550,19.966,5043,2.472,39.932,1563,1641,8992
1984,8131,114846,114954,897001,823645,38496,39.574,3142,3.230,215678,109975,105703,13.352,26.186,69165,10147,59018,1.232,8.397,146513,17.788,16.795,2011,2011,5796
1984,8132,7361,8378,115567,112193,985,12.121,482,5.931,21563,5206,16357,4.640,19.220,14949,3737,11212,3.331,13.324,6614,5.895,26.649,320,322,2417
1984,8133,6833,8024,87030,85219,910,11.532,644,8.161,16726,4102,12624,4.813,19.627,12982,3205,9777,3.761,15.234,3744,4.393,30.467,391,393,1990
1984,8134,28947,30282,253505,250636,2263,7.545,1685,5.618,37789,8563,29226,3.417,15.077,32157,5953,26204,2.375,12.830,5632,2.247,25.660,1192,1192,3641
1984,8139,55819,58051,451196,445726,4978,8.637,4141,7.185,77491,19982,57509,4.483,17.385,66749,17054,49695,3.826,14.975,10742,2.410,29.951,2960,2966,11814
1985,1131,209,216,2165,2069,35,15.945,42,19.134,487,149,338,7.202,23.538,312,130,182,6.283,15.080,175,8.458,30.159,36,36,114
1985,1132,78,93,1289,1275,13,14.054,12,12.973,214,54,160,4.235,16.784,187,76,111,5.961,14.667,27,2.118,29.333,10,10,71
1985,1133,10758,10855,88939,89496,1671,15.484,1544,14.308,19894,7220,12674,8.067,22.229,21022,6979,14043,7.798,23.489,-1128,-1.260,44.458,1117,1117,4707
1985,1141,1185,1200,7433,8061,185,14.974,256,20.720,2162,916,1246,11.363,26.820,3482,964,2518,11.959,43.196,-1320,-16.375,53.641,190,190,695
1985,1142,133,133,546,540,28,21.538,22,16.923,152,94,58,17.424,28.174,135,54,81,10.009,25.023,17,3.151,50.046,20,20,45
1985,1151,3956,4330,54682,53155,547,12.489,647,14.772,17030,4995,12035,9.397,32.038,13745,4620,9125,8.692,25.858,3285,6.180,51.717,429,433,3014
1985,1152,1827,1848,13218,13181,347,19.087,287,15.787,2909,1210,1699,9.180,22.070,2846,1347,1499,10.219,21.592,63,0.478,43.183,218,218,959
1985,1153,777,790,8953,9512,168,21.832,127,16.504,2204,954,1250,10.030,23.172,3339,842,2497,8.852,35.105,-1135,-11.933,46.344,91,91,683
1985,2111,8044,9946,163395,163710,1264,12.695,1286,12.916,30569,9910,20659,6.053,18.673,31192,13080,18112,7.990,19.053,-623,-0.381,37.345,860,874,5099
1985,2121,2636,3310,172395,178118,541,16.006,681,20.148,23714,8598,15116,4.827,13.314,35259,11948,23311,6.708,19.795,-11545,-6.482,26.627,500,504,7293
1985,2122,482,636,39291,42752,100,14.959,165,24.682,4792,1544,3248,3.612,11.209,11705,3243,8462,7.586,27.379,-6913,-16.170,22.418,111,111,1330
1985,2123,3540,5018,103463,101352,430,8.577,421,8.397,17393,5822,11571,5.744,17.161,13235,4175,9060,4.119,13.059,4158,4.103,26.117,292,294,2135
1985,2131,10920,12595,283508,283954,1930,15.271,2016,15.952,63274,16713,46561,5.886,22.283,64233,25334,38899,8.922,22.621,-959,-0.338,44.566,1520,1522,14157
1985,2211,1610,5776,593432,589760,159,2.750,172,2.974,30310,3587,26723,0.608,5.139,23018,4570,18448,0.775,3.903,7292,1.236,7.806,58,58,1040
1985,2212,549,2431,141276,140815,132,5.451,113,4.667,10172,4120,6052,2.926,7.224,9189,2621,6568,1.861,6.526,983,0.698,13.051,35,35,250
1985,2213,3707,4003,29879,29553,348,8.733,312,7.829,3807,1261,2546,4.267,12.882,3202,1138,2064,3.851,10.835,605,2.047,21.670,224,224,643
1985,2361,95359,95706,580051,561655,21588,23.113,16982,18.181,206516,82298,124218,14.653,36.769,169653,71443,98210,12.720,30.206,36863,6.563,60.412,12031,12032,52909
1985,2362,35035,35666,636256,600340,5830,16.640,4571,13.046,203612,47811,155801,7.964,33.916,131570,38145,93425,6.354,21.916,72042,12.000,43.832,3366,3371,27265
1985,2371,13038,13371,329433,322211,1683,12.647,1556,11.693,98116,40878,57238,12.687,30.451,83614,20718,62896,6.430,25.950,14502,4.501,51.900,1181,1185,16743
1985,2372,9007,9154,85467,77103,2640,30.431,1683,19.399,35875,17019,18856,22.073,46.529,18914,8313,10601,10.782,24.531,16961,21.998,49.062,1329,1329,6434
1985,2373,10074,10363,214664,209986,1285,12.560,1020,9.970,52729,10570,42159,5.034,25.111,43289,10746,32543,5.117,20.615,9440,4.496,41.230,755,759,7454
1985,2379,4619,4718,93768,94688,882,19.000,730,15.726,29869,11809,18060,12.472,31.545,31769,4437,27332,4.686,33.551,-1900,-2.007,63.090,502,502,2493
1985,2381,67697,68079,658774,627455,12410,18.652,9321,14.009,217109,63996,153113,10.199,34.602,154189,54634,99555,8.707,24.574,62920,10.028,49.147,6909,6912,43126
1985,2382,104825,106753,1115467,1076849,16884,16.218,11597,11.139,289976,75302,214674,6.993,26.928,213565,72179,141386,6.703,19.832,76411,7.096,39.665,8924,8930,53311
1985,2383,68585,69011,589188,561635,14192,21.119,10572,15.732,195284,61248,134036,10.905,34.771,140020,48526,91494,8.640,24.931,55264,9.840,49.862,7916,7918,38210
1985,2389,36505,36775,350908,348820,6599,18.425,4678,13.062,104624,30254,74370,8.673,29.994,101566,27286,74280,7.822,29.117,3058,0.877,58.234,3480,3482,18488
1985,3111,1297,1918,50261,51498,120,6.211,148,7.660,4904,1458,3446,2.831,9.523,7317,2836,4481,5.507,14.208,-2413,-4.686,19.046,96,97,900
1985,3112,516,863,67971,68490,46,5.266,67,7.670,6100,2338,3762,3.414,8.906,7284,2037,5247,2.974,10.635,-1184,-1.729,17.813,36,36,233
1985,3113,1492,1790,82947,85061,232,12.928,241,13.430,8501,2504,5997,2.944,9.994,12770,4644,8126,5.460,15.013,-4269,-5.019,19.988,117,175,1692
1985,3114,1212,1670,179905,178090,91,5.386,130,7.695,23539,1832,21707,1.029,13.218,19677,4820,14857,2.707,11.049,3862,2.169,22.098,80,80,1405
1985,3115,1747,2425,133615,133566,130,5.270,214,8.675,13431,2543,10888,1.904,10.056,13385,4884,8501,3.657,10.021,46,0.034,20.043,136,137,1962
1985,3116,4178,4751,328237,327626,360,7.495,465,9.680,39249,6978,32271,2.130,11.980,37829,15113,22716,4.613,11.546,1420,0.433,23.093,340,342,8559
1985,3117,728,834,40471,42831,60,7.034,98,11.489,6868,1092,5776,2.550,16.035,11688,6432,5256,15.017,27.289,-4820,-11.254,32.071,58,58,1662
1985,3118,8731,10243,304575,303055,1382,13.507,1360,13.292,40737,11044,29693,3.644,13.442,37927,16005,21922,5.281,12.515,2810,0.927,25.030,1034,1058,9883
1985,3119,2086,2445,123873,124329,239,9.799,227,9.307,13570,2713,10857,2.182,10.915,14520,6639,7881,5.340,11.679,-950,-0.764,21.829,158,158,2769
1985,3121,1953,2484,166677,169041,145,5.792,184,7.350,12415,2400,10015,1.420,7.344,17179,4930,12249,2.916,10.163,-4764,-2.818,14.689,127,128,2157
1985,3122,111,159,41182,41190,16,10.159,13,8.254,2943,617,2326,1.498,7.145,2807,188,2619,0.456,6.815,136,0.330,13.630,7,7,69
1985,3131,448,657,98932,103569,29,4.341,51,7.635,5470,1572,3898,1.518,5.282,14585,3219,11366,3.108,14.082,-9115,-8.801,10.563,33,33,1146
1985,3132,1667,2036,268283,283852,139,6.728,199,9.632,16708,5482,11226,1.931,5.886,47859,13980,33879,4.925,16.861,-31151,-10.974,11.772,137,139,2130
1985,3133,4679,5227,136315,138623,534,10.537,216,4.262,14912,4165,10747,3.005,10.757,19404,5880,13524,4.242,13.998,-4492,-3.240,21.514,132,132,2160
1985,3141,3910,4204,123834,123637,488,11.601,493,11.720,16545,4596,11949,3.717,13.382,16217,4964,11253,4.015,13.117,328,0.265,26.233,371,373,2744
1985,3149,3659,3777,120866,124572,511,13.610,466,12.412,17103,6169,10934,4.952,13.729,24477,9545,14932,7.662,19.649,-7374,-5.919,27.459,384,386,7255
1985,3151,1362,1481,141708,146464,136,9.128,154,10.336,14284,4109,10175,2.805,9.753,23617,10286,13331,7.023,16.125,-9333,-6.372,19.505,121,122,4607
1985,3152,11963,13496,840433,879108,1797,13.197,2039,14.974,106894,37243,69651,4.236,12.159,183015,70130,112885,7.977,20.818,-76121,-8.659,24.319,1695,1712,43626
1985,3159,1758,1845,59766,60399,274,15.030,230,12.617,9886,4139,5747,6.853,16.368,11137,3412,7725,5.649,18.439,-1251,-2.071,32.736,195,196,2654
1985,3161,341,372,15812,16947,31,8.223,41,10.875,1438,269,1169,1.587,8.485,3763,1426,2337,8.414,22.205,-2325,-13.719,16.971,35,35,1021
1985,3162,451,632,102706,111221,31,4.630,106,15.833,9338,3196,6142,2.874,8.396,26492,9855,16637,8.861,23.819,-17154,-15.423,16.792,58,60,2931
1985,3169,1246,1294,44735,47346,134,10.300,148,11.376,5812,1769,4043,3.736,12.276,11046,2805,8241,5.925,23.331,-5234,-11.055,24.551,112,112,1605
1985,3211,4842,5331,135867,138503,505,9.367,625,11.593,17087,5223,11864,3.771,12.337,22488,6747,15741,4.871,16.237,-5401,-3.900,24.674,475,476,4103
1985,3212,1137,1378,85134,86305,149,10.972,109,8.027,9150,2801,6349,3.245,10.602,11406,4373,7033,5.067,13.216,-2256,-2.614,21.204,71,71,1699
1985,3219,8857,9586,278188,279540,1194,12.553,1046,10.997,43514,12590,30924,4.504,15.566,46148,18901,27247,6.761,16.509,-2634,-0.942,31.133,786,792,11421
1985,3221,236,552,194516,196382,17,3.028,36,6.411,11333,5165,6168,2.630,5.771,14784,8355,6429,4.254,7.528,-3451,-1.757,11.542,16,16,2054
1985,3222,3611,5165,399045,399781,289,5.579,319,6.158,35512,6494,29018,1.624,8.883,37292,12659,24633,3.166,9.328,-1780,-0.445,17.766,200,200,4649
1985,3231,37105,38720,747825,734321,4513,11.840,3308,8.678,107729,27504,80225,3.746,14.671,80254,34281,45973,4.668,10.929,27475,3.742,21.858,2618,2629,21921
1985,3241,1358,2206,130166,133589,182,8.258,178,8.076,10667,4122,6545,3.086,7.985,17499,8077,9422,6.046,13.099,-6832,-5.114,15.970,102,103,2916
1985,3251,1143,2258,238805,242842,179,7.931,177,7.842,19140,8160,10980,3.360,7.882,26867,16081,10786,6.622,11.064,-7727,-3.182,15.763,79,81,1584
1985,3252,374,616,135457,137192,54,8.838,44,7.201,7254,3753,3501,2.736,5.287,10830,3979,6851,2.900,7.894,-3576,-2.607,10.575,23,23,378
1985,3253,673,1013,46952,47025,72,7.007,101,9.830,4565,1501,3064,3.192,9.708,4696,1655,3041,3.519,9.986,-131,-0.279,19.415,57,57,570
1985,3254,1018,1248,160470,160922,115,9.185,123,9.824,13521,2367,11154,1.471,8.402,14372,3126,11246,1.943,8.931,-851,-0.529,16.804,79,79,1596
1985,3255,1665,2132,74157,73953,156,7.326,151,7.091,8608,2226,6382,3.010,11.640,8354,4148,4206,5.609,11.296,254,0.343,22.593,98,102,1695
1985,3256,2098,2338,121579,122001,205,8.806,185,7.947,12649,3010,9639,2.467,10.368,13435,5215,8220,4.275,11.012,-786,-0.644,20.736,127,127,1094
1985,3259,1788,2334,128717,129118,222,9.588,185,7.990,11097,3470,7627,2.687,8.594,11771,4018,7753,3.112,9.117,-674,-0.522,17.189,121,121,1519
1985,3261,10394,12029,582575,575675,1132,9.497,912,7.652,85069,20901,64168,3.631,14.777,70783,26995,43788,4.689,12.296,14286,2.482,24.591,652,660,13243
1985,3262,1996,2352,186943,185617,228,9.773,190,8.144,17431,2745,14686,1.479,9.391,14852,4017,10835,2.164,8.001,2579,1.389,16.003,137,137,1737
1985,3271,1320,1598,77869,79357,190,11.890,190,11.890,8275,2120,6155,2.671,10.428,11277,3706,7571,4.670,14.211,-3002,-3.783,20.855,140,140,1689
1985,3272,1562,1822,145112,149230,215,11.921,178,9.870,11087,3070,8017,2.057,7.429,19318,6586,12732,4.413,12.945,-8231,-5.516,14.859,128,128,913
1985,3273,6894,8940,184402,180861,666,7.424,729,8.126,33433,7502,25931,4.148,18.486,26473,9146,17327,5.057,14.637,6960,3.848,29.274,495,501,6138
1985,3274,231,325,17121,16908,29,8.801,38,11.533,1476,185,1291,1.094,8.730,1026,440,586,2.602,6.068,450,2.662,12.137,30,30,208
1985,3279,1885,2182,82919,82688,204,9.394,183,8.427,8904,2437,6467,2.947,10.768,8410,1954,6456,2.363,10.171,494,0.597,20.342,134,134,1214
1985,3311,348,423,219625,231543,47,11.217,39,9.308,10472,5306,5166,2.292,4.523,34332,9215,25117,3.980,14.827,-23860,-10.305,9.045,24,24,326
1985,3312,495,666,66776,68544,43,6.389,57,8.470,4985,1849,3136,2.698,7.273,8559,2950,5609,4.304,12.487,-3574,-5.214,14.545,28,28,790
1985,3313,304,462,88585,90326,32,6.949,29,6.298,5463,1931,3532,2.138,6.048,9008,3516,5492,3.893,9.973,-3545,-3.925,12.096,13,13,314
1985,3314,765,945,96419,97573,77,8.033,104,10.850,9339,2262,7077,2.318,9.571,11785,5025,6760,5.150,12.078,-2446,-2.507,19.143,73,73,1688
1985,3315,2775,3072,220928,223166,169,5.446,231,7.444,21472,4051,17421,1.815,9.622,25893,10613,15280,4.756,11.603,-4421,-1.981,19.243,143,143,3487
1985,3321,3173,3392,149403,149778,196,5.775,200,5.893,15628,2205,13423,1.472,10.434,16416,5369,11047,3.585,10.960,-788,-0.526,20.868,140,140,2981
1985,3322,1223,1340,79554,80381,116,8.641,121,9.013,6870,1598,5272,1.988,8.547,8471,3032,5439,3.772,10.539,-1601,-1.992,17.094,82,83,1128
1985,3323,9924,10732,332288,328966,890,8.273,942,8.756,53971,10436,43535,3.172,16.406,47191,17636,29555,5.361,14.345,6780,2.061,28.691,694,709,10065
1985,3324,1463,1815,127325,127396,123,6.816,102,5.653,10824,1514,9310,1.188,8.496,10878,2910,7968,2.284,8.539,-54,-0.042,16.993,61,61,951
1985,3325,947,1023,74263,75860,82,8.027,79,7.734,4755,643,4112,0.848,6.268,7974,2520,5454,3.322,10.512,-3219,-4.243,12.536,58,58,1115
1985,3326,1728,1935,68741,68790,217,11.445,139,7.331,8652,2219,6433,3.226,12.578,8708,3618,5090,5.260,12.659,-56,-0.081,25.155,100,100,2331
1985,3327,21614,21921,347764,338223,2316,10.713,1711,7.915,60283,12112,48171,3.581,17.823,41500,17146,24354,5.069,12.270,18783,5.553,24.540,1370,1371,11309
1985,3328,5517,5835,135568,132807,466,8.032,399,6.878,21470,5571,15899,4.195,16.166,15946,5860,10086,4.412,12.007,5524,4.159,24.014,312,313,3735
1985,3329,5579,6095,357477,354338,833,14.033,515,8.676,43030,9995,33035,2.821,12.144,36856,13828,23028,3.902,10.401,6174,1.742,20.803,357,357,5036
1985,3331,3039,3402,235966,241796,290,8.417,377,10.942,25091,5361,19730,2.217,10.377,36693,11373,25320,4.704,15.175,-11602,-4.798,20.754,247,247,3296
1985,3332,3760,4020,173114,171344,341,8.513,312,7.789,23459,5688,17771,3.320,13.691,19834,7243,12591,4.227,11.576,3625,2.116,23.151,222,223,3104
1985,3333,2062,2182,162094,163455,194,8.893,193,8.847,18281,3591,14690,2.197,11.184,21001,10654,10347,6.518,12.848,-2720,-1.664,22.368,125,126,2107
1985,3334,1743,1957,165425,166178,156,7.873,205,10.346,20467,3476,16991,2.092,12.316,21847,8801,13046,5.296,13.147,-1380,-0.830,24.633,144,144,3522
1985,3335,9596,9991,243045,236357,736,7.400,645,6.485,37284,6506,30778,2.753,15.774,23951,9821,14130,4.155,10.133,13333,5.641,20.267,494,494,4923
1985,3336,735,896,145258,147623,51,5.689,52,5.800,11050,3020,8030,2.046,7.485,16074,5041,11033,3.415,10.889,-5024,-3.403,14.971,29,29,535
1985,3339,5861,6419,323089,320525,473,7.342,519,8.057,41425,10837,30588,3.381,12.924,36404,15018,21386,4.685,11.358,5021,1.566,22.715,346,348,5764
1985,3341,1650,1844,361208,357961,279,15.271,245,13.410,53971,9169,44802,2.561,15.077,46976,12540,34436,3.503,13.123,6995,1.954,26.246,175,176,4407
1985,3342,1876,2094,300713,296955,217,10.443,185,8.903,47316,7717,39599,2.599,15.934,40362,15230,25132,5.129,13.592,6954,2.342,27.184,126,129,4984
1985,3343,378,404,46009,47152,41,9.927,59,14.286,4443,906,3537,1.921,9.423,6513,1772,4741,3.758,13.813,-2070,-4.390,18.846,45,45,1006
1985,3344,4546,5141,542946,537557,760,15.191,484,9.674,79943,21270,58673,3.957,14.872,69130,22233,46897,4.136,12.860,10813,2.012,25.720,347,347,7452
1985,3345,4195,4773,687171,672789,531,11.332,357,7.618,84370,18988,65382,2.822,12.540,55551,21733,33818,3.230,8.257,28819,4.284,16.514,214,216,4599
1985,3346,636,661,18898,19018,112,17.125,98,14.985,3367,1383,1984,7.272,17.705,3633,1054,2579,5.542,19.103,-266,-1.399,35.409,77,77,677
1985,3351,1191,1319,85318,84487,119,9.060,108,8.222,10790,2046,8744,2.422,12.771,9051,3001,6050,3.552,10.713,1739,2.058,21.426,80,81,1557
1985,3352,340,438,116523,121339,35,7.964,38,8.646,6461,1124,5337,0.926,5.325,15924,3032,12892,2.499,13.124,-9463,-7.799,10.650,23,23,232
1985,3353,1996,2473,244829,247974,185,7.493,177,7.169,25585,6461,19124,2.606,10.318,31560,10109,21451,4.077,12.727,-5975,-2.410,20.635,108,109,2339
1985,3359,2097,2489,227281,227089,282,11.529,196,8.013,25355,5421,19934,2.387,11.165,24813,7174,17639,3.159,10.927,542,0.239,21.853,120,121,2178
1985,3361,200,256,280292,270997,45,17.928,35,13.944,62912,37497,25415,13.837,23.215,42699,35231,7468,13.001,15.756,20213,7.459,31.513,22,22,145
1985,3362,1785,1973,119461,118554,252,12.990,186,9.588,21388,8817,12571,7.437,18.041,19825,5249,14576,4.428,16.722,1563,1.318,33.445,139,139,3057
1985,3363,3734,4445,654520,651454,445,10.102,365,8.286,60321,11981,48340,1.839,9.259,54968,15394,39574,2.363,8.438,5353,0.822,16.875,253,258,5969
1985,3364,1262,1518,716298,692911,147,9.807,109,7.272,83699,22385,61314,3.231,12.079,36712,19980,16732,2.883,5.298,46987,6.781,10.596,74,74,1710
1985,3365,162,186,29340,29146,8,4.178,19,9.922,2377,237,2140,0.813,8.156,1995,575,1420,1.973,6.845,382,1.311,13.690,7,8,144
1985,3366,1135,1222,161728,162518,152,12.428,154,12.592,18307,2457,15850,1.512,11.265,19826,4236,15590,2.606,12.199,-1519,-0.935,22.529,111,112,1745
1985,3369,461,471,38709,38855,73,15.615,66,14.118,4714,628,4086,1.616,12.132,5191,1887,3304,4.857,13.360,-477,-1.228,24.265,50,50,659
1985,3371,12709,13377,384226,381502,1998,15.216,1506,11.469,56202,16095,40107,4.219,14.732,51151,19990,31161,5.240,13.408,5051,1.324,26.816,1208,1215,13115
1985,3372,2644,2783,144232,139865,359,13.213,227,8.355,22844,4270,18574,3.053,16.333,14092,4863,9229,3.477,10.075,8752,6.257,20.151,178,179,3122
1985,3379,1079,1214,41331,41236,121,10.037,104,8.627,5843,1922,3921,4.661,14.170,5680,2211,3469,5.362,13.774,163,0.395,27.549,86,87,1567
1985,3391,9969,10453,222394,223194,1226,11.766,1160,11.132,25270,6054,19216,2.712,11.322,26700,9841,16859,4.409,11.963,-1430,-0.641,22.644,886,892,6383
1985,3399,14903,15471,403772,410401,1964,12.774,1772,11.525,57757,16441,41316,4.006,14.073,71095,27034,44061,6.587,17.323,-13338,-3.250,28.147,1385,1391,14295
1985,4231,18774,22019,257508,254531,2274,10.274,2503,11.309,42213,11883,30330,4.669,16.585,36144,16640,19504,6.538,14.200,6069,2.384,28.400,1830,1853,11076
1985,4232,7412,8401,97004,95360,1138,13.666,991,11.900,18242,4833,13409,5.068,19.130,15091,7197,7894,7.547,15.825,3151,3.304,31.651,755,762,4873
1985,4233,7416,9085,116141,114918,1148,12.727,1019,11.296,21318,6147,15171,5.349,18.551,18860,8556,10304,7.445,16.412,2458,2.139,32.824,772,779,6148
1985,4234,22785,30973,550365,528934,4701,15.431,3686,12.099,121934,43835,78099,8.287,23.053,79914,41098,38816,7.770,15.109,42020,7.944,30.217,2386,2447,16076
1985,4235,6578,8834,132353,129960,942,10.677,920,10.427,21911,6330,15581,4.871,16.860,17140,7723,9417,5.943,13.189,4771,3.671,26.377,546,560,4196
1985,4236,14760,20948,301762,295357,2747,13.240,2348,11.316,64958,23744,41214,8.039,21.993,52413,24283,28130,8.222,17.746,12545,4.247,35.491,1465,1517,12448
1985,4237,10496,13628,149967,147870,1286,9.480,1161,8.558,23231,6044,17187,4.087,15.710,18940,8909,10031,6.025,12.809,4291,2.902,25.617,820,840,6039
1985,4238,46010,59821,640260,635185,5462,9.126,5516,9.217,100113,28593,71520,4.502,15.761,89798,35361,54437,5.567,14.137,10315,1.624,28.275,3689,3788,22094
1985,4239,23059,24599,227208,224613,4008,16.545,3259,13.453,46453,15797,30656,7.033,20.681,41254,18244,23010,8.122,18.367,5199,2.315,36.733,2537,2560,13435
1985,4241,7956,10603,155899,150715,1078,10.274,856,8.159,27800,10085,17715,6.691,18.445,17273,6420,10853,4.260,11.461,10527,6.985,22.921,609,615,4328
1985,4242,2729,3482,94980,96062,468,13.505,435,12.552,13215,3640,9575,3.789,13.757,15527,6176,9351,6.429,16.164,-2312,-2.407,27.514,318,319,4112
1985,4243,8416,9050,103028,102899,1589,17.413,1740,19.067,24900,9805,15095,9.529,24.199,24741,10982,13759,10.673,24.044,159,0.155,48.088,1394,1410,7811
1985,4244,27118,33178,610433,607991,3685,11.079,3851,11.578,100119,27625,72494,4.544,16.467,94816,40930,53886,6.732,15.595,5303,0.872,31.190,2884,2940,24569
1985,4245,7809,10753,93986,95930,625,5.697,1059,9.654,12951,4080,8871,4.253,13.500,16896,6672,10224,6.955,17.613,-3945,-4.112,27.001,700,749,4648
1985,4246,7049,10376,119720,119549,1091,10.606,912,8.866,21066,5270,15796,4.408,17.621,20389,5675,14714,4.747,17.055,677,0.566,34.110,552,567,2973
1985,4247,10861,14052,147108,147187,845,5.881,1477,10.280,24959,6218,18741,4.225,16.957,25199,11916,13283,8.096,17.120,-240,-0.163,33.915,963,989,7122
1985,4248,4478,5567,139017,139957,320,5.681,451,8.007,13431,2958,10473,2.114,9.597,15321,4869,10452,3.479,10.947,-1890,-1.350,19.193,328,334,3233
1985,4249,18441,21929,231713,228444,3000,13.721,2869,13.122,42823,13171,29652,5.766,18.746,36621,16609,20012,7.270,16.031,6202,2.715,32.061,2079,2110,11536
1985,4251,28972,31625,302492,297644,3791,12.124,3077,9.841,55815,18294,37521,6.146,18.752,46221,18132,28089,6.092,15.529,9594,3.223,31.058,2106,2118,11025
1985,4411,37582,38679,883751,860636,4232,10.968,4042,10.476,136279,40513,95766,4.707,15.835,89862,40959,48903,4.759,10.441,46417,5.393,20.883,3271,3292,32282
1985,4412,11185,11624,82289,80623,1422,12.293,1310,11.324,17898,6484,11414,8.042,22.200,14600,6108,8492,7.576,18.109,3298,4.091,36.218,1059,1077,5126
1985,4413,44648,60922,448456,452711,6142,9.948,7784,12.607,76954,29171,47783,6.444,16.999,84105,47880,36225,10.576,18.578,-7151,-1.580,33.997,3929,4101,19429
1985,4421,21876,26584,218105,215030,3122,11.748,3103,11.677,40732,14192,26540,6.600,18.942,34636,16851,17785,7.837,16.108,6096,2.835,32.215,2323,2430,12264
1985,4422,20858,25110,149759,146290,3852,15.533,3231,13.028,33966,14766,19200,10.094,23.218,27000,12625,14375,8.630,18.457,6966,4.762,36.913,2460,2544,9671
1985,4431,29941,42485,276820,263335,6300,14.937,5687,13.483,73761,30801,42960,11.697,28.010,47031,24500,22531,9.304,17.860,26730,10.151,35.720,3822,4033,17042
1985,4441,56898,72878,734276,718678,6592,9.060,6359,8.740,123292,41735,81557,5.807,17.155,92405,37511,54894,5.219,12.858,30887,4.298,25.715,4776,4888,24779
1985,4442,16589,20157,150740,148380,2178,10.827,2097,10.424,27740,8487,19253,5.720,18.695,23090,9648,13442,6.502,15.561,4650,3.134,31.123,1531,1548,6835
1985,4451,63052,95335,1943805,1899598,11196,11.670,12401,12.926,332170,146207,185963,7.697,17.486,243713,117535,126178,6.187,12.830,88457,4.657,25.659,8646,8857,53513
1985,4452,22694,27286,178199,178785,3969,14.298,4917,17.713,41143,17329,23814,9.693,23.013,42333,21733,20600,12.156,23.678,-1190,-0.666,46.025,3552,3913,16515
1985,4453,28447,33707,169219,168755,3677,10.811,4285,12.599,33136,13266,19870,7.861,19.636,32042,14081,17961,8.344,18.987,1094,0.648,37.975,3337,3413,10821
1985,4461,47882,69390,635912,623017,7031,10.196,6168,8.945,107506,41352,66154,6.637,17.256,81188,35397,45791,5.682,13.031,26318,4.224,26.063,4309,4430,23767
1985,4471,94149,136225,907337,892944,14857,10.774,18207,13.203,198041,80331,117710,8.996,22.178,168830,85517,83313,9.577,18.907,29211,3.271,37.814,12359,12768,54169
1985,4481,55365,95952,837951,809553,11441,11.867,12357,12.817,191808,73604,118204,9.092,23.693,135681,60363,75318,7.456,16.760,56127,6.933,33.520,8401,8910,38961
1985,4482,12019,36448,196320,195894,4097,11.298,3725,10.272,40339,19681,20658,10.047,20.592,39948,13854,26094,7.072,20.393,391,0.200,40.785,1820,1989,7455
1985,4483,18319,25928,151378,149756,3102,12.008,2912,11.272,28736,11917,16819,7.958,19.189,25424,11090,14334,7.405,16.977,3312,2.212,33.954,1901,2267,8304
1985,4511,31777,40766,269210,269106,5902,14.106,8053,19.246,59253,25994,33259,9.659,22.019,57556,32765,24791,12.176,21.388,1697,0.631,42.776,4611,4798,15683
1985,4512,7878,11752,80377,78797,1501,12.747,1548,13.146,16417,5828,10589,7.396,20.835,13493,6098,7395,7.739,17.124,2924,3.711,34.247,1019,1086,3664
1985,4522,421,6791,1129001,1110598,241,3.556,212,3.128,94159,29284,64875,2.637,8.478,58985,12539,46446,1.129,5.311,35174,3.167,10.622,31,35,1527
1985,4523,14026,28801,820591,804882,2868,9.890,3266,11.262,111064,43465,67599,5.400,13.799,80736,36138,44598,4.490,10.031,30328,3.768,20.062,1918,1959,10406
1985,4531,22356,23696,119699,115613,3532,15.064,3034,12.940,28574,10666,17908,9.226,24.715,20378,9582,10796,8.288,17.626,8196,7.089,35.252,2429,2458,7698
1985,4532,26754,32748,219534,211890,5556,17.258,4449,13.819,51478,22394,29084,10.569,24.295,36073,17229,18844,8.131,17.024,15405,7.270,34.049,3389,3483,12303
1985,4533,8746,10268,49263,47631,1582,15.335,1679,16.275,12063,5223,6840,10.966,25.326,8889,4717,4172,9.903,18.662,3174,6.664,37.324,1343,1355,3681
1985,4539,24791,29907,141889,139576,4698,15.691,4767,15.921,36606,16597,20009,11.891,26.227,32151,15938,16213,11.419,23.035,4455,3.192,46.070,3461,3530,11705
1985,4541,5951,7497,98115,97160,1020,13.588,1039,13.841,18428,6770,11658,6.968,18.967,16864,9301,7563,9.573,17.357,1564,1.610,34.714,794,798,4028
1985,4542,3975,5106,78995,79135,502,9.575,776,14.801,13354,3125,10229,3.949,16.875,13537,7132,6405,9.013,17.106,-183,-0.231,33.750,458,502,3395
1985,4543,17076,22923,214320,209746,2203,9.591,2298,10.004,42718,12220,30498,5.826,20.367,33546,13938,19608,6.645,15.994,9172,4.373,31.987,1698,1722,9181
1985,4811,1041,2867,328274,313780,329,11.572,281,9.884,51086,4619,46467,1.472,16.281,22290,4749,17541,1.513,7.104,28796,9.177,14.207,157,157,3281
1985,4812,444,710,22638,20173,163,23.935,105,15.419,5918,1130,4788,5.602,29.337,917,374,543,1.854,4.546,5001,24.791,9.092,90,90,335
1985,4831,369,615,32531,32468,67,10.984,57,9.344,5516,1193,4323,3.674,16.989,5483,988,4495,3.043,16.887,33,0.102,33.775,37,37,711
1985,4832,371,437,15891,15848,53,12.226,46,10.611,2531,694,1837,4.379,15.970,2463,354,2109,2.234,15.541,68,0.429,31.083,36,36,294
1985,4841,23533,29098,555930,544096,5184,17.975,4667,16.183,105758,32166,73592,5.912,19.437,82519,35350,47169,6.497,15.166,23239,4.271,30.333,3421,3454,18877
1985,4842,40112,43567,540824,532661,7392,17.085,6788,15.689,106263,33077,73186,6.210,19.949,90687,37261,53426,6.995,17.025,15576,2.924,34.051,5226,5240,24218
1985,4851,396,415,27229,27488,44,10.414,59,13.964,1783,543,1240,1.975,6.486,2339,1057,1282,3.845,8.509,-556,-2.023,12.973,42,42,534
1985,4852,343,650,22872,23662,32,4.823,59,8.892,2119,197,1922,0.833,8.955,3704,1093,2611,4.619,15.654,-1585,-6.699,17.911,21,21,454
1985,4853,5145,5191,54016,53327,950,18.238,986,18.929,11600,4634,6966,8.690,21.753,10304,4949,5355,9.280,19.322,1296,2.430,38.645,822,822,4120
1985,4854,3400,3601,98533,96792,303,8.381,332,9.183,12741,2621,10120,2.708,13.163,9080,4097,4983,4.233,9.381,3661,3.782,18.762,266,266,2672
1985,4855,614,651,12995,13365,115,18.039,88,13.804,2364,758,1606,5.672,17.689,3185,1698,1487,12.705,23.832,-821,-6.143,35.377,66,66,576
1985,4859,1079,1119,25815,25581,230,21.014,181,16.537,4562,1352,3210,5.285,17.834,3969,2225,1744,8.698,15.516,593,2.318,31.031,138,138,1751
1985,4861,67,297,10807,11133,12,3.967,23,7.603,525,205,320,1.841,4.716,1182,298,884,2.677,10.617,-657,-5.901,9.431,4,5,110
1985,4862,256,1347,58524,57929,149,11.326,86,6.537,5777,2724,3053,4.702,9.973,4680,1388,3292,2.396,8.079,1097,1.894,16.158,16,16,272
1985,4869,70,349,7586,7579,15,4.298,15,4.298,811,58,753,0.765,10.701,766,220,546,2.903,10.107,45,0.594,20.214,4,4,180
1985,4871,195,200,3383,3091,46,23.058,45,22.556,1003,361,642,11.681,32.454,397,132,265,4.271,12.846,606,19.608,25.692,33,33,110
1985,4872,724,734,8059,7929,132,18.157,118,16.231,2069,779,1290,9.825,26.094,1853,543,1310,6.848,23.370,216,2.724,46.740,98,98,491
1985,4879,64,85,1480,1278,22,28.025,9,11.465,520,136,384,10.642,40.689,113,72,41,5.634,8.842,407,31.847,17.684,6,6,44
1985,4881,2092,2688,63794,62969,446,16.843,366,13.822,14275,6120,8155,9.719,22.670,12332,5933,6399,9.422,19.584,1943,3.086,39.169,260,260,1682
1985,4882,334,443,10823,10637,53,12.073,45,10.251,2109,657,1452,6.177,19.828,1719,708,1011,6.656,16.161,390,3.667,32.323,33,33,439
1985,4883,2100,2510,97596,103873,288,11.257,385,15.048,20687,5081,15606,4.892,19.916,33160,13260,19900,12.766,31.924,-12473,-12.008,39.832,274,280,5779
1985,4884,3031,3619,41370,41370,608,16.990,527,14.727,8073,2546,5527,6.154,19.514,8111,3220,4891,7.783,19.606,-38,-0.092,39.028,362,369,1745
1985,4885,5534,7478,93671,90715,1336,18.438,872,12.034,21114,7422,13692,8.182,23.275,15103,6772,8331,7.465,16.649,6011,6.626,33.298,615,626,4518
1985,4889,407,408,4275,4455,98,24.685,76,19.144,1040,467,573,10.483,23.345,1435,938,497,21.055,32.211,-395,-8.866,46.689,62,62,386
1985,4921,1430,2365,76185,72217,533,23.563,327,14.456,17421,5778,11643,8.001,24.123,9330,3386,5944,4.689,12.919,8091,11.204,25.839,240,240,2625
1985,4922,1456,1516,11638,10516,597,44.075,274,20.229,4018,2421,1597,23.022,38.208,1838,1014,824,9.642,17.478,2180,20.730,34.956,241,241,923
1985,4931,5980,9440,394461,386251,795,8.427,784,8.310,63151,16566,46585,4.289,16.350,46934,16256,30678,4.209,12.151,16217,4.199,24.302,351,362,3422
1985,5111,13783,15797,651199,638835,1832,11.701,1551,9.906,73084,18164,54920,2.843,11.440,48010,20863,27147,3.266,7.515,25074,3.925,15.030,1207,1221,10509
1985,5112,6849,8023,155332,152726,1140,13.861,1543,18.761,36216,7587,28629,4.968,23.713,31140,14694,16446,9.621,20.389,5076,3.324,40.779,1066,1077,7009
1985,5121,9277,14175,215994,200507,2224,15.755,2106,14.919,70957,35086,35871,17.499,35.389,41492,14741,26751,7.352,20.694,29465,14.695,41.387,1307,1366,8723
1985,5122,2038,2045,15395,14514,571,29.532,348,17.998,5285,2692,2593,18.548,36.413,3549,1613,1936,11.113,24.452,1736,11.961,48.905,276,276,1329
1985,5151,6284,7423,229964,228453,955,12.961,846,11.481,34049,16655,17394,7.290,14.904,31291,15319,15972,6.706,13.697,2758,1.207,27.394,672,682,10660
1985,5152,10,10,449,260,4,38.095,5,47.619,423,404,19,155.385,162.692,38,31,7,11.923,14.615,385,148.077,29.231,5,5,31
1985,5173,3086,16427,913005,933810,2402,15.288,971,6.180,159282,70397,88885,7.539,17.057,202554,19605,182949,2.099,21.691,-43272,-4.634,34.114,349,358,4291
1985,5174,674,1308,70353,65418,215,16.771,163,12.715,22343,9411,12932,14.386,34.154,12545,6205,6340,9.485,19.177,9798,14.978,38.353,86,87,2888
1985,5179,1326,2794,74634,72995,531,19.497,390,14.320,18353,8304,10049,11.376,25.143,15438,3796,11642,5.200,21.149,2915,3.993,42.299,229,230,1748
1985,5182,5879,7830,256186,245841,1273,16.362,1173,15.077,64767,24040,40727,9.779,26.345,42989,23023,19966,9.365,17.487,21778,8.859,34.973,698,712,8686
1985,5191,2329,2765,33517,31620,353,13.069,225,8.330,7055,1593,5462,5.038,22.312,3243,1225,2018,3.874,10.256,3812,12.056,20.512,177,177,923
1985,5211,42,81,24895,24832,6,7.547,3,3.774,867,244,623,0.983,3.491,733,221,512,0.890,2.952,134,0.540,5.904,D,D,D
1985,5221,20223,70659,1956173,1931035,4179,5.958,3132,4.466,250745,62188,188557,3.220,12.985,200152,53859,146293,2.789,10.365,50593,2.620,20.730,1021,1108,20073
1985,5222,22632,40575,408892,400564,3954,9.799,3502,8.679,81392,30809,50583,7.691,20.319,64757,26819,37938,6.695,16.166,16635,4.153,32.333,1822,1841,10585
1985,5223,3833,4302,54606,53219,1057,25.378,783,18.800,15854,6574,9280,12.353,29.790,13077,6012,7065,11.297,24.572,2777,5.218,49.145,603,605,3989
1985,5231,6233,12546,291446,287583,2211,18.083,1573,12.865,52569,19352,33217,6.729,18.280,45157,12867,32290,4.474,15.702,7412,2.577,31.404,1020,1033,6810
1985,5232,119,134,6747,6756,16,11.722,21,15.385,749,127,622,1.880,11.087,736,422,314,6.247,10.895,13,0.192,21.790,16,16,45
1985,5239,14063,14501,259604,242898,3137,21.410,3439,23.471,81617,21575,60042,8.882,33.601,50609,32245,18364,13.275,20.835,31008,12.766,41.671,2834,2834,25692
1985,5241,6539,30873,1290870,1271099,2854,9.229,2956,9.559,184008,48385,135623,3.807,14.476,145846,44068,101778,3.467,11.474,38162,3.002,22.948,538,546,6312
1985,5242,96516,101369,752675,727388,13588,13.422,13326,13.163,189973,64210,125763,8.827,26.117,138353,76574,61779,10.527,19.021,51620,7.097,38.041,10289,10310,57845
1985,5259,705,921,9622,9100,115,12.735,79,8.749,2527,955,1572,10.495,27.771,1415,713,702,7.836,15.550,1112,12.220,31.101,53,53,432
1985,5311,97053,99661,525320,515248,15115,15.144,15410,15.440,131813,63101,68712,12.247,25.582,111135,58126,53009,11.281,21.569,20678,4.013,43.138,12620,12644,45286
1985,5312,33622,35131,193851,188336,6951,20.203,5501,15.988,55754,24058,31696,12.774,29.603,44643,20483,24160,10.876,23.704,11111,5.900,47.408,4355,4357,15464
1985,5313,23476,24511,252439,239868,4895,20.489,3654,15.295,66562,26791,39771,11.169,27.749,41722,19572,22150,8.159,17.394,24840,10.356,34.787,2835,2839,14379
1985,5321,5792,9300,122633,116173,1399,15.218,1185,12.890,30153,10042,20111,8.644,25.955,17294,7548,9746,6.497,14.886,12859,11.069,29.773,724,752,3900
1985,5322,14206,17245,150697,143765,5171,32.639,2367,14.940,46593,22306,24287,15.516,32.409,33213,15253,17960,10.610,23.102,13380,9.307,46.205,1580,1603,8172
1985,5323,3166,3907,31978,30569,823,22.073,466,12.498,9025,3967,5058,12.977,29.523,6226,2720,3506,8.898,20.367,2799,9.156,40.734,299,300,1551
1985,5324,6319,7581,96719,84204,1528,21.227,763,10.599,37126,24291,12835,28.848,44.091,13403,5309,8094,6.305,15.917,23723,28.173,31.835,481,482,2812
1985,5331,885,926,10942,10880,154,16.821,133,14.528,2645,906,1739,8.328,24.312,2511,1072,1439,9.853,23.080,134,1.232,46.160,109,109,914
1985,5411,123816,127505,738732,718282,15571,12.303,13676,10.806,140578,47401,93177,6.599,19.571,98888,46910,51978,6.531,13.767,41690,5.804,27.535,10334,10401,36729
1985,5412,56549,59428,451484,435334,10285,17.713,7560,13.020,98500,37890,60610,8.704,22.626,65503,34516,30987,7.929,15.047,32997,7.580,30.093,5605,5665,27688
1985,5413,53231,58203,771838,741673,10029,17.723,6795,12.008,173344,50914,122430,6.865,23.372,113260,41408,71852,5.583,15.271,60084,8.101,30.542,4962,4997,26151
1985,5414,13368,13599,93445,90466,2837,21.572,1942,14.766,24003,10146,13857,11.215,26.533,18006,8563,9443,9.465,19.904,5997,6.629,39.807,1552,1553,6570
1985,5415,10244,11425,113940,98664,4455,43.514,2081,20.326,49747,30747,19000,31.164,50.421,19263,10853,8410,11.000,19.524,30484,30.897,39.048,1609,1612,6387
1985,5416,35712,36917,309959,293959,9900,28.216,6240,17.784,105608,45861,59747,15.601,35.926,73442,35652,37790,12.128,24.984,32166,10.942,49.968,4924,4939,27334
1985,5417,6111,7406,430364,424173,1142,15.658,917,12.573,59338,16900,42438,3.984,13.989,46712,11036,35676,2.602,11.012,12626,2.977,22.025,592,596,4387
1985,5418,24876,27090,352028,341154,4773,18.066,3432,12.990,80266,28358,51908,8.312,23.528,58067,25568,32499,7.495,17.021,22199,6.507,34.042,2704,2724,18827
1985,5419,29408,32640,222124,215781,4410,13.752,3265,10.182,52070,18255,33815,8.460,24.131,39535,13614,25921,6.309,18.322,12535,5.809,36.644,2490,2505,10178
1985,5511,23750,43751,3003002,2927933,4118,9.430,3958,9.063,543319,140691,402628,4.805,18.556,395884,122549,273335,4.186,13.521,147435,5.035,27.042,981,993,11313
1985,5611,9660,10178,152971,144411,2217,22.309,1736,17.469,49249,17497,31752,12.116,34.103,31743,12698,19045,8.793,21.981,17506,12.122,43.962,1350,1355,8914
1985,5612,185,221,20092,16041,79,39.798,34,17.128,9521,2135,7386,13.310,59.354,1764,1206,558,7.518,10.997,7757,48.357,21.994,26,26,952
1985,5613,12999,17225,924444,823727,3446,20.851,2049,12.398,338758,82997,255761,10.076,41.125,136254,37909,98345,4.602,16.541,202504,24.584,33.082,1540,1564,25250
1985,5614,17728,19897,211565,205432,3336,17.004,2780,14.170,47592,16446,31146,8.006,23.167,35002,14261,20741,6.942,17.038,12590,6.129,34.077,2205,2218,9938
1985,5615,21480,24913,192009,183981,3759,15.467,2541,10.455,44962,14896,30066,8.096,24.438,28753,13758,14995,7.478,15.628,16209,8.810,31.256,1914,1983,10212
1985,5616,11229,13415,424678,412886,2355,17.929,1796,13.673,102638,25519,77119,6.181,24.859,79603,26002,53601,6.298,19.280,23035,5.579,38.559,1365,1366,14557
1985,5617,64069,67176,847702,807835,15877,24.438,11460,17.640,239160,81486,157674,10.087,29.605,159486,64556,94930,7.991,19.742,79674,9.863,39.485,9088,9114,46755
1985,5619,11585,12459,175076,167829,2270,18.610,1748,14.330,43854,12471,31383,7.431,26.130,29624,10548,19076,6.285,17.651,14230,8.479,35.303,1359,1364,7734
1985,5621,5498,5622,107415,104558,737,13.243,623,11.195,17751,3794,13957,3.629,16.977,12115,5089,7026,4.867,11.587,5636,5.390,23.174,495,495,3987
1985,5622,2016,2594,50588,47920,288,11.158,262,10.151,11437,3833,7604,7.999,23.867,6101,2716,3385,5.668,12.732,5336,11.135,25.464,197,197,1876
1985,5629,4328,4584,42791,41206,774,17.164,625,13.860,12410,3906,8504,9.479,30.117,9389,4219,5170,10.239,22.786,3021,7.331,45.571,483,483,2743
1985,6111,13117,13531,380455,374414,692,5.136,578,4.290,40508,6634,33874,1.772,10.819,28336,7456,20880,1.991,7.568,12172,3.251,15.136,447,453,6116
1985,6112,421,529,37396,36384,41,7.787,36,6.838,5005,692,4313,1.902,13.756,3014,340,2674,0.934,8.284,1991,5.472,16.568,24,25,169
1985,6113,2015,2357,924730,920953,86,3.651,83,3.524,89595,1650,87945,0.179,9.729,82223,15816,66407,1.717,8.928,7372,0.800,17.856,57,58,12789
1985,6114,2021,2352,40928,39150,481,20.981,362,15.791,9819,3381,6438,8.636,25.080,6328,2734,3594,6.983,16.163,3491,8.917,32.327,279,282,1521
1985,6115,4122,4720,52387,50275,635,13.568,555,11.859,11834,3837,7997,7.632,23.539,7691,3182,4509,6.329,15.298,4143,8.241,30.596,402,405,2255
1985,6116,11256,11780,100945,104253,2199,18.676,2188,18.583,24226,9672,14554,9.277,23.238,30499,18538,11961,17.782,29.255,-6273,-6.017,46.475,1740,1753,7474
1985,6117,1406,1446,13742,13192,289,20.569,207,14.733,3885,1867,2018,14.153,29.450,2819,1318,1501,9.991,21.369,1066,8.081,42.738,156,156,725
1985,6211,181179,187117,1115443,1089706,15158,8.135,13595,7.296,204634,66654,137980,6.117,18.779,153351,58839,94512,5.400,14.073,51283,4.706,28.145,11073,11179,46398
1985,6212,95530,97711,461268,450826,6545,6.734,5505,5.664,78604,22610,55994,5.015,17.436,57950,19658,38292,4.360,12.854,20654,4.581,25.708,4305,4378,15772
1985,6213,44156,45932,159668,152324,6902,15.430,4502,10.064,41781,18672,23109,12.258,27.429,27173,13325,13848,8.748,17.839,14608,9.590,35.678,3375,3438,10689
1985,6214,5888,7655,130117,123605,1279,17.297,758,10.251,31229,13083,18146,10.585,25.265,18436,8034,10402,6.500,14.915,12793,10.350,29.831,525,529,5210
1985,6215,4334,5285,68360,68823,778,14.819,708,13.486,14043,4634,9409,6.733,20.405,14650,9316,5334,13.536,21.287,-607,-0.882,40.809,477,503,4853
1985,6216,4441,5841,227992,211573,1328,24.148,645,11.728,68560,24810,43750,11.726,32.405,35501,11316,24185,5.349,16.780,33059,15.625,33.559,424,438,5129
1985,6219,4009,4629,83389,81223,1020,23.280,525,11.982,24097,11233,12864,13.830,29.668,19503,11221,8282,13.815,24.012,4594,5.656,48.024,348,355,6403
1985,6221,3684,4982,3130076,3128736,200,4.002,230,4.603,250132,112882,137250,3.608,7.995,248165,82749,165416,2.645,7.932,1967,0.063,15.864,160,162,61120
1985,6222,402,576,191251,160466,63,11.270,29,5.188,67885,51237,16648,31.930,42.305,4966,2190,2776,1.365,3.095,62919,39.210,6.189,16,16,1106
1985,6223,208,242,67681,65813,20,8.264,20,8.264,6272,2548,3724,3.872,9.530,2660,961,1699,1.460,4.042,3612,5.488,8.084,9,10,594
1985,6231,8237,12413,1018009,996341,994,8.037,903,7.301,142339,58166,84173,5.838,14.286,98991,48880,50111,4.906,9.935,43348,4.351,19.871,638,660,36874
1985,6232,4373,5920,139794,132462,826,14.496,382,6.704,28038,10700,17338,8.078,21.167,13314,4636,8678,3.500,10.051,14724,11.116,20.102,285,285,3306
1985,6233,7485,8661,231207,226992,1237,14.560,907,10.676,36897,14844,22053,6.539,16.255,28393,14888,13505,6.559,12.508,8504,3.746,25.017,660,664,10299
1985,6239,2830,3487,84029,81481,356,10.414,219,6.406,12771,3469,9302,4.257,15.674,7660,2592,5068,3.181,9.401,5111,6.273,18.802,153,154,1934
1985,6241,14269,19223,270691,264220,2039,10.773,1446,7.640,46549,11804,34745,4.467,17.618,33256,13604,19652,5.149,12.587,13293,5.031,25.173,944,956,9988
1985,6242,4082,4814,48730,47083,510,10.771,352,7.434,9192,2441,6751,5.184,19.523,5743,2166,3577,4.600,12.198,3449,7.325,24.395,237,241,1729
1985,6243,3931,5625,246048,237980,539,9.716,384,6.922,47461,8035,39426,3.376,19.943,31503,8325,23178,3.498,13.238,15958,6.706,26.475,234,237,5308
1985,6244,30453,35835,324680,310348,5352,15.286,3708,10.590,71759,28876,42883,9.304,23.122,42973,18715,24258,6.030,13.847,28786,9.275,27.693,2949,2977,14224
1985,7111,4440,4478,62526,61311,824,18.407,821,18.340,16827,4321,12506,7.048,27.446,14326,5274,9052,8.602,23.366,2501,4.079,46.733,612,614,3830
1985,7112,2066,2153,63215,62148,383,17.901,356,16.639,18101,4849,13252,7.802,29.126,15958,6017,9941,9.682,25.677,2143,3.448,51.355,288,290,4160
1985,7113,1941,1984,36410,35252,384,19.428,369,18.669,10335,3326,7009,9.435,29.317,8052,3149,4903,8.933,22.841,2283,6.476,45.683,281,281,2522
1985,7114,1130,1147,11272,11489,236,20.848,206,18.198,3021,1595,1426,13.883,26.296,3462,1284,2178,11.176,30.134,-441,-3.839,52.592,163,164,1054
1985,7115,10113,10150,57301,65431,3343,35.411,1924,20.380,25490,14417,11073,22.034,38.957,42958,31754,11204,48.531,65.654,-17468,-26.697,77.914,1458,1458,6644
1985,7121,2220,2372,38280,37208,240,10.311,151,6.488,5377,1006,4371,2.704,14.451,3208,847,2361,2.276,8.622,2169,5.829,17.244,103,103,476
1985,7131,1696,2153,55732,56835,311,13.770,522,23.113,10242,1596,8646,2.808,18.021,12362,2779,9583,4.890,21.751,-2120,-3.730,36.041,416,433,1765
1985,7132,718,734,20509,19336,116,15.623,133,17.912,5711,2614,3097,13.519,29.536,3252,1107,2145,5.725,16.819,2459,12.718,33.638,112,112,998
1985,7139,31961,33925,492022,480770,4752,14.125,4188,12.448,99329,35262,64067,7.334,20.660,76644,29055,47589,6.043,15.942,22685,4.718,31.884,3215,3229,21364
1985,7211,28947,33499,1200061,1171989,4562,13.614,4584,13.679,244867,119225,125642,10.173,20.893,189157,89809,99348,7.663,16.140,55710,4.753,32.280,3406,3448,59338
1985,7212,3679,3946,24456,23113,550,14.020,504,12.847,7409,3150,4259,13.629,32.056,4785,1764,3021,7.632,20.703,2624,11.353,41.406,364,368,1316
1985,7213,4502,4610,24638,23790,311,6.645,451,9.637,5183,2462,2721,10.349,21.786,3553,1413,2140,5.939,14.935,1630,6.852,29.870,323,323,1039
1985,7223,12639,16358,298190,291688,3039,18.658,2899,17.798,77766,39444,38322,13.523,26.661,64398,31819,32579,10.909,22.078,13368,4.583,44.155,2194,2205,19042
1985,7224,55017,55762,321326,322812,8341,14.616,10950,19.188,87393,45708,41685,14.159,27.072,90399,47063,43336,14.579,28.004,-3006,-0.931,54.145,8931,8964,38304
1985,7225,198694,262604,4810773,4706205,45087,17.276,41852,16.036,1171215,619503,551712,13.164,24.887,956674,483809,472865,10.280,20.328,214541,4.559,40.656,30712,31564,292773
1985,8111,100733,105241,524846,505541,17990,17.382,14503,14.013,133478,59750,73728,11.819,26.403,95167,46949,48218,9.287,18.825,38311,7.578,37.650,11506,11604,37467
1985,8112,9893,11197,80940,77746,1723,15.545,1497,13.506,19449,7346,12103,9.449,25.016,13151,5428,7723,6.982,16.915,6298,8.101,33.831,1145,1156,3727
1985,8113,19180,20215,150500,146813,3158,15.853,2569,12.896,33833,12457,21376,8.485,23.045,26494,12765,13729,8.695,18.046,7339,4.999,36.092,1946,1949,8719
1985,8114,22614,24155,145143,142329,4137,17.253,3785,15.785,30556,12811,17745,9.001,21.469,24931,12727,12204,8.942,17.517,5625,3.952,35.033,2896,2910,8522
1985,8121,79451,88303,459321,452388,13070,14.733,13893,15.660,104992,49731,55261,10.993,23.208,91174,46404,44770,10.258,20.154,13818,3.054,40.308,11143,11304,36392
1985,8122,17293,19995,116057,115663,1467,7.327,1522,7.601,17032,5135,11897,4.440,14.726,16281,5646,10635,4.881,14.076,751,0.649,28.152,1038,1062,4391
1985,8123,32355,38209,347440,344096,4711,12.277,5040,13.134,58711,21655,37056,6.293,17.062,51960,27391,24569,7.960,15.100,6751,1.962,30.201,3893,4019,21176
1985,8129,13806,20924,212402,209502,3973,19.321,3251,15.810,50803,18818,31985,8.982,24.249,44201,19383,24818,9.252,21.098,6602,3.151,42.196,2068,2149,11830
1985,8131,120338,120439,944870,921533,11434,9.713,5982,5.082,144611,31474,113137,3.415,15.692,98933,20065,78868,2.177,10.736,45678,4.957,21.471,3049,3049,7662
1985,8132,7570,8597,119462,117576,864,10.181,642,7.565,20175,3952,16223,3.361,17.159,16464,7690,8774,6.540,14.003,3711,3.156,28.006,473,481,6097
1985,8133,6921,8071,90059,88726,830,10.323,769,9.564,16274,4049,12225,4.563,18.342,13819,4815,9004,5.427,15.575,2455,2.767,31.150,513,523,3266
1985,8134,28188,29544,259850,256972,2061,6.888,2820,9.424,38438,9752,28686,3.795,14.958,32581,9208,23373,3.583,12.679,5857,2.279,25.358,1675,1676,5885
1985,8139,55405,57669,467699,459583,4736,8.183,5153,8.903,90150,21580,68570,4.696,19.616,73774,24631,49143,5.359,16.052,16376,3.563,32.105,3532,3541,18324
1986,1131,210,216,2271,2216,39,18.182,36,16.783,572,208,364,9.386,25.812,451,191,260,8.619,20.352,121,5.460,40.704,25,25,80
1986,1132,82,97,1464,1374,14,14.815,9,9.524,314,101,213,7.351,22.853,133,33,100,2.402,9.680,181,13.173,19.360,5,5,27
1986,1133,10380,10465,86314,87578,1479,13.881,1858,17.439,19955,6490,13465,7.411,22.786,22395,8826,13569,10.078,25.572,-2440,-2.786,45.571,1336,1337,5523
1986,1141,1120,1129,7090,7278,178,15.332,242,20.844,2128,801,1327,11.007,29.241,2445,1151,1294,15.816,33.597,-317,-4.356,58.482,185,185,673
1986,1142,132,132,623,584,27,20.455,27,20.455,239,172,67,29.452,40.925,168,108,60,18.493,28.767,71,12.158,57.534,25,25,105
1986,1151,3941,4330,52911,53923,598,13.815,595,13.746,14668,5193,9475,9.630,27.202,16803,5655,11148,10.487,31.161,-2135,-3.959,54.404,398,398,3328
1986,1152,1899,1918,13771,13345,351,18.700,269,14.331,3232,1451,1781,10.873,24.220,2409,812,1597,6.085,18.052,823,6.167,36.105,200,200,589
1986,1153,781,792,9522,9286,158,20.013,153,19.379,3157,1107,2050,11.922,33.999,2698,1295,1403,13.946,29.056,459,4.943,58.112,117,117,875
1986,2111,7835,9618,150963,157042,1087,11.107,1424,14.551,24498,8087,16411,5.150,15.600,36867,10285,26582,6.549,23.476,-12369,-7.876,31.199,985,995,4614
1986,2121,2565,3185,167963,170476,484,14.897,612,18.837,27915,8664,19251,5.082,16.375,32915,13257,19658,7.776,19.308,-5000,-2.933,32.749,408,409,4911
1986,2122,457,598,35131,37160,91,14.761,128,20.762,5437,2037,3400,5.482,14.631,9607,2305,7302,6.203,25.853,-4170,-11.222,29.263,83,83,987
1986,2123,3541,5047,102800,103222,439,8.713,422,8.376,14698,4128,10570,3.999,14.239,15657,4612,11045,4.468,15.168,-959,-0.929,28.479,260,263,1808
1986,2131,10181,11679,230055,256782,1342,11.053,2266,18.664,39954,16332,23622,6.360,15.560,93164,23055,70109,8.978,36.281,-53210,-20.722,31.119,1659,1674,14473
1986,2211,1647,5907,600891,597236,293,5.014,166,2.841,39879,13367,26512,2.238,6.677,31952,2472,29480,0.414,5.350,7927,1.327,10.700,57,57,581
1986,2212,571,2468,141037,142149,123,5.002,105,4.270,7043,1395,5648,0.981,4.955,8990,2098,6892,1.476,6.324,-1947,-1.370,9.909,37,37,307
1986,2213,3812,4098,31542,30741,375,9.273,267,6.602,4642,1927,2715,6.269,15.100,3008,1252,1756,4.073,9.785,1634,5.315,19.570,182,182,660
1986,2361,100201,100525,613345,596994,22168,22.599,17301,17.638,210029,84596,125433,14.170,35.181,177359,72211,105148,12.096,29.709,32670,5.472,59.417,12382,12390,54248
1986,2362,36146,36808,669414,653298,5766,15.905,4655,12.840,190254,44857,145397,6.866,29.122,157563,38294,119269,5.862,24.118,32691,5.004,48.236,3441,3442,26709
1986,2371,13048,13369,291593,297172,1527,11.424,1523,11.394,64457,14108,50349,4.747,21.690,74802,16494,58308,5.550,25.171,-10345,-3.481,43.380,1125,1125,8664
1986,2372,9649,9791,88705,87385,2549,26.917,1907,20.137,31240,15636,15604,17.893,35.750,28396,11829,16567,13.537,32.495,2844,3.255,64.991,1493,1496,8908
1986,2373,10301,10591,231827,223702,1277,12.182,1061,10.121,63975,12455,51520,5.568,28.598,47305,10013,37292,4.476,21.146,16670,7.452,42.293,750,752,6583
1986,2379,4659,4751,93876,93590,827,17.477,789,16.674,25089,8585,16504,9.173,26.807,24617,6054,18563,6.469,26.303,472,0.504,52.606,573,573,2782
1986,2381,70838,71214,698617,678166,12610,18.114,9414,13.523,217850,66074,151776,9.743,32.123,176991,56141,120850,8.278,26.098,40859,6.025,52.197,6953,6963,43743
1986,2382,109361,111037,1148819,1129016,16409,15.075,12038,11.059,270889,69060,201829,6.117,23.993,231187,72609,158578,6.431,20.477,39702,3.517,40.954,9021,9035,49349
1986,2383,72243,72672,623706,606324,14540,20.524,10883,15.362,191856,62074,129782,10.238,31.643,157180,53757,103423,8.866,25.923,34676,5.719,51.847,7930,7934,41348
1986,2389,37531,37795,355948,352954,6286,16.876,5194,13.944,97685,29111,68574,8.248,27.676,92035,26760,65275,7.582,26.076,5650,1.601,52.151,3811,3811,19674
1986,3111,1260,1871,49448,49758,97,5.136,132,6.990,5638,1971,3667,3.961,11.331,6256,1747,4509,3.511,12.573,-618,-1.242,22.662,74,74,825
1986,3112,501,852,65960,66325,42,4.918,46,5.386,4375,808,3567,1.218,6.596,5238,491,4747,0.740,7.897,-863,-1.301,13.193,26,26,200
1986,3113,1511,1840,80356,81330,270,14.905,213,11.758,8487,2319,6168,2.851,10.435,10440,2473,7967,3.041,12.837,-1953,-2.401,20.871,149,149,1036
1986,3114,1188,1649,178538,178888,119,7.179,136,8.205,19982,3729,16253,2.085,11.170,20785,4373,16412,2.445,11.619,-803,-0.449,22.340,89,90,2191
1986,3115,1648,2311,131169,131929,136,5.775,224,9.512,14509,4745,9764,3.597,10.998,16096,7381,8715,5.595,12.201,-1587,-1.203,21.995,144,145,1929
1986,3116,4036,4605,333795,327851,332,7.106,466,9.974,40650,9123,31527,2.783,12.399,28588,9583,19005,2.923,8.720,12062,3.679,17.440,340,340,4118
1986,3117,725,817,39232,39447,74,9.013,82,9.988,5810,1442,4368,3.656,14.729,6142,1318,4824,3.341,15.570,-332,-0.842,29.458,45,48,716
1986,3118,8782,10312,290894,297202,1450,14.108,1381,13.437,37656,13231,24425,4.452,12.670,49771,15874,33897,5.341,16.747,-12115,-4.076,25.340,1014,1039,8289
1986,3119,2070,2430,126310,124773,221,9.080,229,9.408,16521,3539,12982,2.836,13.241,13494,4712,8782,3.776,10.815,3027,2.426,21.630,176,176,2356
1986,3121,1898,2404,159562,161369,178,7.355,210,8.678,16369,4361,12008,2.703,10.144,20180,7569,12611,4.691,12.506,-3811,-2.362,20.288,133,135,2481
1986,3122,110,150,37554,39270,3,1.929,14,9.003,1751,15,1736,0.038,4.459,5197,1718,3479,4.375,13.234,-3446,-8.775,8.918,6,6,203
1986,3131,413,624,98033,98019,31,4.870,56,8.798,9763,2564,7199,2.616,9.960,9731,3227,6504,3.292,9.928,32,0.033,19.855,31,31,1100
1986,3132,1598,1957,251099,257427,142,7.136,208,10.452,19097,3881,15216,1.508,7.418,32061,9878,22183,3.837,12.454,-12964,-5.036,14.837,146,147,1933
1986,3133,4988,5589,135465,134902,591,10.933,224,4.144,18130,4565,13565,3.384,13.439,16998,5024,11974,3.724,12.600,1132,0.839,25.201,122,123,1460
1986,3141,3860,4154,121600,122052,497,11.911,534,12.798,15446,3760,11686,3.081,12.655,16169,5563,10606,4.558,13.248,-723,-0.592,25.311,410,416,3142
1986,3149,3635,3754,121393,120744,519,13.820,522,13.900,21055,6550,14505,5.425,17.438,19946,8449,11497,6.997,16.519,1109,0.918,33.038,438,438,6046
1986,3151,1341,1460,142182,140731,122,8.316,136,9.271,16074,2608,13466,1.853,11.422,13123,4374,8749,3.108,9.325,2951,2.097,18.650,109,109,2551
1986,3152,11608,13075,810949,819127,1826,13.775,2188,16.506,133306,42369,90937,5.172,16.274,148767,63847,84920,7.795,18.162,-15461,-1.887,32.548,1795,1803,39486
1986,3159,1690,1768,54691,56847,238,13.211,305,16.930,7397,2092,5305,3.680,13.012,11613,4662,6951,8.201,20.429,-4216,-7.416,26.024,257,257,3293
1986,3161,321,352,14336,14863,38,10.570,53,14.743,2203,1097,1106,7.381,14.823,3237,1788,1449,12.030,21.780,-1034,-6.957,29.645,44,46,1509
1986,3162,410,568,87191,93524,35,5.917,82,13.863,6740,1405,5335,1.502,7.207,19370,7726,11644,8.261,20.711,-12630,-13.505,14.413,49,51,1882
1986,3169,1153,1201,40389,42184,89,7.149,177,14.217,4803,1249,3554,2.961,11.386,8368,2695,5673,6.389,19.837,-3565,-8.451,22.772,142,142,1521
1986,3211,4625,5108,134032,134318,467,8.964,671,12.879,18845,5358,13487,3.989,14.030,19252,6732,12520,5.012,14.333,-407,-0.303,28.060,488,488,4066
1986,3212,1156,1404,87296,85896,157,11.303,127,9.143,11571,4122,7449,4.799,13.471,8716,3491,5225,4.064,10.147,2855,3.324,20.294,86,86,1320
1986,3219,8883,9602,281591,278190,1119,11.676,1083,11.300,49976,15274,34702,5.491,17.965,43196,16901,26295,6.075,15.528,6780,2.437,31.055,824,827,7963
1986,3221,225,539,190457,191566,18,3.315,26,4.788,11031,4623,6408,2.413,5.758,13417,4954,8463,2.586,7.004,-2386,-1.246,11.517,12,12,277
1986,3222,3597,5190,403002,399820,335,6.492,275,5.329,39195,8835,30360,2.210,9.803,32492,8474,24018,2.119,8.127,6703,1.677,16.253,190,193,4047
1986,3231,38078,39717,761111,751076,4604,11.747,3557,9.075,103246,28068,75178,3.737,13.746,83045,28019,55026,3.731,11.057,20201,2.690,22.114,2838,2846,20078
1986,3241,1328,2206,124938,127075,213,9.680,202,9.180,9112,2122,6990,1.670,7.171,13452,2804,10648,2.207,10.586,-4340,-3.415,14.341,114,114,817
1986,3251,1125,2239,228059,233327,160,7.146,160,7.146,17763,5381,12382,2.306,7.613,28182,8871,19311,3.802,12.078,-10419,-4.465,15.226,74,75,885
1986,3252,381,623,126297,130880,46,7.474,31,5.037,5516,1940,3576,1.482,4.215,14513,1618,12895,1.236,11.089,-8997,-6.874,8.429,13,13,136
1986,3253,662,987,44003,45481,65,6.481,97,9.671,3911,991,2920,2.179,8.599,6863,1776,5087,3.905,15.090,-2952,-6.491,17.199,49,50,313
1986,3254,1030,1271,157697,157600,141,11.213,114,9.066,17968,5650,12318,3.585,11.401,17665,9020,8645,5.723,11.209,303,0.192,22.418,74,74,4238
1986,3255,1650,2132,75694,75325,153,7.200,139,6.541,8952,2668,6284,3.542,11.885,8147,1782,6365,2.366,10.816,805,1.069,21.632,90,90,649
1986,3256,2079,2317,118657,119557,199,8.568,210,9.042,10710,3270,7440,2.735,8.958,12479,2458,10021,2.056,10.438,-1769,-1.480,17.916,158,158,1853
1986,3259,1809,2373,127880,128153,245,10.414,204,8.672,11449,4274,7175,3.335,8.934,12061,4965,7096,3.874,9.411,-612,-0.478,17.868,103,108,1492
1986,3261,10315,12010,591491,584330,1077,8.976,1054,8.784,87193,23320,63873,3.991,14.922,72915,21882,51033,3.745,12.478,14278,2.443,24.957,774,779,12752
1986,3262,1955,2316,177645,181552,198,8.540,203,8.756,13255,3021,10234,1.664,7.301,21109,8055,13054,4.437,11.627,-7854,-4.326,14.602,160,160,1673
1986,3271,1305,1584,74409,75929,179,11.237,197,12.367,7177,1302,5875,1.715,9.452,10318,3357,6961,4.421,13.589,-3141,-4.137,18.905,147,147,1494
1986,3272,1557,1812,134406,138900,208,11.463,213,11.739,12150,2677,9473,1.927,8.747,20863,3543,17320,2.551,15.020,-8713,-6.273,17.495,154,155,1676
1986,3273,6777,8943,187159,185399,679,7.602,656,7.345,30984,7806,23178,4.210,16.712,27524,7043,20481,3.799,14.846,3460,1.866,29.692,455,475,4913
1986,3274,236,330,17467,17360,37,11.178,39,11.782,1363,247,1116,1.423,7.851,1158,319,839,1.838,6.671,205,1.181,13.341,29,29,131
1986,3279,1887,2178,81159,81859,183,8.402,183,8.402,8354,1713,6641,2.093,10.205,9789,2378,7411,2.905,11.958,-1435,-1.753,20.411,132,135,1542
1986,3311,363,430,184822,197312,45,10.551,38,8.910,4871,2070,2801,1.049,2.469,29621,3681,25940,1.866,15.012,-24750,-12.544,4.937,23,23,772
1986,3312,503,666,61379,63452,46,6.928,42,6.325,4142,794,3348,1.251,6.528,8498,2396,6102,3.776,13.393,-4356,-6.865,13.056,23,23,377
1986,3313,300,458,85760,87003,30,6.557,29,6.339,5793,2529,3264,2.907,6.658,8416,2482,5934,2.853,9.673,-2623,-3.015,13.317,14,14,1447
1986,3314,717,886,85064,90491,58,6.342,115,12.575,5259,1664,3595,1.839,5.812,16165,6556,9609,7.245,17.864,-10906,-12.052,11.623,72,72,2119
1986,3315,2671,2937,213315,214555,172,5.770,260,8.722,24671,8694,15977,4.052,11.499,27318,9095,18223,4.239,12.732,-2647,-1.234,22.997,174,177,3599
1986,3321,3167,3375,140806,144291,205,6.066,214,6.332,13211,3417,9794,2.368,9.156,20335,5658,14677,3.921,14.093,-7124,-4.937,18.312,140,140,2864
1986,3322,1200,1321,76773,77778,102,7.701,109,8.230,7388,2700,4688,3.471,9.499,9125,3175,5950,4.082,11.732,-1737,-2.233,18.998,79,79,1761
1986,3323,9743,10514,328776,328668,834,7.870,1001,9.446,51395,10124,41271,3.080,15.637,51219,15449,35770,4.700,15.584,176,0.054,31.168,725,728,7829
1986,3324,1478,1816,123257,124387,153,8.481,129,7.151,14054,4112,9942,3.306,11.299,16736,4642,12094,3.732,13.455,-2682,-2.156,22.597,77,79,1231
1986,3325,938,1018,73068,72889,78,7.700,68,6.713,6518,1867,4651,2.561,8.942,6216,1168,5048,1.602,8.528,302,0.414,17.056,51,51,856
1986,3326,1636,1839,66151,66894,136,7.296,186,9.979,8321,2204,6117,3.295,12.439,9753,3039,6714,4.543,14.580,-1432,-2.141,24.878,136,136,1620
1986,3327,21775,22074,341373,343027,2110,9.587,1978,8.988,46970,11193,35777,3.263,13.693,50398,14517,35881,4.232,14.692,-3428,-0.999,27.386,1561,1562,9443
1986,3328,5471,5801,147434,141433,461,7.941,470,8.096,31801,6126,25675,4.331,22.485,20299,5227,15072,3.696,14.352,11502,8.133,28.705,358,360,3848
1986,3329,5596,6108,353896,354715,641,10.543,585,9.622,37887,10239,27648,2.887,10.681,39764,9823,29941,2.769,11.210,-1877,-0.529,21.362,432,432,5574
1986,3331,2900,3226,210042,221347,253,7.661,406,12.294,18644,6197,12447,2.800,8.423,41286,12685,28601,5.731,18.652,-22642,-10.229,16.846,257,260,5523
1986,3332,3738,3998,160755,165804,316,7.906,314,7.856,15793,4664,11129,2.813,9.525,25706,6868,18838,4.142,15.504,-9913,-5.979,19.050,213,213,2367
1986,3333,2060,2177,167682,168279,196,9.041,178,8.210,18032,4415,13617,2.624,10.716,19463,4558,14905,2.709,11.566,-1431,-0.850,21.431,117,117,1915
1986,3334,1698,1921,159436,160221,188,9.731,210,10.870,17965,5875,12090,3.667,11.213,19647,6177,13470,3.855,12.262,-1682,-1.050,22.425,155,155,2918
1986,3335,9597,9983,233302,237296,703,7.048,685,6.868,27812,7619,20193,3.211,11.720,35960,9438,26522,3.977,15.154,-8148,-3.434,23.441,515,516,4261
1986,3336,728,882,133313,138541,47,5.293,59,6.644,6345,1736,4609,1.253,4.580,16874,2094,14780,1.511,12.180,-10529,-7.600,9.160,34,34,331
1986,3339,5812,6360,314541,316878,459,7.194,500,7.836,33714,7711,26003,2.433,10.639,38439,10639,27800,3.357,12.131,-4725,-1.491,21.279,358,358,4245
1986,3341,1603,1764,310830,332414,237,13.251,286,15.991,28782,6201,22581,1.865,8.658,70798,19449,51349,5.851,21.298,-42016,-12.640,17.317,205,206,4336
1986,3342,1792,2019,285662,292234,176,8.598,232,11.334,34745,17016,17729,5.823,11.889,47997,14405,33592,4.929,16.424,-13252,-4.535,23.779,162,162,2492
1986,3343,370,394,41758,41917,43,10.886,45,11.392,4015,588,3427,1.403,9.579,4299,552,3747,1.317,10.256,-284,-0.678,19.157,31,31,339
1986,3344,4481,5106,492723,516194,603,11.802,610,11.939,43817,13811,30006,2.676,8.488,90728,15391,75337,2.982,17.576,-46911,-9.088,16.977,470,470,6902
1986,3345,4222,4818,675374,673985,428,8.936,371,7.746,65580,13829,51751,2.052,9.730,62728,18570,44158,2.755,9.307,2852,0.423,18.614,234,234,2890
1986,3346,619,641,19403,19002,93,14.374,105,16.229,4425,1665,2760,8.762,23.288,3524,1555,1969,8.184,18.546,901,4.742,37.092,72,72,310
1986,3351,1202,1330,85609,85198,119,8.971,112,8.443,9484,1723,7761,2.022,11.132,8755,2472,6283,2.901,10.276,729,0.856,20.552,73,73,640
1986,3352,323,423,115260,115394,27,6.308,37,8.645,8830,1092,7738,0.946,7.652,9165,2637,6528,2.285,7.942,-335,-0.290,15.304,21,22,765
1986,3353,2020,2504,236284,240857,191,7.668,165,6.624,18242,3499,14743,1.453,7.574,27104,6997,20107,2.905,11.253,-8862,-3.679,15.148,91,91,2104
1986,3359,2120,2522,221946,223746,259,10.375,208,8.332,22099,6872,15227,3.071,9.877,25525,5149,20377,2.301,11.408,-3426,-1.531,19.754,136,136,1738
1986,3361,209,266,282557,281330,34,13.027,24,9.195,26205,5929,20276,2.107,9.315,23095,1456,21639,0.518,8.209,3110,1.105,16.418,20,20,990
1986,3362,1774,1974,113794,115548,215,10.939,198,10.074,14516,4743,9773,4.105,12.563,17962,4160,13802,3.600,15.545,-3446,-2.982,25.126,149,150,1984
1986,3363,3723,4491,641828,645578,478,10.737,400,8.985,55230,18802,36428,2.912,8.555,62549,19163,43386,2.968,9.689,-7319,-1.134,17.110,289,289,7201
1986,3364,1253,1523,734839,710911,131,8.613,127,8.350,97767,36347,61420,5.113,13.752,50799,37027,13772,5.208,7.146,46968,6.607,14.291,84,84,1810
1986,3365,163,185,27218,28228,13,7.027,13,7.027,2005,381,1624,1.350,7.103,3920,223,3697,0.790,13.887,-1915,-6.784,14.206,7,7,53
1986,3366,1137,1218,157407,159032,158,13.058,142,11.736,19708,3239,16469,2.037,12.393,23437,4157,19280,2.614,14.737,-3729,-2.345,24.785,99,99,1420
1986,3369,459,471,34314,35972,60,12.780,57,12.141,2344,533,1811,1.482,6.516,5734,2180,3554,6.060,15.940,-3390,-9.424,13.033,44,44,321
1986,3371,12919,13618,378702,379214,1999,14.812,1754,12.997,54970,17419,37551,4.593,14.496,56134,21093,35041,5.562,14.803,-1164,-0.307,28.992,1384,1390,13263
1986,3372,2657,2795,141280,141472,309,11.097,288,10.343,17185,4771,12414,3.372,12.147,17563,4823,12740,3.409,12.414,-378,-0.267,24.295,239,239,3379
1986,3379,1071,1212,41495,41534,113,9.323,113,9.323,4670,840,3830,2.022,11.244,4687,2197,2490,5.290,11.285,-17,-0.041,22.488,87,87,994
1986,3391,10145,10624,221606,221388,1285,12.202,1099,10.436,30539,10188,20351,4.602,13.794,29788,10774,19014,4.867,13.455,751,0.339,26.910,801,803,4204
1986,3399,14805,15357,393675,394660,1926,12.557,1889,12.315,59578,16272,43306,4.123,15.096,61624,23049,38575,5.840,15.614,-2046,-0.518,30.192,1476,1484,12726
1986,4231,18596,21954,256711,257264,2403,10.933,2452,11.156,41563,14074,27489,5.471,16.156,42714,15255,27459,5.930,16.603,-1151,-0.447,32.312,1755,1785,9002
1986,4232,7499,8526,98047,97250,1141,13.489,1007,11.904,18124,5587,12537,5.745,18.637,16422,5950,10472,6.118,16.886,1702,1.750,33.773,753,763,3970
1986,4233,7495,9221,117454,116616,1166,12.750,1014,11.088,22297,7883,14414,6.760,19.120,20561,7207,13354,6.180,17.631,1736,1.489,35.263,709,715,4011
1986,4234,23673,32533,572737,562832,4952,15.540,3618,11.354,101224,39093,62131,6.946,17.985,81237,31629,49608,5.620,14.434,19987,3.551,28.867,2292,2390,15415
1986,4235,6665,8862,130090,131534,903,10.201,884,9.986,18130,6105,12025,4.641,13.784,20997,7377,13620,5.608,15.963,-2867,-2.180,27.567,500,505,3446
1986,4236,15092,21559,305065,305335,2707,12.704,2204,10.344,54307,20610,33697,6.750,17.786,54695,22779,31916,7.460,17.913,-388,-0.127,35.572,1406,1438,10048
1986,4237,10546,13893,150983,150433,1419,10.313,1152,8.372,23753,8162,15591,5.426,15.790,22561,8118,14443,5.396,14.997,1192,0.792,29.995,815,827,5296
1986,4238,46176,60214,636905,640219,5901,9.821,5650,9.403,96634,30760,65874,4.805,15.094,103029,37252,65777,5.819,16.093,-6395,-0.999,30.188,3612,3691,20234
1986,4239,23857,25477,236950,233105,4170,16.624,3385,13.494,51427,18646,32781,7.999,22.062,43786,16406,27380,7.038,18.784,7641,3.278,37.568,2576,2597,10779
1986,4241,8174,10858,157536,156493,1126,10.500,857,7.992,22488,6538,15950,4.178,14.370,20519,5736,14783,3.665,13.112,1969,1.258,26.224,584,594,3288
1986,4242,2826,3611,98736,96902,551,15.526,427,12.032,17489,3607,13882,3.722,18.048,13660,5508,8152,5.684,14.097,3829,3.951,28.193,302,312,1991
1986,4243,8258,8881,106313,105350,1542,17.214,1696,18.933,26499,8647,17852,8.208,25.153,24301,11521,12780,10.936,23.067,2198,2.086,46.134,1367,1375,6984
1986,4244,27187,33327,631328,622234,3929,11.808,3823,11.489,109528,32186,77342,5.173,17.602,91460,34030,57430,5.469,14.699,18068,2.904,29.397,2810,2834,17884
1986,4245,7427,10308,88070,90915,666,6.325,1109,10.532,12227,3621,8606,3.983,13.449,17757,6600,11157,7.260,19.532,-5530,-6.083,26.898,689,717,3833
1986,4246,7214,10491,122629,121311,1135,10.876,1025,9.822,21190,6884,14306,5.675,17.468,18560,6876,11684,5.668,15.300,2630,2.168,30.599,570,573,3157
1986,4247,10585,13748,146034,146484,935,6.732,1215,8.749,24845,6606,18239,4.510,16.961,25452,7978,17474,5.446,17.375,-607,-0.414,33.922,763,793,4864
1986,4248,4312,5385,138937,138488,317,5.805,469,8.588,15576,3155,12421,2.278,11.247,14703,4935,9768,3.563,10.617,873,0.630,21.234,347,355,2805
1986,4249,18727,22175,238373,234821,3066,13.898,2836,12.856,45610,15920,29690,6.780,19.423,38532,15171,23361,6.461,16.409,7078,3.014,32.818,2003,2022,9081
1986,4251,29622,32316,308044,305589,3802,11.896,3092,9.674,55146,17888,37258,5.854,18.046,50360,16981,33379,5.557,16.480,4786,1.566,32.959,2143,2150,10272
1986,4411,38050,39325,940651,912447,4539,11.639,3886,9.964,149891,49789,100102,5.457,16.427,93781,33420,60361,3.663,10.278,56110,6.149,20.556,3116,3130,27203
1986,4412,11236,11747,84683,83502,1514,12.957,1390,11.896,18428,7109,11319,8.514,22.069,15982,6222,9760,7.451,19.140,2446,2.929,38.280,1128,1135,5245
1986,4413,44775,62137,451507,450484,6778,11.009,5638,9.158,79004,34406,44598,7.638,17.538,76686,27592,49094,6.125,17.023,2318,0.515,34.046,3781,3918,17608
1986,4421,21976,27300,226737,222479,3578,13.278,2870,10.651,45838,18986,26852,8.534,20.603,37294,13565,23729,6.097,16.763,8544,3.840,33.526,2107,2190,9200
1986,4422,21600,26409,158449,154142,4187,16.248,2908,11.285,38689,17759,20930,11.521,25.100,30376,10645,19731,6.906,19.707,8313,5.393,39.413,2099,2167,7566
1986,4431,30211,43688,299152,287869,6616,15.370,5329,12.380,79548,37899,41649,13.165,27.633,57569,23076,34493,8.016,19.998,21979,7.635,39.997,3622,3812,15796
1986,4441,57119,73914,768136,751725,7007,9.544,6018,8.197,134893,51305,83588,6.825,17.944,102692,33717,68975,4.485,13.661,32201,4.284,27.322,4322,4419,20138
1986,4442,16884,20571,153861,152589,2416,11.854,2036,9.990,29668,11494,18174,7.533,19.443,26890,8960,17930,5.872,17.623,2778,1.821,35.245,1378,1396,5551
1986,4451,62914,95429,2043984,1993485,11827,12.401,11714,12.282,359751,159007,200744,7.976,18.046,259491,103780,155711,5.206,13.017,100260,5.029,26.034,7947,8156,49556
1986,4452,22628,27504,177198,178734,4400,16.058,4195,15.309,41439,20524,20915,11.483,23.185,44426,18812,25614,10.525,24.856,-2987,-1.671,46.370,3140,3217,13829
1986,4453,28006,33267,165254,168466,3685,11.003,4130,12.332,32128,13326,18802,7.910,19.071,38736,14702,24034,8.727,22.993,-6608,-3.922,38.142,3154,3225,11364
1986,4461,48245,71559,650669,644594,8099,11.492,5932,8.417,113026,52960,60066,8.216,17.534,100382,33953,66429,5.267,15.573,12644,1.962,31.146,4173,4263,21823
1986,4471,91749,135895,925369,916582,16069,11.813,16346,12.016,204997,90374,114623,9.860,22.365,187872,80886,106986,8.825,20.497,17125,1.868,40.994,10988,11324,49913
1986,4481,55271,98373,888707,862934,13667,14.071,11172,11.503,203700,85533,118167,9.912,23.606,150586,57853,92733,6.704,17.450,53114,6.155,34.901,7227,7774,31495
1986,4482,11815,36636,198047,197430,4315,11.805,4150,11.353,43267,20567,22700,10.417,21.915,42330,16158,26172,8.184,21.441,937,0.475,42.881,1642,1860,7154
1986,4483,18778,27464,157069,154155,4152,15.548,2632,9.856,34640,18055,16585,11.712,22.471,29161,9939,19222,6.447,18.917,5479,3.554,37.833,1776,1846,6675
1986,4511,32143,41758,286188,278263,6379,15.464,5365,13.006,66998,29193,37805,10.491,24.077,51411,20159,31252,7.245,18.476,15587,5.602,36.951,3856,3972,12374
1986,4512,8048,12212,81831,80683,1741,14.528,1284,10.715,18050,7557,10493,9.366,22.372,15734,5308,10426,6.579,19.501,2316,2.871,39.002,882,905,2932
1986,4522,418,6884,1129845,1129889,315,4.594,262,3.821,112321,42738,69583,3.782,9.941,111588,17193,94395,1.522,9.876,733,0.065,19.752,24,26,632
1986,4523,13804,29048,848602,835883,3078,10.640,2839,9.814,131463,63512,67951,7.598,15.727,107691,34487,73204,4.126,12.884,23772,2.844,25.767,1725,1772,8635
1986,4531,22910,24349,125487,122551,3657,15.238,2957,12.321,28696,11143,17553,9.093,23.416,22699,9511,13188,7.761,18.522,5997,4.893,37.044,2250,2290,7396
1986,4532,28084,34505,228662,224145,6223,18.500,4490,13.348,52903,25120,27783,11.207,23.602,43815,17531,26284,7.821,19.548,9088,4.055,39.095,3253,3372,12259
1986,4533,8774,10376,49200,48737,1723,16.738,1559,15.145,11838,5979,5859,12.268,24.290,10871,4157,6714,8.529,22.305,967,1.984,44.611,1238,1242,3268
1986,4539,24833,30100,147762,145039,4728,15.763,4515,15.053,38690,18036,20654,12.435,26.676,33331,15399,17932,10.617,22.981,5359,3.695,45.961,3203,3317,11027
1986,4541,5349,6583,92418,95102,789,11.233,1671,23.790,16902,5608,11294,5.897,17.772,22999,11334,11665,11.918,24.184,-6097,-6.411,35.545,1120,1124,3694
1986,4542,4012,5037,73465,76037,574,11.318,643,12.679,11789,3463,8326,4.554,15.504,17251,6914,10337,9.093,22.688,-5462,-7.183,31.009,387,388,2076
1986,4543,16990,22879,215515,214680,2330,10.179,2351,10.271,39970,13111,26859,6.107,18.618,38090,14357,23733,6.688,17.743,1880,0.876,35.485,1651,1665,7482
1986,4811,1044,2991,345658,337153,392,13.388,266,9.085,52594,8115,44479,2.407,15.599,36256,12777,23479,3.790,10.754,16338,4.846,21.507,137,138,3875
1986,4812,454,756,25258,23971,148,20.081,110,14.925,5655,2195,3460,9.157,23.591,3018,2137,881,8.915,12.590,2637,11.001,25.180,77,77,1848
1986,4831,369,649,30992,31583,86,13.640,49,7.772,4868,2195,2673,6.950,15.414,6035,816,5219,2.584,19.109,-1167,-3.695,30.827,27,27,279
1986,4832,350,411,13937,14823,34,8.057,56,13.270,1982,927,1055,6.254,13.372,3724,1123,2601,7.576,25.124,-1742,-11.752,26.743,39,39,539
1986,4841,23697,29668,569201,562382,5272,17.938,4715,16.043,107173,38568,68605,6.858,19.057,93729,32024,61705,5.694,16.666,13444,2.391,33.333,3543,3588,19509
1986,4842,40395,43899,538270,539120,7344,16.801,6969,15.943,103844,35291,68553,6.546,19.262,105421,36244,69177,6.723,19.554,-1577,-0.293,38.524,5361,5426,26889
1986,4851,385,412,29048,28132,51,12.349,53,12.833,3436,1474,1962,5.240,12.214,1611,784,827,2.787,5.727,1825,6.487,11.453,46,46,661
1986,4852,345,630,21722,22729,33,5.140,57,8.879,2519,230,2289,1.012,11.083,4443,1499,2944,6.595,19.548,-1924,-8.465,22.166,28,28,157
1986,4853,5073,5119,54203,54267,919,17.846,980,19.031,11324,4435,6889,8.173,20.867,11416,5034,6382,9.276,21.037,-92,-0.170,41.735,825,826,4522
1986,4854,3355,3592,100251,99132,335,9.317,342,9.512,16430,4868,11562,4.911,16.574,14246,4548,9698,4.588,14.371,2184,2.203,28.742,273,273,3402
1986,4855,625,676,14308,13830,131,19.744,106,15.976,3809,1760,2049,12.726,27.543,2776,1464,1312,10.586,20.073,1033,7.470,40.146,69,69,549
1986,4859,1127,1166,27745,26770,242,21.182,195,17.068,5470,2005,3465,7.490,20.433,3594,1614,1980,6.029,13.425,1876,7.008,26.851,151,151,1326
1986,4861,63,288,10161,10483,14,4.786,23,7.863,978,94,884,0.897,9.329,1617,754,863,7.193,15.425,-639,-6.096,18.659,D,D,D
1986,4862,255,1332,56592,57544,62,4.627,78,5.821,2993,1249,1744,2.171,5.201,4978,1024,3954,1.780,8.651,-1985,-3.450,10.403,32,32,274
1986,4869,71,352,9069,8318,26,7.407,24,6.838,2465,790,1675,9.497,29.635,941,293,648,3.522,11.313,1524,18.322,22.626,10,10,65
1986,4871,210,216,3901,3653,48,22.912,35,16.706,1035,564,471,15.439,28.333,541,260,281,7.117,14.810,494,13.523,29.619,24,24,171
1986,4872,760,771,8417,8284,154,20.397,122,16.159,2055,785,1270,9.476,24.807,1807,655,1152,7.907,21.813,248,2.994,43.626,82,82,431
1986,4879,64,88,1588,1533,18,20.930,14,16.279,263,53,210,3.458,17.162,153,61,92,3.980,9.984,110,7.178,19.967,10,10,37
1986,4881,2087,2708,67299,65620,396,14.659,383,14.177,12250,4597,7653,7.006,18.668,8767,3564,5203,5.431,13.360,3483,5.308,26.721,270,270,1719
1986,4882,346,474,11102,11048,95,20.720,64,13.959,2259,879,1380,7.957,20.448,2086,727,1359,6.581,18.882,173,1.566,37.764,38,39,483
1986,4883,2107,2493,89656,93338,336,13.416,359,14.334,16824,4702,12122,5.038,18.025,23840,6404,17436,6.861,25.542,-7016,-7.517,36.050,233,235,3598
1986,4884,3195,3759,42954,42226,676,18.335,532,14.429,8852,3179,5673,7.529,20.963,7290,2408,4882,5.703,17.264,1562,3.699,34.528,367,372,1516
1986,4885,5887,7929,100314,97063,1483,19.230,1049,13.602,23889,9189,14700,9.467,24.612,17147,6295,10852,6.485,17.666,6742,6.946,35.332,713,762,4883
1986,4889,434,437,4929,4605,103,24.437,72,17.082,1533,687,846,14.919,33.290,866,424,442,9.207,18.806,667,14.484,37.611,60,60,311
1986,4921,1567,2609,88502,82375,588,23.662,340,13.682,22246,10358,11888,12.574,27.006,10229,4120,6109,5.002,12.418,12017,14.588,24.835,225,225,2092
1986,4922,1779,1870,15802,13733,687,40.591,332,19.616,6376,3847,2529,28.013,46.428,2178,1265,913,9.211,15.860,4198,30.569,31.719,272,272,1021
1986,4931,6048,9549,395867,395143,924,9.732,815,8.584,62469,19154,43315,4.847,15.809,61369,15864,45505,4.015,15.531,1100,0.278,31.062,332,336,3042
1986,5111,13913,15990,669243,658786,1962,12.352,1751,11.023,79398,23146,56252,3.513,12.052,58549,20258,38291,3.075,8.887,20849,3.165,17.775,1371,1375,13199
1986,5112,6360,7392,159269,159796,925,12.018,1534,19.931,33252,8076,25176,5.054,20.809,34479,16706,17773,10.455,21.577,-1227,-0.768,41.618,1016,1028,6172
1986,5121,9306,14131,231666,224314,2281,16.109,2339,16.518,62366,20664,41702,9.212,27.803,48298,16373,31925,7.299,21.531,14068,6.272,43.063,1320,1382,7384
1986,5122,2149,2154,15049,15092,548,26.158,430,20.525,4819,2597,2222,17.208,31.932,4937,2570,2367,17.029,32.714,-118,-0.782,63.864,341,341,2198
1986,5151,6380,7564,239139,235844,1037,13.853,881,11.769,44898,19500,25398,8.268,19.037,39224,14747,24477,6.253,16.631,5674,2.406,33.263,670,681,9988
1986,5152,10,11,525,487,6,60.000,4,40.000,86,16,70,3.289,17.677,11,8,3,1.644,2.261,75,15.416,4.522,3,3,6
1986,5173,3220,16972,887790,900247,1772,10.608,1236,7.399,115303,30583,84720,3.397,12.808,141597,19295,122302,2.143,15.729,-26294,-2.921,25.616,441,443,4809
1986,5174,688,1376,75294,72718,189,14.089,120,8.945,15789,5123,10666,7.045,21.713,10891,4993,5898,6.866,14.977,4898,6.736,29.954,54,54,633
1986,5179,1356,2929,77896,76249,527,18.436,386,13.504,16040,7646,8394,10.028,21.036,13141,4267,8874,5.596,17.234,2899,3.802,34.469,219,221,1351
1986,5182,5948,7811,254577,254493,1211,15.487,1228,15.704,52591,19355,33236,7.605,20.665,52383,24072,28311,9.459,20.583,208,0.082,41.167,613,619,4437
1986,5191,2384,2846,36448,34716,354,12.609,277,9.866,9090,4912,4178,14.149,26.184,5227,1616,3611,4.655,15.057,3863,11.128,30.113,197,197,832
1986,5211,46,83,25760,25328,7,8.537,5,6.098,1479,298,1181,1.177,5.840,595,202,393,0.798,2.349,884,3.490,4.698,D,D,D
1986,5221,19816,73049,2015685,1985603,5241,7.293,2869,3.992,294340,93316,201024,4.700,14.824,234310,51210,183100,2.579,11.800,60030,3.023,23.601,924,971,16906
1986,5222,22294,40812,461253,437672,4180,10.272,3946,9.697,112741,37539,75202,8.577,25.759,65435,32204,33231,7.358,14.951,47306,10.809,29.901,2015,2159,15989
1986,5223,4128,4628,57476,55031,1174,26.358,826,18.545,17126,7633,9493,13.870,31.121,12281,6420,5861,11.666,22.317,4845,8.804,44.633,629,629,3823
1986,5231,6379,12906,330310,311384,1821,14.309,1461,11.480,73200,15525,57675,4.986,23.508,36564,13847,22717,4.447,11.742,36636,11.766,23.485,901,904,6610
1986,5232,113,126,6711,6689,13,10.000,21,16.154,524,206,318,3.080,7.834,451,157,294,2.347,6.742,73,1.091,13.485,12,12,56
1986,5239,14789,15294,236601,235369,3305,22.141,2571,17.224,58907,21503,37404,9.136,25.028,57140,27427,29713,11.653,24.277,1767,0.751,48.554,1955,1959,21609
1986,5241,6594,30822,1352746,1322643,2125,6.882,2235,7.238,172797,31983,140814,2.418,13.065,111154,35791,75363,2.706,8.404,61643,4.661,16.808,478,483,6096
1986,5242,99041,103949,802492,777100,13628,13.283,10925,10.648,184656,69980,114676,9.005,23.762,133021,52216,80805,6.719,17.118,51635,6.645,34.235,8048,8058,34666
1986,5259,754,958,10215,9927,116,12.360,77,8.205,2310,640,1670,6.447,23.271,1659,493,1166,4.967,16.713,651,6.558,33.426,39,39,256
1986,5311,96569,99889,536406,529738,14858,14.908,14413,14.461,128579,57928,70651,10.935,24.272,114208,54972,59236,10.377,21.559,14371,2.713,43.119,11538,11572,41103
1986,5312,34889,36595,208585,201681,6922,19.283,5525,15.391,59462,24439,35023,12.118,29.483,45458,19496,25962,9.667,22.540,14004,6.944,45.079,4255,4259,14251
1986,5313,24558,25688,273868,262368,4811,19.152,3675,14.630,71753,25460,46293,9.704,27.348,48358,19553,28805,7.453,18.431,23395,8.917,36.863,2839,2854,13003
1986,5321,5840,9564,140995,132053,1501,15.905,1248,13.224,39766,10725,29041,8.122,30.114,21601,9639,11962,7.299,16.358,18165,13.756,32.716,770,815,5586
1986,5322,17906,21515,169027,157359,6868,35.491,2541,13.131,56273,31204,25069,19.830,35.761,32990,15449,17541,9.818,20.965,23283,14.796,41.930,1704,1742,10360
1986,5323,3429,4315,33872,32764,914,22.230,507,12.331,9495,3877,5618,11.833,28.980,7154,2848,4306,8.692,21.835,2341,7.145,43.670,367,368,1915
1986,5324,7067,8487,102101,97443,1770,22.059,844,10.518,26484,10042,16442,10.306,27.179,17221,5685,11536,5.834,17.673,9263,9.506,35.346,556,557,3496
1986,5331,873,913,10764,10826,155,16.912,162,17.676,3194,1439,1755,13.292,29.503,3220,1584,1637,14.627,29.743,-26,-0.240,59.006,126,127,1039
1986,5411,126837,130928,799859,769551,15902,12.309,12436,9.626,160041,53190,106851,6.912,20.797,98576,38515,60061,5.005,12.810,61465,7.987,25.619,9215,9260,30136
1986,5412,59579,62671,484617,467938,10322,16.901,7127,11.670,100042,37736,62306,8.064,21.379,66452,25937,40515,5.543,14.201,33590,7.178,28.402,5213,5274,20007
1986,5413,55935,61364,808390,790796,10216,17.087,7067,11.820,170986,56830,114156,7.186,21.622,136438,37768,98670,4.776,17.253,34548,4.369,34.506,5074,5105,23627
1986,5414,14077,14322,99589,96873,2762,19.787,2036,14.586,24840,10274,14566,10.606,25.642,19411,7763,11648,8.014,20.038,5429,5.604,40.075,1619,1621,5903
1986,5415,12638,13956,139691,126085,5096,40.424,2397,19.014,53097,29886,23211,23.703,42.112,25622,12451,13171,9.875,20.321,27475,21.791,40.642,1849,1853,8875
1986,5416,38168,39452,334468,320807,9761,25.612,7080,18.577,109067,47713,61354,14.873,33.998,81614,38108,43506,11.879,25.440,27453,8.557,50.880,5471,5483,29285
1986,5417,6442,7832,442244,436438,1262,16.544,854,11.196,58193,12734,45459,2.918,13.334,45841,15109,30732,3.462,10.503,12352,2.830,21.007,548,551,5628
1986,5418,26141,28423,364153,357715,5007,18.040,3670,13.223,76942,28673,48269,8.016,21.509,63648,25777,37871,7.206,17.793,13294,3.716,35.586,2809,2818,17706
1986,5419,30420,33832,236014,228868,4456,13.415,3225,9.709,53469,18188,35281,7.947,23.362,39364,14284,25080,6.241,17.199,14105,6.163,34.399,2429,2440,9740
1986,5511,24503,44778,3071927,3040602,5055,11.422,4016,9.074,541071,171671,369400,5.646,17.795,476865,113968,362897,3.748,15.683,64206,2.112,31.366,902,957,10070
1986,5611,10539,11113,177558,165003,2502,23.484,1584,14.868,55259,23337,31922,14.143,33.490,30054,11052,19002,6.698,18.214,25205,15.276,36.429,1195,1200,7588
1986,5612,219,276,25505,22817,91,36.620,36,14.487,8027,4588,3439,20.108,35.181,2649,685,1964,3.002,11.610,5378,23.571,23.220,27,27,199
1986,5613,14227,18980,1023762,972694,4016,22.191,2251,12.438,305223,97277,207946,10.001,31.379,203817,48095,155722,4.945,20.954,101406,10.425,41.908,1532,1558,23672
1986,5614,18418,20798,226706,219193,3672,18.054,2753,13.536,53727,20681,33046,9.435,24.511,38924,16364,22560,7.466,17.758,14803,6.753,35.516,2108,2120,10102
1986,5615,22557,26270,200896,195956,4144,16.199,2767,10.816,46084,18345,27739,9.362,23.518,35923,14277,21646,7.286,18.332,10161,5.185,36.664,2011,2047,10017
1986,5616,11650,13963,452894,438752,2431,17.761,1879,13.728,99471,29868,69603,6.807,22.671,71468,26467,45001,6.032,16.289,28003,6.382,32.578,1423,1429,17686
1986,5617,69013,72246,911048,880356,16881,24.222,11773,16.893,243568,85373,158195,9.698,27.667,181525,64817,116708,7.363,20.619,62043,7.047,41.239,9134,9148,47332
1986,5619,12104,13065,187332,180998,2303,18.036,1711,13.400,45314,14741,30573,8.144,25.036,32406,10238,22168,5.656,17.904,12908,7.132,35.808,1302,1304,7256
1986,5621,5548,5674,109195,107766,780,13.824,717,12.707,17004,3804,13200,3.530,15.779,14137,5737,8400,5.324,13.118,2867,2.660,26.237,558,561,4256
1986,5622,2007,2592,55780,53582,260,9.992,280,10.761,10691,2835,7856,5.291,19.953,6259,2958,3301,5.521,11.681,4432,8.272,23.363,190,191,1450
1986,5629,4486,4751,44217,43646,781,16.727,617,13.215,10945,4384,6561,10.045,25.077,9913,3637,6276,8.333,22.713,1032,2.365,45.425,477,477,2875
1986,6111,13075,13551,392756,386565,660,4.873,644,4.755,41209,7014,34195,1.814,10.660,29173,6670,22503,1.725,7.547,12036,3.114,15.093,494,496,4869
1986,6112,432,567,38844,38154,64,11.647,29,5.278,5497,1307,4190,3.426,14.407,3957,793,3164,2.078,10.371,1540,4.036,20.742,17,18,708
1986,6113,2007,2316,942283,938086,82,3.513,118,5.056,79006,2404,76602,0.256,8.422,70751,5632,65119,0.600,7.542,8255,0.880,15.084,45,45,1875
1986,6114,2199,2592,45528,43327,568,22.959,332,13.420,11294,4352,6942,10.045,26.067,6881,2536,4345,5.853,15.882,4413,10.185,31.763,262,266,1947
1986,6115,4167,4894,56701,54488,699,14.534,530,11.020,13368,4241,9127,7.783,24.534,8952,3062,5890,5.620,16.429,4416,8.105,32.859,375,382,2048
1986,6116,11607,12152,106705,103961,2404,20.105,2015,16.851,26265,10559,15706,10.157,25.264,20839,9089,11750,8.743,20.045,5426,5.219,40.090,1610,1632,7295
1986,6117,1449,1490,13638,13573,284,19.372,236,16.098,3511,1165,2346,8.583,25.868,3300,1629,1671,12.002,24.313,211,1.555,48.626,182,183,1200
1986,6211,182948,190236,1182916,1150881,16151,8.558,13112,6.948,228274,77964,150310,6.774,19.835,164313,53333,110980,4.634,14.277,63961,5.558,28.554,10420,10476,40990
1986,6212,96735,99169,478372,469872,6586,6.691,5119,5.200,79052,23088,55964,4.914,16.824,61740,18129,43611,3.858,13.140,17312,3.684,26.279,3987,4028,14627
1986,6213,46639,48691,172570,166729,7204,15.231,4420,9.345,43713,19410,24303,11.642,26.218,31963,14595,17368,8.754,19.171,11750,7.047,38.341,3287,3326,10258
1986,6214,6378,8552,147002,141011,1607,19.783,749,9.221,35781,15805,19976,11.208,25.375,23784,8345,15439,5.918,16.867,11997,8.508,33.734,459,471,4426
1986,6215,4625,5858,79221,73785,1158,20.771,592,10.619,20789,8136,12653,11.027,28.175,9939,5048,4891,6.841,13.470,10850,14.705,26.940,415,431,2784
1986,6216,4806,6365,265597,247410,1288,21.087,774,12.672,77634,26493,51141,10.708,31.379,40671,8980,31691,3.630,16.439,36963,14.940,32.877,519,527,5441
1986,6219,4455,5133,93023,88731,1063,21.760,567,11.607,25708,9354,16354,10.542,28.973,16948,6662,10286,7.508,19.100,8760,9.873,38.201,389,390,4232
1986,6221,4033,5288,3196219,3200955,223,4.225,204,3.865,215121,85400,129721,2.668,6.721,222102,45333,176769,1.416,6.939,-6981,-0.218,13.441,128,129,38939
1986,6222,381,582,206320,199505,67,11.806,38,6.696,20414,7248,13166,3.633,10.232,6302,1841,4461,0.923,3.159,14112,7.074,6.318,28,28,1274
1986,6223,211,247,70987,69436,27,11.180,16,6.625,6263,2557,3706,3.683,9.020,2988,1352,1636,1.947,4.303,3275,4.717,8.606,6,6,1131
1986,6231,8266,12791,1079582,1050783,1167,9.255,804,6.376,163606,75211,88395,7.158,15.570,105161,41219,63942,3.923,10.008,58445,5.562,20.016,537,560,29279
1986,6232,4654,6581,156261,148253,1126,18.010,468,7.486,34455,14953,19502,10.086,23.241,18509,7110,11399,4.796,12.485,15946,10.756,24.970,334,343,5721
1986,6233,7873,9146,242247,236988,1494,16.772,1017,11.417,43905,18792,25113,7.930,18.526,33304,17104,16200,7.217,14.053,10601,4.473,28.106,684,701,12342
1986,6239,2947,3670,90262,86989,450,12.579,265,7.407,16138,6037,10101,6.940,18.552,9543,2743,6800,3.153,10.970,6595,7.581,21.941,170,177,1675
1986,6241,15028,20325,285253,278509,2524,12.762,1429,7.225,50806,15268,35538,5.482,18.242,37104,9673,27431,3.473,13.322,13702,4.920,26.645,868,877,5638
1986,6242,4299,5088,52549,50643,613,12.383,338,6.828,10690,3462,7228,6.836,21.109,6831,2470,4361,4.877,13.489,3859,7.620,26.977,198,198,1150
1986,6243,4129,6014,253913,249891,761,13.087,363,6.242,42993,10596,32397,4.240,17.205,35198,4891,30307,1.957,14.085,7795,3.119,28.171,180,199,2209
1986,6244,31416,37172,344437,334435,5364,14.699,4005,10.975,75495,31617,43878,9.454,22.574,55714,21351,34363,6.384,16.659,19781,5.915,33.318,3004,3051,14866
1986,7111,4499,4541,64346,63488,777,17.215,722,15.996,16551,5362,11189,8.446,26.070,14842,3984,10858,6.275,23.378,1709,2.692,46.756,537,537,3093
1986,7112,2144,2230,64280,64227,435,19.858,356,16.252,14357,3364,10993,5.238,22.354,14177,3000,11177,4.671,22.073,180,0.280,44.147,275,276,1404
1986,7113,1994,2034,35512,36004,399,19.861,349,17.372,7937,2376,5561,6.599,22.045,8923,3198,5725,8.882,24.783,-986,-2.739,44.090,266,266,1805
1986,7114,1145,1162,12428,11864,214,18.528,200,17.316,4123,1156,2967,9.744,34.754,2932,1360,1572,11.464,24.714,1191,10.039,49.429,150,150,946
1986,7115,10677,10714,66656,62250,3049,29.163,2531,24.209,27057,12314,14743,19.782,43.465,18556,9615,8941,15.446,29.809,8501,13.656,59.618,1971,1971,7225
1986,7121,2299,2452,41082,39706,233,9.648,159,6.584,5314,1052,4262,2.649,13.383,2568,529,2039,1.332,6.468,2746,6.916,12.935,109,109,374
1986,7131,1612,2165,59933,57724,415,19.249,397,18.414,10997,3803,7194,6.588,19.051,6522,3154,3368,5.464,11.299,4475,7.752,22.597,297,298,1665
1986,7132,747,766,20331,20339,143,19.054,112,14.923,3592,1691,1901,8.314,17.661,3571,1191,2380,5.856,17.557,21,0.103,35.115,88,88,869
1986,7139,32895,35246,516236,504358,5247,15.162,3968,11.466,108300,45903,62397,9.101,21.473,84618,30546,54072,6.056,16.777,23682,4.695,33.555,2960,2980,21235
1986,7211,29345,34222,1277529,1240150,5045,14.876,4428,13.057,274227,138169,136058,11.141,22.112,198523,84739,113784,6.833,16.008,75704,6.104,32.016,3205,3254,54594
1986,7212,3702,3977,24953,24660,507,12.816,465,11.754,6284,2006,4278,8.135,25.483,5684,1897,3787,7.693,23.050,600,2.433,46.100,328,329,1148
1986,7213,4303,4417,25187,24979,293,6.516,452,10.052,4508,1082,3426,4.332,18.047,4142,1833,2309,7.338,16.582,366,1.465,33.164,320,322,1462
1986,7223,12743,16858,315529,307014,3322,19.996,2832,17.047,84966,48203,36763,15.701,27.675,68381,29582,38799,9.635,22.273,16585,5.402,44.546,2077,2085,18455
1986,7224,53433,54188,317534,319071,8460,15.401,9944,18.103,88278,48890,39388,15.323,27.667,90995,45435,45560,14.240,28.519,-2717,-0.852,55.334,8000,8019,37768
1986,7225,203134,272112,5108419,4964000,49505,18.513,40095,14.994,1290613,753695,536918,15.183,25.999,1002318,443234,559084,8.929,20.192,288295,5.808,40.383,28927,29664,288424
1986,8111,103613,108866,549287,537221,18570,17.345,14958,13.972,135049,68242,66807,12.703,25.138,111120,50006,61114,9.308,20.684,23929,4.454,41.368,11582,11665,39866
1986,8112,10152,11631,89720,85416,1900,16.645,1467,12.852,23220,11391,11829,13.336,27.185,14566,5027,9539,5.885,17.053,8654,10.132,34.106,1114,1115,3181
1986,8113,19783,20871,156660,154009,2987,14.528,2365,11.503,32962,12037,20925,7.816,21.403,27874,9693,18181,6.294,18.099,5088,3.304,36.198,1756,1759,6732
1986,8114,23021,24565,148076,146512,4112,16.884,3690,15.152,30936,12451,18485,8.498,21.115,27611,10947,16664,7.472,18.846,3325,2.269,37.691,2784,2787,8248
1986,8121,79387,88153,471013,464861,13631,15.455,13717,15.553,108536,56031,52505,12.053,23.348,96188,47494,48694,10.217,20.692,12348,2.656,41.384,10539,10731,35871
1986,8122,17258,20084,119719,117915,1648,8.228,1539,7.684,19463,6208,13255,5.265,16.506,15802,5627,10175,4.772,13.401,3661,3.105,26.802,1064,1086,4020
1986,8123,32726,38789,355933,351655,5383,13.987,4778,12.415,66187,28277,37910,8.041,18.822,57483,24153,33330,6.868,16.346,8704,2.475,32.693,3528,3664,16530
1986,8129,14075,21638,218983,215361,4239,19.927,3509,16.495,51118,20550,30568,9.542,23.736,44452,20721,23731,9.622,20.641,6666,3.095,41.281,2171,2257,13391
1986,8131,124228,124331,979072,961401,8111,6.627,4245,3.468,127891,23927,103964,2.489,13.303,92352,12277,80075,1.277,9.606,35539,3.697,19.212,2156,2156,6109
1986,8132,7954,9017,124567,122132,1020,11.586,593,6.736,19750,5641,14109,4.619,16.171,14684,3628,11056,2.971,12.023,5066,4.148,24.046,395,403,2363
1986,8133,7257,8439,95781,92901,1034,12.521,672,8.138,18111,5598,12513,6.026,19.495,12451,3904,8547,4.202,13.402,5660,6.093,26.805,405,422,2121
1986,8134,28627,30035,268168,264288,2349,7.881,1889,6.338,38860,8798,30062,3.329,14.704,31182,6816,24366,2.579,11.799,7678,2.905,23.597,1255,1255,4546
1986,8139,56267,58608,476191,472007,5106,8.781,4183,7.194,81898,22859,59039,4.843,17.351,73627,17647,55980,3.739,15.599,8271,1.752,31.197,2876,2884,12327
1987,1131,218,229,2445,2416,48,22.069,25,11.494,577,274,303,11.343,23.887,518,187,331,7.742,21.445,59,2.443,42.890,18,19,169
1987,1132,82,97,1486,1433,20,21.858,9,9.836,373,69,304,4.815,26.029,270,49,221,3.419,18.842,103,7.188,37.683,6,6,16
1987,1133,10539,10619,85634,85383,1660,15.735,1521,14.418,22073,7627,14446,8.933,25.852,21315,7436,13879,8.709,24.964,758,0.888,49.928,1125,1125,5153
1987,1141,1084,1088,7556,7167,204,18.673,213,19.497,2902,972,1930,13.562,40.491,2114,958,1156,13.367,29.496,788,10.995,58.993,159,159,698
1987,1142,135,135,973,937,27,20.455,21,15.909,203,98,105,10.464,21.676,133,51,82,5.446,14.202,70,7.475,28.404,14,14,27
1987,1151,3706,4103,49035,49944,620,15.155,596,14.569,14518,5266,9252,10.544,29.069,16323,8055,8268,16.128,32.683,-1805,-3.614,58.137,406,407,3959
1987,1152,1910,1930,13858,13485,363,19.222,280,14.827,3613,1700,1913,12.607,26.794,2806,1026,1780,7.609,20.809,807,5.985,41.618,221,221,833
1987,1153,767,776,9871,9737,167,21.816,146,19.073,2910,1177,1733,12.088,29.886,2595,1016,1579,10.434,26.651,315,3.235,53.302,109,109,750
1987,2111,7297,8942,130532,142230,909,9.665,1836,19.520,19496,7354,12142,5.170,13.707,42920,15291,27629,10.751,30.176,-23424,-16.469,27.415,1204,1216,5416
1987,2121,2315,2896,147724,158308,507,17.082,651,21.934,23530,12617,10913,7.970,14.863,44377,20430,23947,12.905,28.032,-20847,-13.169,29.727,427,429,6688
1987,2122,483,615,35542,35711,140,22.932,131,21.458,8009,2702,5307,7.566,22.428,8537,2522,6015,7.062,23.906,-528,-1.479,44.855,62,63,243
1987,2123,3521,5004,102053,102777,473,9.399,530,10.532,16126,4488,11638,4.367,15.690,17596,6039,11557,5.876,17.121,-1470,-1.430,31.381,278,283,2424
1987,2131,8315,9765,162956,193482,1262,11.900,2942,27.742,30660,14267,16393,7.374,15.846,91515,31566,59949,16.315,47.299,-60855,-31.453,31.693,2061,2073,17203
1987,2211,1659,5958,603151,602181,202,3.408,140,2.362,33209,9914,23295,1.646,5.515,31467,3328,28139,0.553,5.226,1742,0.289,10.451,61,61,551
1987,2212,560,2436,140204,140021,125,5.114,142,5.809,8610,2342,6268,1.673,6.149,8334,3317,5017,2.369,5.952,276,0.197,11.904,49,51,338
1987,2213,3722,3999,30935,30557,327,8.212,293,7.358,4005,1702,2303,5.570,13.107,3251,1330,1921,4.353,10.639,754,2.468,21.278,203,203,717
1987,2361,105138,105528,626864,604754,24016,23.472,17595,17.196,223168,92865,130303,15.356,36.902,178556,77000,101556,12.732,29.525,44612,7.377,59.051,12799,12802,57223
1987,2362,37655,38376,687673,684697,5837,15.398,4900,12.926,187955,47503,140452,6.938,27.451,182433,54875,127558,8.014,26.644,5522,0.806,53.289,3598,3599,30653
1987,2371,13376,13661,299052,293808,1516,11.101,1506,11.028,70374,14226,56148,4.842,23.952,59779,16089,43690,5.476,20.346,10595,3.606,40.693,1096,1097,10338
1987,2372,9739,9897,75357,75397,2835,29.407,2322,24.086,28779,15703,13076,20.827,38.170,28703,16169,12534,21.445,38.069,76,0.101,76.139,1876,1879,12423
1987,2373,9628,9986,253071,252343,1226,12.343,1119,11.266,62247,11000,51247,4.359,24.668,61590,14497,47093,5.745,24.407,657,0.260,48.815,849,850,7922
1987,2379,4989,5050,87549,92247,879,17.468,843,16.753,22526,5748,16778,6.231,24.419,32305,14477,17828,15.694,35.020,-9779,-10.601,48.838,615,616,5895
1987,2381,75313,75756,728297,717214,13380,18.123,9527,12.904,215068,67733,147335,9.444,29.987,193097,57500,135597,8.017,26.923,21971,3.063,53.846,7173,7174,44322
1987,2382,113795,115760,1204500,1182064,17112,15.074,12629,11.125,285774,84266,201508,7.129,24.176,240469,71092,169377,6.014,20.343,45305,3.833,40.686,9666,9673,52370
1987,2383,77695,78126,657976,636749,16673,22.099,11314,14.996,208562,70153,138409,11.017,32.754,166071,54278,111793,8.524,26.081,42491,6.673,52.162,8420,8421,41086
1987,2389,39687,39922,344678,338560,7005,17.952,5201,13.329,103034,32742,70292,9.671,30.433,91205,33444,57761,9.878,26.939,11829,3.494,53.878,3823,3823,20215
1987,3111,1220,1823,48327,48484,106,5.786,124,6.769,5743,1893,3850,3.904,11.845,6084,1802,4282,3.717,12.548,-341,-0.703,23.690,72,75,619
1987,3112,475,819,64925,65590,46,5.600,51,6.208,4324,858,3466,1.308,6.592,5642,915,4727,1.395,8.602,-1318,-2.009,13.185,28,28,433
1987,3113,1544,1869,83510,82997,261,14.074,232,12.510,12105,2557,9548,3.081,14.585,10986,2521,8465,3.037,13.237,1119,1.348,26.473,150,150,1079
1987,3114,1140,1572,168110,166744,114,7.227,125,7.924,21884,3965,17919,2.378,13.124,18959,3692,15267,2.214,11.370,2925,1.754,22.740,85,87,1352
1987,3115,1559,2217,133840,133344,117,5.188,193,8.559,15229,3338,11891,2.503,11.421,14168,5731,8437,4.298,10.625,1061,0.796,21.250,123,124,2173
1987,3116,3877,4461,334829,334198,307,6.767,458,10.096,40137,8276,31861,2.476,12.010,38509,12389,26120,3.707,11.523,1628,0.487,23.046,333,334,4917
1987,3117,678,781,42664,41530,57,7.165,86,10.811,9059,2389,6670,5.752,21.813,6765,2182,4583,5.254,16.289,2294,5.524,32.579,61,61,893
1987,3118,8976,10552,301837,299846,1609,15.432,1358,13.025,41670,15172,26498,5.060,13.897,37474,16264,21210,5.424,12.498,4196,1.399,24.995,1002,1013,7543
1987,3119,1980,2346,129049,127323,226,9.619,233,9.917,17350,4460,12890,3.503,13.627,13843,4697,9146,3.689,10.872,3507,2.754,21.745,164,164,2701
1987,3121,1776,2250,145907,148902,218,9.589,265,11.656,14508,3778,10730,2.537,9.743,20112,8845,11267,5.940,13.507,-5604,-3.764,19.487,185,188,4802
1987,3122,96,133,33954,35233,7,5.109,15,10.949,1688,611,1077,1.734,4.791,4156,707,3449,2.007,11.796,-2468,-7.005,9.582,9,9,34
1987,3131,393,610,111120,108852,34,5.466,58,9.325,12912,1975,10937,1.814,11.862,8299,4103,4196,3.769,7.624,4613,4.238,15.248,33,34,1123
1987,3132,1587,1900,238975,241208,165,8.583,210,10.923,25443,6139,19304,2.545,10.548,30222,18370,11852,7.616,12.529,-4779,-1.981,21.096,127,131,3131
1987,3133,5471,6170,140622,139608,670,11.201,293,4.898,18277,4241,14036,3.038,13.092,16304,5140,11164,3.682,11.678,1973,1.413,23.357,153,153,2171
1987,3141,3728,4018,123782,123527,442,10.877,533,13.117,18681,4289,14392,3.472,15.123,18410,9024,9386,7.305,14.904,271,0.219,29.807,410,411,3557
1987,3149,3496,3608,109140,110529,460,12.676,502,13.833,17375,4925,12450,4.456,15.720,20002,8198,11804,7.417,18.097,-2627,-2.377,31.440,411,411,5044
1987,3151,1280,1392,138873,136563,157,11.267,160,11.482,20834,8529,12305,6.245,15.256,16224,5533,10691,4.052,11.880,4610,3.376,23.761,119,119,2458
1987,3152,11526,12917,800078,810064,2014,15.550,2083,16.083,128951,42468,86483,5.243,15.919,150398,65477,84921,8.083,18.566,-21447,-2.648,31.837,1684,1703,40200
1987,3159,1660,1735,56718,56666,214,12.121,275,15.576,9078,2072,7006,3.657,16.020,8990,3238,5752,5.714,15.865,88,0.155,31.730,238,239,2691
1987,3161,308,338,15231,15004,16,4.578,39,11.159,2106,523,1583,3.486,14.037,1630,572,1058,3.812,10.864,476,3.173,21.728,30,30,318
1987,3162,382,515,78866,82449,34,6.302,83,15.385,6565,901,5664,1.093,7.962,13894,5572,8322,6.758,16.852,-7329,-8.889,15.925,51,52,985
1987,3169,1122,1168,36175,37141,124,10.522,145,12.304,5436,1413,4023,3.804,14.636,7523,3409,4114,9.179,20.256,-2087,-5.619,29.273,100,101,1701
1987,3211,4514,4996,139881,137244,465,9.190,593,11.719,21775,6367,15408,4.639,15.866,16136,7810,8326,5.691,11.757,5639,4.109,23.514,415,417,4203
1987,3212,1260,1560,102232,99752,154,9.958,127,8.212,13088,3308,9780,3.316,13.121,8212,2933,5279,2.940,8.232,4876,4.888,16.465,82,82,1255
1987,3219,8908,9551,274976,273668,1265,13.354,1108,11.697,49204,12592,36612,4.601,17.979,46643,24982,21661,9.129,17.044,2561,0.936,34.087,824,829,13526
1987,3221,209,521,188214,188846,17,3.250,21,4.015,8250,2656,5594,1.406,4.369,9453,3048,6405,1.614,5.006,-1203,-0.637,8.737,10,10,1044
1987,3222,3563,5112,384357,383781,313,6.113,330,6.445,34591,8762,25829,2.283,9.013,33593,9853,23740,2.567,8.753,998,0.260,17.506,217,218,4227
1987,3231,39929,41670,797309,789266,5076,12.393,3653,8.919,108054,31469,76585,3.987,13.690,92073,31697,60376,4.016,11.666,15981,2.025,23.331,2897,2900,21902
1987,3241,1274,2126,113645,116649,193,8.975,242,11.253,8881,1754,7127,1.504,7.613,14916,6224,8692,5.336,12.787,-6035,-5.174,15.227,111,114,1438
1987,3251,1081,2185,217873,225519,156,7.022,229,10.308,9713,2188,7525,0.970,4.307,25036,11515,13521,5.106,11.102,-15323,-6.795,8.614,74,75,809
1987,3252,348,595,124857,125770,54,9.114,49,8.270,9176,1976,7200,1.571,7.296,11126,4420,6706,3.514,8.846,-1950,-1.550,14.592,22,23,1023
1987,3253,632,917,42106,43706,50,5.258,118,12.408,3441,985,2456,2.254,7.873,6641,2685,3956,6.143,15.195,-3200,-7.322,15.746,49,49,570
1987,3254,1027,1268,157325,158710,114,8.917,135,10.559,15744,2990,12754,1.884,9.920,18166,7061,11105,4.449,11.446,-2422,-1.526,19.840,71,71,1059
1987,3255,1607,2104,75274,76216,130,6.123,168,7.913,7969,2018,5951,2.648,10.456,9904,2538,7366,3.330,12.995,-1935,-2.539,20.912,108,108,1117
1987,3256,2027,2270,114754,114918,205,8.946,248,10.823,13645,4695,8950,4.086,11.874,13947,2930,11017,2.550,12.137,-302,-0.263,23.747,188,189,1628
1987,3259,2056,2619,134926,139195,217,8.238,247,9.377,11119,2435,8684,1.749,7.988,19303,6992,12311,5.023,13.868,-8184,-5.880,15.976,115,115,1456
1987,3261,9623,11399,614131,604810,1078,9.469,1049,9.214,89961,24878,65083,4.113,14.874,71225,23952,47273,3.960,11.776,18736,3.098,23.553,726,732,11408
1987,3262,2060,2510,188719,188320,267,10.775,203,8.192,18556,7920,10636,4.206,9.853,18159,4990,13169,2.650,9.643,397,0.211,19.285,125,127,1791
1987,3271,1373,1649,78781,77728,212,12.939,191,11.657,10909,1980,8929,2.547,14.035,8675,3293,5382,4.237,11.161,2234,2.874,22.322,129,129,1149
1987,3272,1595,1855,139494,138846,201,10.862,192,10.376,13037,2133,10904,1.536,9.390,12041,3729,8312,2.686,8.672,996,0.717,17.344,124,124,1304
1987,3273,6711,8951,189570,189151,713,7.932,788,8.767,32907,9463,23444,5.003,17.397,32282,11169,21113,5.905,17.067,625,0.330,34.134,467,480,4818
1987,3274,242,338,17658,18145,34,9.971,40,11.730,1245,408,837,2.249,6.861,2282,1211,1071,6.674,12.576,-1037,-5.715,13.723,23,23,107
1987,3279,1862,2151,74637,76575,221,10.289,215,10.009,7468,2299,5169,3.002,9.753,11412,3761,7651,4.912,14.903,-3944,-5.151,19.505,143,145,1698
1987,3311,343,410,166348,175256,57,14.074,47,11.605,14764,10130,4634,5.780,8.424,32788,12936,19852,7.381,18.709,-18024,-10.284,16.848,21,21,1358
1987,3312,510,691,61714,63019,69,10.095,54,7.901,6520,3322,3198,5.271,10.346,9136,3894,5242,6.179,14.497,-2616,-4.151,20.692,21,21,627
1987,3313,316,460,82765,84515,33,7.143,37,8.009,5336,2002,3334,2.369,6.314,8943,2601,6342,3.078,10.582,-3607,-4.268,12.627,10,10,344
1987,3314,747,915,80035,82090,98,10.705,99,10.814,6322,1932,4390,2.354,7.701,10645,4475,6170,5.451,12.968,-4323,-5.266,15.403,49,51,731
1987,3315,2494,2750,202342,208623,170,6.077,265,9.473,18530,5838,12692,2.798,8.882,30959,8358,22601,4.006,14.840,-12429,-5.958,17.764,182,184,4536
1987,3321,3272,3482,137567,139436,250,7.199,231,6.652,15950,4394,11556,3.151,11.439,19750,6461,13289,4.634,14.164,-3800,-2.725,22.878,146,146,2563
1987,3322,1268,1397,76145,77270,88,6.257,107,7.608,6503,1306,5197,1.690,8.416,8669,2574,6095,3.331,11.219,-2166,-2.803,16.832,68,68,750
1987,3323,9946,10725,330387,336124,871,8.099,931,8.656,44545,13436,31109,3.997,13.253,55789,16822,38967,5.005,16.598,-11244,-3.345,26.505,669,684,8108
1987,3324,1498,1835,113812,118402,138,7.508,144,7.835,11570,2756,8814,2.328,9.772,20596,5426,15170,4.583,17.395,-9026,-7.623,19.544,88,90,1976
1987,3325,938,1017,70476,72863,54,5.261,73,7.112,4341,483,3858,0.663,5.958,9092,3378,5714,4.636,12.478,-4751,-6.520,11.916,49,49,574
1987,3326,1539,1743,66856,67393,113,6.382,168,9.489,7679,1972,5707,2.926,11.394,8825,3150,5675,4.674,13.095,-1146,-1.700,22.789,119,119,1721
1987,3327,20912,21184,303425,306464,2334,11.082,2090,9.923,41153,12926,28227,4.218,13.428,47274,14742,32532,4.810,15.426,-6121,-1.997,26.857,1577,1581,10676
1987,3328,5473,5811,149504,147568,415,7.099,485,8.296,22766,4078,18688,2.763,15.428,18973,5271,13702,3.572,12.857,3793,2.570,25.714,371,371,3609
1987,3329,6170,6666,346703,352691,707,10.660,639,9.635,34090,9844,24246,2.791,9.666,46041,14079,31962,3.992,13.054,-11951,-3.389,19.331,438,441,5256
1987,3331,2863,3126,185247,193530,269,8.409,415,12.973,23249,5871,17378,3.034,12.013,40269,14319,25950,7.399,20.808,-17020,-8.795,24.026,237,237,2429
1987,3332,3987,4230,159228,163202,322,7.608,327,7.726,17726,5116,12610,3.135,10.861,25385,5399,19986,3.308,15.554,-7659,-4.693,21.723,230,230,2329
1987,3333,2156,2272,145453,150222,201,8.866,191,8.425,12334,4023,8311,2.678,8.211,21594,5938,15656,3.953,14.375,-9260,-6.164,16.421,120,120,1937
1987,3334,1616,1849,158165,159790,126,6.653,216,11.404,14753,2581,12172,1.615,9.233,18266,7064,11202,4.421,11.431,-3513,-2.199,18.465,155,158,2290
1987,3335,9182,9529,210372,216306,645,6.723,776,8.088,23210,6691,16519,3.093,10.730,35119,9721,25398,4.494,16.236,-11909,-5.506,21.460,576,577,4633
1987,3336,747,893,127830,131007,46,5.061,78,8.581,9969,5033,4936,3.842,7.610,16470,4894,11576,3.736,12.572,-6501,-4.962,15.219,40,41,697
1987,3339,5287,5861,304324,314763,485,8.231,548,9.300,26724,8526,18198,2.709,8.490,47275,14380,32895,4.569,15.019,-20551,-6.529,16.980,371,373,5910
1987,3341,1487,1620,275627,285610,264,16.241,275,16.918,26512,6390,20122,2.237,9.283,46834,16686,30148,5.842,16.398,-20322,-7.115,18.565,194,194,3132
1987,3342,1358,1547,243381,257527,163,10.294,236,14.904,22072,7698,14374,2.989,8.571,51077,21030,30047,8.166,19.834,-29005,-11.263,17.142,150,156,4633
1987,3343,361,381,29640,30004,38,9.857,47,12.192,3446,640,2806,2.133,11.485,4123,2533,1590,8.442,13.742,-677,-2.256,22.971,30,30,250
1987,3344,4348,4938,509654,515651,586,11.784,656,13.191,56617,16729,39888,3.244,10.980,69100,27900,41200,5.411,13.401,-12483,-2.421,21.959,428,432,5834
1987,3345,4374,5003,675158,681244,500,10.057,437,8.790,52491,16447,36044,2.414,7.705,65255,19924,45331,2.925,9.579,-12764,-1.874,15.410,265,267,6890
1987,3346,687,727,39025,37748,127,17.862,95,13.361,6743,1619,5124,4.289,17.863,4157,856,3301,2.268,11.013,2586,6.851,22.025,72,72,609
1987,3351,1175,1304,85802,86439,100,7.544,143,10.788,9052,2349,6703,2.718,10.472,10340,2938,7402,3.399,11.962,-1288,-1.490,20.944,91,91,1056
1987,3352,307,395,111273,111650,30,7.463,44,10.945,10538,1454,9084,1.302,9.438,11399,6898,4501,6.178,10.210,-861,-0.771,18.877,24,24,530
1987,3353,2087,2542,229186,235014,194,7.642,187,7.367,19193,5707,13486,2.428,8.167,31330,9827,21503,4.181,13.331,-12137,-5.164,16.334,79,79,1546
1987,3359,2270,2643,203161,208985,259,9.814,251,9.511,19616,6532,13084,3.126,9.386,31387,11659,19728,5.579,15.019,-11771,-5.632,18.773,135,139,2544
1987,3361,222,278,248377,256738,44,16.029,37,13.479,22594,4948,17646,1.927,8.800,40334,12125,28209,4.723,15.710,-17740,-6.910,17.601,26,26,228
1987,3362,1842,2034,118479,117060,224,11.026,219,10.780,17557,4352,13205,3.718,14.998,14585,5855,8730,5.002,12.459,2972,2.539,24.919,166,168,1989
1987,3363,3826,4638,659014,666718,398,8.576,404,8.705,52074,14605,37469,2.191,7.810,68289,12329,55960,1.849,10.243,-16215,-2.432,15.621,292,292,4999
1987,3364,1370,1656,688943,682200,129,7.788,130,7.848,68888,21370,47518,3.133,10.098,53709,13079,40630,1.917,7.873,15179,2.225,15.746,94,95,1466
1987,3365,164,186,24560,26555,14,7.427,19,10.080,1874,482,1392,1.815,7.057,5805,719,5086,2.708,21.860,-3931,-14.803,14.114,10,10,63
1987,3366,1203,1282,155685,157507,149,11.695,133,10.440,17862,3031,14831,1.924,11.340,21997,3807,18190,2.417,13.966,-4135,-2.625,22.681,82,82,900
1987,3369,478,492,30724,30797,73,14.913,68,13.892,3325,1049,2276,3.406,10.797,3435,1539,1896,4.997,11.154,-110,-0.357,21.593,55,55,599
1987,3371,13267,13984,392286,386590,1993,14.401,1703,12.306,59714,15623,44091,4.041,15.446,48557,20126,28431,5.206,12.560,11157,2.886,25.121,1303,1310,13330
1987,3372,2868,3029,151272,150349,334,11.146,269,8.977,20114,5526,14588,3.675,13.378,18163,5302,12861,3.526,12.081,1951,1.298,24.161,212,212,3250
1987,3379,1063,1215,41556,41131,114,9.406,108,8.911,5842,2421,3421,5.886,14.203,5067,1406,3661,3.418,12.319,775,1.884,24.638,86,86,1152
1987,3391,10427,10947,234049,231533,1277,11.729,1159,10.645,34042,9963,24079,4.303,14.703,28836,11276,17560,4.870,12.454,5206,2.248,24.909,852,856,4370
1987,3399,14980,15509,389634,388267,2092,13.597,1846,11.998,61039,16054,44985,4.135,15.721,57978,21481,36497,5.533,14.933,3061,0.788,29.865,1400,1402,10700
1987,4231,18951,22397,260233,261162,2430,10.803,2624,11.665,44586,14197,30389,5.436,17.072,46360,17853,28507,6.836,17.751,-1774,-0.679,34.144,1714,1749,10544
1987,4232,7730,8794,107010,105437,1254,14.353,1140,13.048,21454,7294,14160,6.918,20.348,18418,7360,11058,6.981,17.468,3036,2.879,34.937,809,819,4078
1987,4233,7916,10018,129871,126395,1375,13.859,1182,11.914,28095,9770,18325,7.730,22.228,21449,8395,13054,6.642,16.970,6646,5.258,33.940,788,799,5133
1987,4234,24472,33779,600987,594088,5045,15.148,4097,12.301,121107,56684,64423,9.541,20.385,105036,48853,56183,8.223,17.680,16071,2.705,35.360,2263,2356,15904
1987,4235,6857,9017,129800,133676,972,10.702,1102,12.134,19877,7299,12578,5.460,14.870,27349,9882,17467,7.393,20.459,-7472,-5.590,29.739,573,591,4077
1987,4236,15178,21380,296986,301122,2609,12.162,2754,12.838,58372,18601,39771,6.177,19.385,66771,27401,39370,9.100,22.174,-8399,-2.789,38.770,1441,1498,9248
1987,4237,10675,14228,152988,152965,1352,9.525,1283,9.039,23664,6821,16843,4.459,15.470,23665,7953,15712,5.199,15.471,-1,-0.001,30.941,789,816,4960
1987,4238,46719,60640,636672,637737,5826,9.555,6498,10.657,106936,34159,72777,5.356,16.768,109063,39411,69652,6.180,17.102,-2127,-0.334,33.536,3683,3776,19402
1987,4239,24638,26278,247948,243701,4251,16.348,3700,14.229,56233,20160,36073,8.272,23.075,47848,20108,27740,8.251,19.634,8385,3.441,39.268,2782,2804,13407
1987,4241,8317,11089,165432,160292,1193,10.865,975,8.880,30005,6671,23334,4.162,18.719,19884,8152,11732,5.086,12.405,10121,6.314,24.810,605,610,3667
1987,4242,2939,3844,106176,103614,585,15.399,495,13.030,20970,7919,13051,7.643,20.239,15689,6249,9440,6.031,15.142,5281,5.097,30.284,320,322,2256
1987,4243,7988,8560,110695,107887,1559,17.900,1858,21.333,29319,10066,19253,9.330,27.176,23671,11819,11852,10.955,21.941,5648,5.235,43.881,1417,1433,7527
1987,4244,27430,33772,673070,664560,4213,12.489,4134,12.255,122882,39586,83296,5.957,18.491,105546,40074,65472,6.030,15.882,17336,2.609,31.764,2933,2981,21928
1987,4245,7198,10096,88635,88397,674,6.575,984,9.599,15807,4383,11424,4.958,17.882,15459,5280,10179,5.973,17.488,348,0.394,34.976,586,608,3294
1987,4246,7469,10706,126876,125840,1247,11.605,1325,12.331,25128,8713,16415,6.924,19.968,23330,9274,14056,7.370,18.539,1798,1.429,37.079,613,633,2760
1987,4247,9775,12761,142589,140680,1145,8.875,1426,11.053,29295,9237,20058,6.566,20.824,25551,9306,16245,6.615,18.162,3744,2.661,36.325,769,797,4783
1987,4248,4054,5155,141870,139732,366,6.951,587,11.148,20942,7066,13876,5.057,14.987,16667,7664,9003,5.485,11.928,4275,3.059,23.856,392,413,4899
1987,4249,18970,22840,260492,257455,3190,14.037,2961,13.029,49731,16752,32979,6.507,19.316,43250,15893,27357,6.173,16.799,6481,2.517,33.598,2023,2033,8584
1987,4251,29539,31918,293508,292617,4069,12.845,3589,11.330,58727,21640,37087,7.395,20.070,57113,24245,32868,8.286,19.518,1614,0.552,39.036,2240,2252,12935
1987,4411,38459,40096,983804,963112,5023,12.657,4202,10.588,157380,64218,93162,6.668,16.341,116167,46386,69781,4.816,12.062,41213,4.279,24.123,3369,3389,36847
1987,4412,11467,12058,90222,87792,1524,12.714,1381,11.521,21275,7626,13649,8.686,24.233,16439,6955,9484,7.922,18.725,4836,5.508,37.450,1066,1082,5451
1987,4413,44431,62266,457424,452518,6642,10.712,6121,9.872,87328,36047,51281,7.966,19.298,77501,30761,46740,6.798,17.127,9827,2.172,34.253,3848,3977,19259
1987,4421,21900,27576,235022,231833,3437,12.496,3293,11.973,48233,17954,30279,7.744,20.805,42155,16677,25478,7.194,18.183,6078,2.622,36.367,2170,2281,10555
1987,4422,22888,28313,175048,168325,4413,15.892,3324,11.970,46250,19248,27002,11.435,27.477,32516,14507,18009,8.618,19.317,13734,8.159,38.635,2220,2283,8393
1987,4431,28874,42710,296707,294832,6020,14.033,6399,14.916,75555,34649,40906,11.752,25.626,72067,33391,38676,11.325,24.443,3488,1.183,48.887,3889,4155,18966
1987,4441,56582,73393,797881,778671,6921,9.432,6889,9.389,153659,54771,98888,7.034,19.733,116062,49962,66100,6.416,14.905,37597,4.828,29.810,4552,4654,24338
1987,4442,17664,21583,162307,161077,2422,11.304,2109,9.843,31920,11433,20487,7.098,19.817,29463,10893,18570,6.763,18.291,2457,1.525,36.583,1434,1446,5675
1987,4451,62507,94533,2157448,2103335,11971,12.585,13152,13.826,393566,181774,211792,8.642,18.712,286536,128687,157849,6.118,13.623,107030,5.089,27.246,8018,8219,54047
1987,4452,22242,26167,168864,168819,4335,16.447,4717,17.896,43366,21581,21785,12.784,25.688,43102,22425,20677,13.283,25.531,264,0.156,51.063,3287,3369,14899
1987,4453,27327,32353,157421,160532,3591,10.952,4464,13.614,31763,12653,19110,7.882,19.786,37822,16316,21506,10.164,23.560,-6059,-3.774,39.572,3302,3352,11970
1987,4461,50037,76622,709432,685224,7778,10.236,6506,8.562,148472,53891,94581,7.865,21.668,99137,38312,60825,5.591,14.468,49335,7.200,28.936,4137,4259,22138
1987,4471,88226,136021,959660,942594,16844,12.407,16332,12.030,227833,99677,128156,10.575,24.171,193128,83234,109894,8.830,20.489,34705,3.682,40.978,10367,10619,48739
1987,4481,55101,101768,919322,906700,15784,15.750,12681,12.654,213162,110509,102653,12.188,23.510,188101,68534,119567,7.559,20.746,25061,2.764,41.491,7361,7863,31309
1987,4482,11333,36881,200131,200048,4281,11.632,4126,11.211,43293,19952,23341,9.974,21.641,42372,16623,25749,8.310,21.181,921,0.460,42.362,1779,2045,7974
1987,4483,18850,27915,171713,164374,3649,13.175,3211,11.594,45861,15981,29880,9.722,27.900,30263,13186,17077,8.022,18.411,15598,9.489,36.822,1989,2065,7744
1987,4511,32002,41586,292676,284939,6428,15.560,5880,14.233,71485,31760,39725,11.146,25.088,55603,24377,31226,8.555,19.514,15882,5.574,39.028,4075,4221,15176
1987,4512,8031,12249,82369,80880,1771,14.627,1489,12.298,17875,7396,10479,9.144,22.101,15140,6592,8548,8.150,18.719,2735,3.382,37.438,950,985,3890
1987,4522,249,6427,1123339,1121722,372,5.801,343,5.349,112477,49255,63222,4.391,10.027,109569,25573,83996,2.280,9.768,2908,0.259,19.536,34,41,1554
1987,4523,13116,28837,851258,853146,3044,10.539,3135,10.854,108352,54077,54275,6.339,12.700,112633,39482,73151,4.628,13.202,-4281,-0.502,25.401,1714,1753,8948
1987,4531,22755,24240,122799,122575,3457,14.337,3202,13.279,26526,10600,15926,8.648,21.641,26177,10609,15568,8.655,21.356,349,0.285,42.712,2425,2448,7897
1987,4532,29451,36470,225420,226135,6442,18.095,4703,13.210,56021,24919,31102,11.020,24.773,56808,31028,25780,13.721,25.121,-787,-0.348,49.547,3345,3407,12875
1987,4533,8458,10529,55208,54638,1692,16.157,1579,15.078,12093,4995,7098,9.142,22.133,10873,4790,6083,8.767,19.900,1220,2.233,39.801,1212,1215,3459
1987,4539,21234,24874,129364,128357,4635,18.457,5111,20.353,36631,16989,19642,13.236,28.538,34768,18677,16091,14.551,27.087,1863,1.451,54.174,3480,3664,13435
1987,4541,5333,6617,99063,95460,954,14.463,912,13.827,22565,7415,15150,7.768,23.638,15336,7124,8212,7.463,16.065,7229,7.573,32.131,680,684,4239
1987,4542,3882,4846,71639,72278,607,12.458,660,13.545,13011,4619,8392,6.391,18.001,14397,5684,8713,7.864,19.919,-1386,-1.918,36.003,417,419,2452
1987,4543,16969,23025,228005,222883,2307,9.998,2407,10.431,46855,14125,32730,6.337,21.022,37001,12697,24304,5.697,16.601,9854,4.421,33.202,1667,1683,7724
1987,4811,782,2701,356737,349132,321,11.405,548,19.471,49311,6886,42425,1.972,14.124,32808,18332,14476,5.251,9.397,16503,4.727,18.794,152,162,1811
1987,4812,421,776,15507,20766,147,19.241,123,16.099,4977,2262,2715,10.893,23.967,15543,12792,2751,61.601,74.848,-10566,-50.881,47.934,79,79,1028
1987,4831,311,603,31231,31698,80,12.924,112,18.094,7789,3001,4788,9.467,24.573,8773,3261,5512,10.288,27.677,-984,-3.104,49.145,43,43,843
1987,4832,308,343,13440,12947,34,9.551,60,16.854,2846,248,2598,1.916,21.983,1881,619,1262,4.781,14.529,965,7.454,29.058,39,39,277
1987,4841,24611,30828,584068,569783,5692,18.679,4982,16.349,121909,44669,77240,7.840,21.396,93478,42176,51302,7.402,16.406,28431,4.990,32.812,3452,3468,19066
1987,4842,40621,44104,457311,454924,8090,18.567,7024,16.121,104360,38214,66146,8.400,22.940,99611,43863,55748,9.642,21.896,4749,1.044,43.792,5274,5294,30301
1987,4851,353,380,31545,30193,32,8.333,40,10.417,3727,382,3345,1.265,12.344,1092,326,766,1.080,3.617,2635,8.727,7.234,35,35,321
1987,4852,336,626,20605,20944,74,11.802,76,12.121,3154,1083,2071,5.171,15.060,3865,1399,2466,6.680,18.454,-711,-3.395,30.119,38,38,588
1987,4853,4959,5011,52790,52666,915,18.220,937,18.658,11219,4333,6886,8.227,21.302,10903,5156,5747,9.790,20.702,316,0.600,41.405,770,770,4175
1987,4854,3246,3533,102748,100313,341,9.666,331,9.382,18670,6356,12314,6.336,18.612,13579,6222,7357,6.203,13.537,5091,5.075,27.073,265,268,5260
1987,4855,690,749,17505,16686,127,17.338,94,12.833,4310,1658,2652,9.936,25.830,2618,971,1647,5.819,15.690,1692,10.140,31.380,75,75,785
1987,4859,1195,1241,28821,28380,258,21.366,191,15.818,5550,1905,3645,6.713,19.556,4614,2249,2365,7.925,16.258,936,3.298,32.516,164,164,1782
1987,4861,58,289,9158,9691,27,9.359,26,9.012,995,259,736,2.673,10.268,1992,698,1294,7.203,20.556,-997,-10.288,20.536,3,3,23
1987,4862,251,1315,58050,57727,68,5.148,80,6.056,6096,1201,4895,2.081,10.560,5480,1170,4310,2.027,9.493,616,1.067,18.986,26,26,259
1987,4869,68,344,7547,8510,14,3.972,31,8.794,477,174,303,2.045,5.605,2381,411,1970,4.830,27.980,-1904,-22.375,11.211,8,8,33
1987,4871,213,216,4402,4097,46,21.296,46,21.296,1498,491,1007,11.986,36.568,802,486,316,11.864,19.578,696,16.990,39.155,32,32,187
1987,4872,748,759,6453,6136,160,21.607,123,16.610,1969,790,1179,12.876,32.092,1374,525,849,8.557,22.394,595,9.698,44.789,96,96,379
1987,4879,46,81,1433,1306,26,33.333,20,25.641,558,440,118,33.691,42.726,285,180,105,13.783,21.822,273,20.904,43.645,14,14,82
1987,4881,2123,2752,70140,69149,421,15.444,369,13.536,14231,5595,8636,8.091,20.580,12123,4718,7405,6.823,17.532,2108,3.048,35.063,253,253,1907
1987,4882,362,515,12613,11942,99,20.204,49,10.000,3177,1596,1581,13.365,26.604,1863,972,891,8.139,15.600,1314,11.003,31.201,31,31,316
1987,4883,2196,2603,89277,90777,353,13.491,380,14.523,23648,6882,16766,7.581,26.051,26516,10000,16516,11.016,29.210,-2868,-3.159,52.102,259,262,6304
1987,4884,3200,3447,26100,25669,716,21.174,585,17.300,7194,3746,3448,14.594,28.027,6336,3471,2865,13.522,24.684,858,3.343,49.368,397,406,1970
1987,4885,6502,8617,101747,98857,1584,18.993,1030,12.350,25338,10631,14707,10.754,25.631,19600,8122,11478,8.216,19.827,5738,5.804,39.653,678,745,5420
1987,4889,513,520,5769,5422,151,31.756,62,13.039,1650,632,1018,11.657,30.434,964,232,732,4.279,17.781,686,12.653,35.562,49,49,171
1987,4921,2029,3421,298383,274561,723,22.049,439,13.388,70947,16374,54573,5.964,25.840,24037,5851,18186,2.131,8.755,46910,17.085,17.509,237,239,1317
1987,4922,3368,3607,52328,51588,804,23.840,335,9.933,12764,4427,8337,8.582,24.742,11085,1514,9571,2.935,21.488,1679,3.255,42.976,274,274,1260
1987,4931,5687,9296,396848,395848,1057,11.428,963,10.412,71091,26086,45005,6.590,17.959,68435,29224,39211,7.383,17.288,2656,0.671,34.576,361,368,4362
1987,5111,13721,15963,671285,668901,1759,11.001,1812,11.332,72728,22411,50317,3.350,10.873,67723,29118,38605,4.353,10.125,5005,0.748,20.249,1385,1392,12367
1987,5112,2680,3060,63653,65888,662,18.693,1625,45.885,17197,6814,10383,10.342,26.101,21484,15616,5868,23.701,32.607,-4287,-6.507,52.201,1084,1095,7293
1987,5121,9387,14003,218341,226158,2324,16.533,2431,17.294,47519,18568,28951,8.210,21.011,62460,17332,45128,7.664,27.618,-14941,-6.606,42.023,1351,1415,8369
1987,5122,1960,1968,12931,13236,479,24.143,511,25.756,4473,2077,2396,15.693,33.795,5052,3231,1821,24.412,38.170,-579,-4.375,67.591,406,406,2220
1987,5151,6088,7442,233889,236674,1253,16.891,1205,16.244,46708,28526,18182,12.053,19.735,51604,28142,23462,11.891,21.804,-4896,-2.069,39.470,932,966,18371
1987,5152,10,18,1048,787,12,82.759,5,34.483,563,452,111,57.470,71.583,49,30,19,3.814,6.230,514,65.353,12.460,4,4,25
1987,5173,3380,19234,908371,902702,3447,18.982,1297,7.142,226973,152391,74582,16.882,25.144,216283,31501,184782,3.490,23.960,10690,1.184,47.919,472,496,6324
1987,5174,629,1352,72580,72481,197,14.533,204,15.050,15775,7813,7962,10.779,21.764,15528,6958,8570,9.600,21.424,247,0.341,42.847,124,128,3489
1987,5179,1375,3124,79338,81868,600,19.531,496,16.146,19044,10878,8166,13.287,23.262,23959,8464,15495,10.339,29.266,-4915,-6.004,46.524,307,311,5091
1987,5182,5469,7165,241721,238479,1132,15.671,1249,17.291,55045,22038,33007,9.241,23.082,48497,22065,26432,9.252,20.336,6548,2.746,40.672,643,651,5547
1987,5191,2279,2743,35960,35690,315,11.467,323,11.758,5162,2019,3143,5.657,14.463,4645,2324,2321,6.512,13.015,517,1.449,26.030,238,239,1159
1987,5211,46,84,24588,24882,4,4.819,D,D,602,194,408,0.780,2.419,1169,D,1147,D,4.698,-567,-2.279,4.839,0,0,0
1987,5221,19126,73604,2030666,2022316,3787,5.167,3165,4.318,253634,66511,187123,3.289,12.542,235561,57488,178073,2.843,11.648,18073,0.894,23.296,965,1188,23483
1987,5222,21675,40420,518623,487056,4140,10.291,3757,9.339,129768,57607,72161,11.828,26.643,68152,32379,35773,6.648,13.993,61616,12.651,27.985,1846,1920,12098
1987,5223,4451,4955,65096,61096,1201,25.050,880,18.354,20155,7740,12415,12.669,32.989,12123,7623,4500,12.477,19.843,8032,13.147,39.685,670,672,5008
1987,5231,6625,13578,369072,350136,2053,15.521,1351,10.214,72988,18827,54161,5.377,20.846,34777,9302,25475,2.657,9.932,38211,10.913,19.865,919,924,5850
1987,5232,110,123,7012,6852,18,14.938,13,10.788,681,81,600,1.182,9.939,349,204,145,2.977,5.093,332,4.845,10.187,12,12,202
1987,5239,15362,15959,188281,174254,3903,25.284,2858,18.515,69324,33215,36109,19.061,39.783,41430,21767,19663,12.492,23.776,27894,16.008,47.551,2266,2269,13573
1987,5241,6756,33386,1354322,1351379,4667,14.503,2254,7.004,181638,44782,136856,3.314,13.441,172887,34029,138858,2.518,12.793,8751,0.648,25.587,501,512,4278
1987,5242,101155,106126,923156,879724,14145,13.496,11507,10.979,226419,91410,135009,10.391,25.738,139063,54691,84372,6.217,15.808,87356,9.930,31.615,8619,8636,34853
1987,5259,868,1084,12684,12200,165,15.759,91,8.691,3006,951,2055,7.795,24.640,1981,1039,942,8.517,16.238,1025,8.402,32.477,69,69,676
1987,5311,94691,98280,538567,535511,14134,14.294,15330,15.504,130682,60637,70045,11.323,24.403,124622,62553,62069,11.681,23.272,6060,1.132,46.543,12706,12744,47537
1987,5312,36307,38233,221564,215836,7586,20.252,6037,16.117,61906,28652,33254,13.275,28.682,50646,24129,26517,11.179,23.465,11260,5.217,46.930,4713,4727,17862
1987,5313,25759,27044,300332,288710,5241,19.830,4013,15.184,79935,32847,47088,11.377,27.687,56351,24579,31772,8.513,19.518,23584,8.169,39.036,3109,3120,16757
1987,5321,6132,10124,135113,139033,1768,17.655,1548,15.458,30132,14976,15156,10.772,21.673,38892,12391,26501,8.912,27.973,-8760,-6.301,43.345,863,923,5536
1987,5322,19250,23174,145830,141624,6908,32.198,3470,16.173,54844,30220,24624,21.338,38.725,46905,27612,19293,19.497,33.120,7939,5.606,66.239,2110,2153,11973
1987,5323,4189,5353,36055,36513,1053,20.336,703,13.577,9302,4749,4553,13.007,25.476,10469,5279,5190,14.458,28.672,-1167,-3.196,50.952,413,414,2124
1987,5324,8110,9942,111455,112778,1822,18.825,1295,13.380,25263,8919,16344,7.908,22.401,28711,13158,15553,11.667,25.458,-3448,-3.057,44.801,722,731,4290
1987,5331,801,838,11639,10814,171,20.189,189,22.314,3880,1938,1942,17.921,35.879,2251,1118,1133,10.338,20.816,1629,15.064,41.631,151,151,677
1987,5411,129606,133938,857655,828194,15909,12.019,12764,9.643,167880,54528,113352,6.584,20.271,108219,43618,64601,5.267,13.067,59661,7.204,26.134,9282,9340,32972
1987,5412,65320,69354,578533,562265,10976,16.212,7670,11.329,121023,41989,79034,7.468,21.524,88266,36627,51639,6.514,15.698,32757,5.826,31.397,5550,5593,24636
1987,5413,57904,63894,831971,823905,10452,16.661,8130,12.960,174909,58981,115928,7.159,21.229,158618,54056,104562,6.561,19.252,16291,1.977,38.504,5755,5787,28002
1987,5414,15256,15499,105350,100712,2936,19.390,2222,14.674,29449,10975,18474,10.897,29.241,20153,8745,11408,8.683,20.011,9296,9.230,40.021,1710,1717,6387
1987,5415,17800,20054,298695,275088,5268,27.917,2901,15.373,90028,36498,53530,13.268,32.727,42412,13822,28590,5.025,15.418,47616,17.309,30.835,2247,2251,9461
1987,5416,38534,39992,306712,301265,10078,25.717,8471,21.616,106039,47415,58624,15.739,35.198,94996,54147,40849,17.973,31.532,11043,3.666,63.065,6591,6603,39216
1987,5417,6522,7942,431147,430123,1406,18.133,1030,13.283,66291,20878,45413,4.854,15.412,64194,21640,42554,5.031,14.925,2097,0.488,29.849,586,589,4374
1987,5418,25910,28141,342471,338230,5200,18.872,4026,14.611,78256,28853,49403,8.531,23.137,69476,30141,39335,8.911,20.541,8780,2.596,41.082,3009,3046,18755
1987,5419,31085,34669,255949,251132,4346,12.706,3416,9.987,56311,19867,36444,7.911,22.423,46651,17135,29516,6.823,18.576,9660,3.847,37.153,2509,2511,11368
1987,5511,24505,44524,3024400,3051148,5330,11.976,5294,11.895,555466,172971,382495,5.669,18.205,610700,178671,432029,5.856,20.015,-55234,-1.810,36.410,1001,1036,13891
1987,5611,12351,12977,208855,197566,3176,25.693,1945,15.734,65900,31527,34373,15.958,33.356,43524,13774,29750,6.972,22.030,22376,11.326,44.060,1440,1442,9377
1987,5612,353,477,58062,57154,67,14.565,33,7.174,11331,5381,5950,9.415,19.826,8845,753,8092,1.318,15.476,2486,4.350,30.952,25,25,487
1987,5613,15264,20791,1091045,1051965,4438,22.284,2688,13.497,359078,131748,227330,12.524,34.134,282961,66273,216688,6.300,26.898,76117,7.236,53.797,1784,1797,30066
1987,5614,19094,21691,235291,226984,3803,17.875,2971,13.965,59196,22478,36718,9.903,26.079,42921,14871,28050,6.552,18.909,16275,7.170,37.819,2226,2240,9279
1987,5615,22827,26730,204534,201458,4007,15.146,3457,13.067,48901,19883,29018,9.870,24.274,42663,19673,22990,9.765,21.177,6238,3.096,42.354,2481,2555,12933
1987,5616,12207,14592,443453,449642,2603,18.086,2204,15.314,105279,46495,58784,10.340,23.414,115284,58898,56386,13.099,25.639,-10005,-2.225,46.828,1480,1620,24863
1987,5617,74132,77524,967125,942317,18055,24.119,12725,16.999,253785,96479,157306,10.238,26.932,203979,78688,125291,8.350,21.647,49806,5.285,43.293,10047,10063,54045
1987,5619,12965,13864,184771,178790,2650,19.629,1923,14.244,47016,17441,29575,9.755,26.297,35482,14131,21351,7.904,19.846,11534,6.451,39.691,1412,1415,8762
1987,5621,5462,5565,59770,57981,807,14.631,708,12.837,13910,5118,8792,8.827,23.991,10348,5526,4822,9.531,17.847,3562,6.143,35.694,554,554,4126
1987,5622,1716,2381,58119,55586,357,15.322,255,10.944,12238,3920,8318,7.052,22.016,7134,2010,5124,3.616,12.834,5104,9.182,25.668,204,204,1382
1987,5629,4502,4784,45785,43863,832,17.732,648,13.811,12321,4415,7906,10.066,28.090,8445,3502,4943,7.984,19.253,3876,8.837,38.507,482,482,2463
1987,6111,13387,14355,428805,424163,636,4.440,574,4.007,42233,7467,34766,1.760,9.957,32863,5974,26889,1.408,7.748,9370,2.209,15.495,432,432,4155
1987,6112,473,667,51658,49664,101,15.881,39,6.132,10375,2378,7997,4.788,20.891,6522,3760,2762,7.571,13.132,3853,7.758,26.265,18,21,845
1987,6113,1990,2308,940329,926700,96,4.171,83,3.606,76429,2641,73788,0.285,8.247,48749,2895,45854,0.312,5.260,27680,2.987,10.521,51,51,1824
1987,6114,2226,2728,44227,43124,507,18.978,394,14.748,10025,4156,5869,9.637,23.247,7628,3739,3889,8.670,17.689,2397,5.558,35.377,301,305,2383
1987,6115,4070,4869,59647,57201,675,14.043,550,11.443,15787,4768,11019,8.336,27.599,10592,3857,6735,6.743,18.517,5195,9.082,37.034,398,400,2710
1987,6116,11339,11922,96586,93665,2300,19.442,2116,17.887,25991,10865,15126,11.600,27.749,20239,9261,10978,9.887,21.608,5752,6.141,43.216,1648,1659,7240
1987,6117,1552,1592,16720,16466,327,21.220,225,14.601,3699,1515,2184,9.201,22.465,3266,1386,1880,8.418,19.835,433,2.630,39.671,168,168,498
1987,6211,183220,191146,1242078,1205223,16238,8.528,14762,7.753,261388,84770,176618,7.034,21.688,187415,66686,120729,5.533,15.550,73973,6.138,31.100,11555,11637,50656
1987,6212,97418,99941,490135,482992,6262,6.288,5555,5.578,78201,21247,56954,4.399,16.191,63800,19838,43962,4.107,13.209,14401,2.982,26.419,4177,4211,15230
1987,6213,48868,51190,187497,179777,7141,14.280,4777,9.552,48514,20928,27586,11.641,26.986,32863,14712,18151,8.183,18.280,15651,8.706,36.560,3544,3571,11371
1987,6214,7135,10663,181404,174076,2048,20.301,898,8.902,47018,20799,26219,11.948,27.010,32687,11995,20692,6.891,18.777,14331,8.233,37.555,561,573,5610
1987,6215,4795,6118,87026,83524,981,16.307,777,12.916,22896,9756,13140,11.681,27.413,16085,7233,8852,8.660,19.258,6811,8.155,38.516,509,525,3331
1987,6216,4415,6227,292745,282966,1219,20.031,936,15.381,76892,26348,50544,9.311,27.174,58036,15615,42421,5.518,20.510,18856,6.664,41.020,649,654,8101
1987,6219,4768,5619,105779,104413,1126,20.704,765,14.066,27320,11641,15679,11.149,26.165,24531,14271,10260,13.668,23.494,2789,2.671,46.988,514,515,7664
1987,6221,4377,5757,3661495,3546242,627,11.278,232,4.173,562935,347858,215077,9.809,15.874,330363,57076,273287,1.609,9.316,232572,6.558,18.632,130,130,28837
1987,6222,522,812,287455,281185,262,37.590,32,4.591,146889,135652,11237,48.243,52.239,137309,1707,135602,0.607,48.832,9580,3.407,97.665,21,21,1029
1987,6223,224,267,98554,105252,61,25.103,13,5.350,26558,21471,5087,20.400,25.233,39578,1478,38100,1.404,37.603,-13020,-12.370,50.466,8,8,875
1987,6231,8058,13201,1118474,1097631,1537,11.877,1017,7.859,178276,96083,82193,8.754,16.242,137647,65112,72535,5.932,12.540,40629,3.702,25.081,645,676,44128
1987,6232,4845,7228,171923,165748,1022,14.628,539,7.715,35737,14262,21475,8.605,21.561,23537,9247,14290,5.579,14.201,12200,7.361,28.401,392,394,7398
1987,6233,8347,9771,253880,249945,1583,16.534,1189,12.419,51439,25362,26077,10.147,20.580,43711,25109,18602,10.046,17.488,7728,3.092,34.976,775,799,16371
1987,6239,3187,4057,101157,97132,527,13.399,279,7.094,19070,7521,11549,7.743,19.633,10961,3736,7225,3.846,11.285,8109,8.348,22.569,169,175,2189
1987,6241,15949,21307,298261,290673,2282,10.890,1577,7.526,52821,14298,38523,4.919,18.172,37852,10176,27676,3.501,13.022,14969,5.150,26.044,928,936,5093
1987,6242,4499,5328,55508,54640,512,9.742,367,6.983,9775,2517,7258,4.607,17.890,8090,2285,5805,4.182,14.806,1685,3.084,29.612,203,206,1403
1987,6243,4404,6467,260298,255878,724,11.515,365,5.805,48129,8188,39941,3.200,18.809,40051,5452,34599,2.131,15.652,8078,3.157,31.305,158,164,2229
1987,6244,31936,37871,349425,341321,5085,13.594,4158,11.115,72216,30330,41886,8.886,21.158,56005,22441,33564,6.575,16.408,16211,4.749,32.817,3168,3204,15910
1987,7111,4674,4713,64989,64236,861,18.510,738,15.866,18212,5899,12313,9.183,28.352,16926,4437,12489,6.907,26.350,1286,2.002,52.700,560,561,2947
1987,7112,2280,2388,71006,67937,459,19.582,371,15.828,19187,5343,13844,7.865,28.242,12877,2829,10048,4.164,18.954,6310,9.288,37.909,267,267,1919
1987,7113,1944,1994,31075,31640,376,19.014,343,17.345,9251,2135,7116,6.748,29.239,10461,2802,7659,8.856,33.063,-1210,-3.824,58.478,263,264,1656
1987,7114,1177,1203,13187,13164,226,19.064,191,16.111,4017,1665,2352,12.649,30.516,3996,1298,2698,9.861,30.357,21,0.160,60.713,144,144,1109
1987,7115,9403,9448,57946,57888,2618,27.115,3032,31.403,24593,9523,15070,16.451,42.484,24430,14243,10187,24.605,42.203,163,0.282,84.405,2442,2442,9784
1987,7121,2684,2876,53115,51721,228,8.027,157,5.527,6976,1436,5540,2.776,13.488,4154,710,3444,1.373,8.032,2822,5.456,16.063,108,108,548
1987,7131,1661,2247,61311,62037,341,15.240,322,14.391,8940,3318,5622,5.348,14.411,10005,2642,7363,4.259,16.128,-1065,-1.717,28.822,246,249,2192
1987,7132,698,714,20106,19166,158,22.539,132,18.830,4822,1843,2979,9.616,25.160,2896,1669,1227,8.708,15.110,1926,10.049,30.221,97,97,1224
1987,7139,34506,37720,566167,551126,6000,16.313,4123,11.209,125141,53666,71475,9.738,22.706,95267,33882,61385,6.148,17.286,29874,5.421,34.572,3076,3094,23863
1987,7211,29568,34732,1283540,1284232,5279,15.315,4755,13.795,252666,132937,119729,10.351,19.674,253601,116187,137414,9.047,19.747,-935,-0.073,39.349,3381,3466,67208
1987,7212,3769,4025,25418,24940,533,13.239,535,13.289,7243,2599,4644,10.421,29.042,6262,2606,3656,10.449,25.108,981,3.933,50.217,342,343,1287
1987,7213,3786,3883,21114,20441,322,8.191,418,10.633,4588,1204,3384,5.890,22.446,3368,1629,1739,7.969,16.477,1220,5.969,32.954,277,277,1102
1987,7223,12984,17783,333771,327687,3741,21.494,2985,17.150,85672,49458,36214,15.093,26.145,73556,33145,40411,10.115,22.447,12116,3.697,44.894,2112,2124,18278
1987,7224,52277,53003,313897,311110,8827,16.568,9377,17.600,90792,50562,40230,16.252,29.183,85206,41722,43484,13.411,27.388,5586,1.796,54.775,7525,7561,33230
1987,7225,208703,285849,5428264,5284973,53691,19.193,41482,14.829,1379281,768223,611058,14.536,26.098,1095464,491438,604026,9.299,20.728,283817,5.370,41.456,30434,31128,323514
1987,8111,107990,114079,580541,567464,19582,17.467,15641,13.952,148164,73126,75038,12.886,26.110,121603,56641,64962,9.981,21.429,26561,4.681,42.858,12017,12100,44858
1987,8112,11055,13134,107862,108026,2155,16.780,1573,12.248,24355,12034,12321,11.140,22.545,24484,9033,15451,8.362,22.665,-129,-0.119,45.091,1118,1121,3762
1987,8113,20333,21521,156408,156570,3076,14.436,2649,12.432,31303,11459,19844,7.319,19.993,31445,11463,19982,7.321,20.084,-142,-0.091,39.986,1900,1902,7822
1987,8114,23897,25559,151242,149851,4372,17.323,3731,14.783,33051,14464,18587,9.652,22.056,30323,12361,17962,8.249,20.236,2728,1.820,40.471,2804,2810,8179
1987,8121,75353,83914,424163,423311,12736,15.083,13785,16.325,100347,51990,48357,12.282,23.705,99179,50838,48341,12.010,23.429,1168,0.276,46.859,10837,10943,37179
1987,8122,17121,20159,123967,121602,1656,8.224,1609,7.991,22380,6338,16042,5.212,18.404,17637,6197,11440,5.096,14.504,4743,3.900,29.008,1099,1118,4523
1987,8123,33143,39489,364427,360370,5758,14.698,5133,13.102,72765,32181,40584,8.930,20.192,64218,28370,35848,7.872,17.820,8547,2.372,35.640,3715,3854,19268
1987,8129,12985,21378,189327,190551,4478,21.373,3626,17.306,47396,19751,27645,10.365,24.873,49403,23686,25717,12.430,25.926,-2007,-1.053,49.746,2205,2278,12541
1987,8131,126403,126485,1014555,1001158,7205,5.743,5147,4.103,126372,21383,104989,2.136,12.623,99709,16470,83239,1.645,9.959,26663,2.663,19.919,3054,3054,8351
1987,8132,8158,9224,127549,123553,1004,11.108,633,7.003,22591,6123,16468,4.956,18.285,14627,4099,10528,3.318,11.839,7964,6.446,23.677,433,436,2694
1987,8133,7207,8383,93946,92058,946,11.435,726,8.776,17834,5172,12662,5.618,19.373,14015,4347,9668,4.722,15.224,3819,4.148,30.448,463,475,2489
1987,8134,29189,30610,266445,263281,2389,7.851,2025,6.655,39242,9203,30039,3.496,14.905,32931,7413,25518,2.816,12.508,6311,2.397,25.016,1366,1366,4805
1987,8139,56835,59190,474566,470634,5090,8.628,4695,7.959,83732,23539,60193,5.002,17.791,75964,21192,54772,4.503,16.141,7768,1.651,32.282,3275,3281,13975
1988,1131,220,231,2798,2653,39,17.257,29,12.832,694,305,389,11.496,26.159,405,161,244,6.069,15.266,289,10.893,30.531,21,21,118
1988,1132,87,102,1573,1532,20,20.101,15,15.075,429,172,257,11.227,28.003,361,119,242,7.768,23.564,68,4.439,47.128,12,12,49
1988,1133,10775,10854,89351,87747,1732,16.096,1545,14.358,22062,7883,14179,8.984,25.143,18835,7510,11325,8.559,21.465,3227,3.678,42.930,1159,1160,4894
1988,1141,1052,1060,7271,7240,201,18.768,223,20.822,3049,1381,1668,19.075,42.113,2989,1502,1487,20.746,41.285,60,0.829,82.569,166,166,773
1988,1142,141,141,1007,1005,31,22.464,25,18.116,234,87,147,8.657,23.284,224,108,116,10.746,22.289,10,0.995,44.577,22,22,90
1988,1151,3776,4088,52175,50419,624,15.255,629,15.377,17767,8467,9300,16.793,35.239,14240,6787,7453,13.461,28.243,3527,6.995,56.487,347,349,3490
1988,1152,1937,1954,13968,13873,336,17.329,306,15.781,2862,1072,1790,7.728,20.631,2627,1158,1469,8.347,18.937,235,1.694,37.873,241,241,790
1988,1153,792,803,10800,10364,156,19.784,127,16.107,3679,1351,2328,13.036,35.500,2811,1293,1518,12.476,27.124,868,8.376,54.248,94,94,922
1988,2111,7151,8713,123731,127361,1031,11.678,1262,14.295,21465,6593,14872,5.177,16.854,28933,9812,19121,7.704,22.717,-7468,-5.864,33.707,808,819,3209
1988,2121,2239,2809,144963,148445,475,16.643,565,19.797,24123,11372,12751,7.661,16.251,31298,11957,19341,8.055,21.084,-7175,-4.833,32.501,409,412,6933
1988,2122,495,635,40229,37801,151,24.257,126,20.241,10086,2092,7994,5.534,26.682,5400,1409,3991,3.727,14.286,4686,12.397,28.571,86,86,481
1988,2123,3523,5053,106684,104292,470,9.331,438,8.696,18071,5924,12147,5.680,17.327,13273,4238,9035,4.064,12.727,4798,4.601,25.454,261,263,1738
1988,2131,8119,9289,161265,161219,1299,13.648,1757,18.460,46143,10109,36034,6.270,28.621,45985,22858,23127,14.178,28.523,158,0.098,57.047,1084,1098,6479
1988,2211,1705,6014,596064,599241,303,5.062,247,4.126,31826,9445,22381,1.576,5.311,38506,12089,26417,2.017,6.426,-6680,-1.115,10.622,56,132,5362
1988,2212,592,2505,143572,141944,268,10.848,199,8.055,13144,7314,5830,5.153,9.260,10163,3874,6289,2.729,7.160,2981,2.100,14.320,33,33,187
1988,2213,3845,4108,31488,31120,373,9.206,260,6.417,4378,1453,2925,4.669,14.068,3644,1829,1815,5.877,11.710,734,2.359,23.419,158,160,1073
1988,2361,107599,107991,639560,634140,22486,21.067,19976,18.715,204940,85252,119688,13.444,32.318,194301,83755,110546,13.208,30.640,10639,1.678,61.280,14784,14789,61465
1988,2362,38074,38790,705372,699714,5203,13.453,4974,12.861,190333,37961,152372,5.425,27.202,177816,46840,130976,6.694,25.413,12517,1.789,50.825,3769,3775,32504
1988,2371,13546,13844,299352,299543,1460,10.596,1330,9.652,65035,12661,52374,4.227,21.711,66160,13265,52895,4.428,22.087,-1125,-0.376,43.423,982,984,8244
1988,2372,9797,10020,77814,75534,2356,23.751,2155,21.725,29342,15257,14085,20.199,38.846,24856,12120,12736,16.046,32.907,4486,5.939,65.814,1739,1756,9725
1988,2373,9546,9940,263882,260464,1131,11.431,1039,10.501,57646,10824,46822,4.156,22.132,50746,11579,39167,4.446,19.483,6900,2.649,38.966,780,781,7591
1988,2379,5017,5071,78783,82431,799,15.705,832,16.354,18659,6464,12195,7.842,22.636,25921,6423,19498,7.792,31.446,-7262,-8.810,45.272,652,652,3456
1988,2381,76549,76992,736709,733684,12277,16.068,11108,14.538,204623,62379,142244,8.502,27.890,198058,62350,135708,8.498,26.995,6565,0.895,53.990,8456,8461,49588
1988,2382,116911,118901,1248204,1231050,16120,13.726,13193,11.234,268218,70787,197431,5.750,21.788,234468,67334,167134,5.470,19.046,33750,2.742,38.092,10143,10160,52034
1988,2383,79382,79828,667902,663781,15270,19.343,13502,17.103,192618,62757,129861,9.454,29.018,184272,62104,122168,9.356,27.761,8346,1.257,55.522,10306,10307,48779
1988,2389,40742,40972,356722,350905,6727,16.612,5772,14.254,98808,30365,68443,8.653,28.158,87131,27966,59165,7.970,24.830,11677,3.328,49.661,4361,4364,21265
1988,3111,1215,1813,48118,48390,120,6.581,141,7.732,6390,2686,3704,5.551,13.205,7042,3225,3817,6.665,14.553,-652,-1.347,26.411,76,77,1085
1988,3112,475,823,65489,65254,52,6.326,50,6.083,5124,1194,3930,1.830,7.852,4699,1624,3075,2.489,7.201,425,0.651,14.402,27,27,211
1988,3113,1582,1901,86974,85314,221,11.681,203,10.729,11625,1787,9838,2.095,13.626,8459,1961,6498,2.299,9.915,3166,3.711,19.830,120,121,734
1988,3114,1141,1569,168117,168334,133,8.461,139,8.842,25912,8806,17106,5.231,15.393,26353,10642,15711,6.322,15.655,-441,-0.262,30.786,76,76,1947
1988,3115,1506,2151,138530,137121,125,5.701,208,9.487,16739,5818,10921,4.243,12.208,14461,5834,8627,4.255,10.546,2278,1.661,21.092,132,132,1510
1988,3116,3830,4429,357102,348707,349,7.821,416,9.322,46849,12944,33905,3.712,13.435,29645,11189,18456,3.209,8.501,17204,4.934,17.003,317,318,5789
1988,3117,704,818,46546,45067,86,10.710,56,6.974,9634,2759,6875,6.122,21.377,6807,1260,5547,2.796,15.104,2827,6.273,30.209,40,40,784
1988,3118,9093,10696,308610,306475,1495,14.034,1409,13.226,43860,18581,25279,6.063,14.311,40478,15745,24733,5.137,13.208,3382,1.104,26.415,1029,1046,7345
1988,3119,2044,2405,133098,131742,276,11.577,234,9.815,18224,6429,11795,4.880,13.833,15489,5101,10388,3.872,11.757,2735,2.076,23.514,155,155,2411
1988,3121,1788,2297,149694,148288,236,10.340,207,9.069,20329,8133,12196,5.485,13.709,17263,4563,12700,3.077,11.642,3066,2.068,23.283,139,141,2248
1988,3122,94,131,35608,34690,9,6.818,11,8.333,4397,166,4231,0.479,12.675,2485,682,1803,1.966,7.163,1912,5.512,14.327,7,7,89
1988,3131,397,622,112735,111765,47,7.605,39,6.311,12847,5380,7467,4.814,11.495,11134,3070,8064,2.747,9.962,1713,1.533,19.924,24,24,664
1988,3132,1633,1967,258160,250946,190,9.764,148,7.605,30786,16473,14313,6.564,12.268,16787,4769,12018,1.900,6.690,13999,5.579,13.379,99,101,1478
1988,3133,5600,6307,146230,144439,660,10.516,598,9.528,21396,6618,14778,4.582,14.813,17878,5544,12334,3.838,12.378,3518,2.436,24.755,455,457,3170
1988,3141,3695,3989,130236,127748,430,10.714,479,11.935,18899,7530,11369,5.894,14.794,13836,4976,8860,3.895,10.831,5063,3.963,21.661,354,363,3174
1988,3149,3649,3765,110900,110432,521,14.114,374,10.131,18886,6569,12317,5.948,17.102,17784,5872,11912,5.317,16.104,1102,0.998,32.208,303,304,4597
1988,3151,1275,1401,140586,141564,149,10.613,155,11.040,16767,5907,10860,4.173,11.844,18813,4616,14197,3.261,13.289,-2046,-1.445,23.688,130,131,3726
1988,3152,11524,12905,791222,801671,2080,16.053,2184,16.856,128479,49282,79197,6.147,16.026,148236,64677,83559,8.068,18.491,-19757,-2.464,32.053,1845,1849,39442
1988,3159,1757,1838,59881,58795,291,16.243,198,11.052,11764,5487,6277,9.333,20.009,9634,3204,6430,5.449,16.386,2130,3.623,32.772,154,155,2532
1988,3161,320,348,14936,14942,31,9.038,21,6.122,2279,790,1489,5.287,15.252,2298,576,1722,3.855,15.379,-19,-0.127,30.505,11,11,80
1988,3162,397,527,83173,81898,44,8.365,42,7.985,10990,2298,8692,2.806,13.419,8348,2775,5573,3.388,10.193,2642,3.226,20.386,26,26,837
1988,3169,1115,1163,37330,37038,125,10.666,143,12.201,6696,2051,4645,5.538,18.079,5985,3019,2966,8.151,16.159,711,1.920,32.318,109,109,781
1988,3211,4598,5098,145751,144001,544,10.752,467,9.230,23568,9170,14398,6.368,16.367,20113,10451,9662,7.258,13.967,3455,2.399,27.935,337,338,3475
1988,3212,1305,1610,106386,105039,174,10.913,143,8.968,13035,5239,7796,4.988,12.410,10239,3921,6318,3.733,9.748,2796,2.662,19.496,101,107,2008
1988,3219,9126,9791,287949,283550,1213,12.508,1026,10.580,48160,16550,31610,5.837,16.985,39223,12895,26328,4.548,13.833,8937,3.152,27.666,784,787,7562
1988,3221,228,544,190396,190295,25,4.613,21,3.875,8204,2795,5409,1.469,4.311,8005,1852,6153,0.973,4.207,199,0.105,8.413,11,12,612
1988,3222,3610,5196,397669,393787,325,6.277,288,5.563,38943,10270,28673,2.608,9.889,31463,9196,22267,2.335,7.990,7480,1.900,15.980,201,203,4560
1988,3231,40961,42793,831293,818641,4905,11.600,3888,9.195,115837,34724,81113,4.242,14.150,90550,34442,56108,4.207,11.061,25287,3.089,22.122,3141,3146,22249
1988,3241,1271,2131,113727,113439,193,9.106,170,8.021,11168,5455,5713,4.809,9.845,10462,3732,6730,3.290,9.223,706,0.622,18.445,93,96,2262
1988,3251,1139,2273,227972,224228,197,8.810,123,5.501,28178,7621,20557,3.399,12.567,21493,9123,12370,4.069,9.585,6685,2.981,19.171,44,44,1153
1988,3252,363,633,131124,127909,66,10.706,33,5.353,14263,7958,6305,6.222,11.151,7980,1472,6508,1.151,6.239,6283,4.912,12.478,19,19,431
1988,3253,619,890,41511,41938,64,7.072,94,10.387,4240,1407,2833,3.355,10.110,5097,1899,3198,4.528,12.154,-857,-2.044,20.221,46,49,465
1988,3254,1068,1313,163268,162085,131,10.108,97,7.485,16114,4885,11229,3.014,9.942,14029,4732,9297,2.919,8.655,2085,1.286,17.311,62,63,1795
1988,3255,1624,2127,77080,76184,145,6.836,133,6.271,8783,2194,6589,2.880,11.529,7023,2497,4526,3.278,9.218,1760,2.310,18.437,80,80,730
1988,3256,2032,2279,120223,118458,206,9.035,208,9.123,16516,3470,13046,2.929,13.942,13262,5697,7565,4.809,11.196,3254,2.747,22.391,147,148,1883
1988,3259,2129,2751,142654,140176,317,11.767,203,7.535,19292,8259,11033,5.892,13.763,14458,3203,11255,2.285,10.314,4834,3.449,20.628,130,132,1493
1988,3261,9830,11695,654375,637404,1095,9.457,862,7.445,100616,27034,73582,4.241,15.785,67099,19183,47916,3.010,10.527,33517,5.258,21.054,624,629,10319
1988,3262,2114,2558,192126,191119,239,9.415,200,7.879,19533,4622,14911,2.418,10.220,17484,8569,8915,4.484,9.148,2049,1.072,18.296,125,130,2014
1988,3271,1374,1661,83397,81814,196,11.793,198,11.913,12156,3113,9043,3.805,14.858,8683,3320,5363,4.058,10.613,3473,4.245,21.226,146,146,1070
1988,3272,1686,1940,143807,142729,242,12.697,174,9.129,15682,3392,12290,2.377,10.987,13585,5542,8043,3.883,9.518,2097,1.469,19.036,129,129,2549
1988,3273,6668,9064,189908,190308,723,8.012,643,7.125,32036,11274,20762,5.924,16.834,32533,9517,23016,5.001,17.095,-497,-0.261,33.668,436,443,5440
1988,3274,262,356,18100,17931,40,11.315,35,9.901,2024,862,1162,4.807,11.288,1731,652,1079,3.636,9.654,293,1.634,19.308,20,20,318
1988,3279,1887,2180,77972,76443,222,10.266,187,8.647,11031,3227,7804,4.221,14.430,8111,3543,4568,4.635,10.611,2920,3.820,21.221,128,128,1421
1988,3311,348,422,196654,187794,51,12.100,50,11.862,27170,10470,16700,5.575,14.468,8766,1921,6845,1.023,4.668,18404,9.800,9.336,33,33,577
1988,3312,523,704,66636,64955,57,8.120,53,7.550,9013,2385,6628,3.672,13.876,5509,2693,2816,4.146,8.481,3504,5.395,16.963,32,33,593
1988,3313,333,476,86746,84699,43,9.168,29,6.183,9841,3780,6061,4.463,11.619,5572,2194,3378,2.590,6.579,4269,5.040,13.157,10,10,214
1988,3314,770,929,82390,81804,87,9.400,80,8.644,9932,4168,5764,5.095,12.141,8881,4152,4729,5.076,10.856,1051,1.285,21.713,42,43,671
1988,3315,2529,2789,213454,209525,205,7.382,181,6.518,28489,5818,22671,2.777,13.597,21071,9003,12068,4.297,10.057,7418,3.540,20.113,131,133,3537
1988,3321,3300,3512,145219,141953,227,6.480,209,5.966,20079,5003,15076,3.524,14.145,13573,5063,8510,3.567,9.562,6506,4.583,19.123,156,156,2466
1988,3322,1292,1420,78086,77514,116,8.227,96,6.809,8472,1822,6650,2.351,10.930,7433,1815,5618,2.342,9.589,1039,1.340,19.178,68,68,1091
1988,3323,10022,10835,340142,336804,902,8.338,869,8.033,52767,14312,38455,4.249,15.667,45929,14910,31019,4.427,13.637,6838,2.030,27.273,643,647,8305
1988,3324,1515,1859,115457,115031,161,8.705,142,7.678,15023,3942,11081,3.427,13.060,14201,4087,10114,3.553,12.345,822,0.715,24.691,88,88,1408
1988,3325,969,1065,75014,73157,104,9.943,66,6.310,9418,4283,5135,5.855,12.874,5785,1296,4489,1.772,7.908,3633,4.966,15.815,38,38,473
1988,3326,1627,1830,72001,70081,185,10.315,112,6.245,9797,2553,7244,3.643,13.980,5864,2257,3607,3.221,8.368,3933,5.612,16.735,76,76,1114
1988,3327,21282,21568,328207,317274,2174,10.157,1848,8.633,57088,15027,42061,4.736,17.993,35138,13686,21452,4.314,11.075,21950,6.918,22.150,1444,1445,9800
1988,3328,5498,5844,138178,144277,412,7.060,396,6.785,21524,3920,17604,2.717,14.919,32703,6851,25852,4.749,22.667,-11179,-7.748,29.837,306,306,3957
1988,3329,6401,6884,364124,357287,773,11.353,623,9.150,45295,9949,35346,2.785,12.677,31765,11581,20184,3.241,8.891,13530,3.787,17.781,469,470,5154
1988,3331,2913,3173,199806,193519,280,8.831,275,8.674,35951,8853,27098,4.575,18.578,22945,9575,13370,4.948,11.857,13006,6.721,23.713,190,190,1750
1988,3332,4100,4335,168276,165330,376,8.738,312,7.251,24890,5861,19029,3.545,15.055,18959,8660,10299,5.238,11.467,5931,3.587,22.935,233,234,3926
1988,3333,2228,2358,153092,150675,233,10.017,169,7.266,21940,8523,13417,5.657,14.561,17291,7914,9377,5.252,11.476,4649,3.085,22.951,123,123,2642
1988,3334,1629,1875,165278,163302,163,8.686,166,8.846,21496,6407,15089,3.923,13.163,17321,6302,11019,3.859,10.607,4175,2.557,21.214,112,112,2182
1988,3335,9227,9558,218224,215137,631,6.605,623,6.521,29869,6936,22933,3.224,13.884,23849,7391,16458,3.435,11.085,6020,2.798,22.171,467,469,2769
1988,3336,748,895,128678,128896,54,6.023,57,6.358,14579,3798,10781,2.947,11.311,14877,4951,9926,3.841,11.542,-298,-0.231,22.621,34,34,3513
1988,3339,5378,5961,319510,314521,458,7.708,419,7.052,43830,12103,31727,3.848,13.935,34132,14248,19884,4.530,10.852,9698,3.083,21.704,286,289,3644
1988,3341,1599,1740,271131,273538,308,18.166,219,12.917,38486,9591,28895,3.506,14.070,42896,15473,27423,5.657,15.682,-4410,-1.612,28.139,152,155,3101
1988,3342,1462,1655,250576,247599,188,11.677,98,6.087,35099,10710,24389,4.326,14.176,28926,9590,19336,3.873,11.683,6173,2.493,23.365,54,54,1705
1988,3343,379,400,31570,31861,57,14.504,43,10.941,3958,1327,2631,4.165,12.423,4306,785,3521,2.464,13.515,-348,-1.092,24.846,30,30,524
1988,3344,4604,5221,522368,518885,741,14.512,511,10.008,66327,18227,48100,3.513,12.783,59821,18831,40990,3.629,11.529,6506,1.254,23.058,367,369,5496
1988,3345,4451,5103,676759,679668,553,10.884,509,10.018,61095,22540,38555,3.316,8.989,67447,23355,44092,3.436,9.924,-6352,-0.935,17.978,352,357,5970
1988,3346,745,789,47958,43402,140,18.409,83,10.914,13853,4521,9332,10.417,31.918,5050,1570,3480,3.617,11.636,8803,20.283,23.271,58,58,506
1988,3351,1173,1302,86539,86413,107,8.206,111,8.512,8193,1695,6498,1.962,9.481,7827,2262,5565,2.618,9.058,366,0.424,18.115,78,79,1335
1988,3352,327,412,112659,113187,51,12.469,45,11.002,15545,7573,7972,6.691,13.734,16652,11124,5528,9.828,14.712,-1107,-0.978,27.468,25,27,2468
1988,3353,2110,2558,232465,231642,199,7.786,195,7.629,25340,7706,17634,3.327,10.939,23651,7086,16565,3.059,10.210,1689,0.729,20.420,127,127,1192
1988,3359,2290,2673,210962,208049,272,10.204,257,9.642,34561,12277,22284,5.901,16.612,27814,13184,14630,6.337,13.369,6747,3.243,26.738,169,170,2967
1988,3361,225,284,240501,245758,39,13.805,36,12.743,17195,2210,14985,0.899,6.997,28559,1960,26599,0.798,11.621,-11364,-4.624,13.993,28,28,235
1988,3362,1871,2082,128866,125324,231,11.141,214,10.321,21675,8141,13534,6.496,17.295,14680,5241,9439,4.182,11.714,6995,5.582,23.427,169,169,3480
1988,3363,3960,4788,656015,658770,473,10.000,357,7.548,60390,19002,41388,2.884,9.167,65946,16520,49426,2.508,10.010,-5556,-0.843,18.334,242,243,6653
1988,3364,1399,1695,681818,673697,156,9.275,130,7.729,77195,29655,47540,4.402,11.458,62426,26147,36279,3.881,9.266,14769,2.192,18.532,83,83,900
1988,3365,164,194,27857,26072,29,15.263,21,11.053,6456,2458,3998,9.428,24.763,2867,938,1929,3.598,10.997,3589,13.766,21.993,11,11,345
1988,3366,1256,1354,167840,162388,180,13.549,129,9.710,26832,5652,21180,3.481,16.523,15937,3234,12703,1.992,9.814,10895,6.709,19.628,95,95,2006
1988,3369,493,507,30507,30588,68,13.614,53,10.611,3587,689,2898,2.253,11.727,3829,766,3063,2.504,12.518,-242,-0.791,23.454,43,43,546
1988,3371,13565,14315,408187,403122,2005,14.139,1737,12.249,66594,24454,42140,6.066,16.520,56506,23327,33179,5.787,14.017,10088,2.502,28.034,1356,1363,13926
1988,3372,2987,3171,162191,158377,369,11.838,261,8.373,25130,8353,16777,5.274,15.867,17666,7242,10424,4.573,11.154,7464,4.713,22.309,201,201,3202
1988,3379,1100,1262,42287,41860,127,10.234,85,6.849,5857,1814,4043,4.334,13.992,5095,1085,4010,2.592,12.172,762,1.820,24.343,62,62,665
1988,3391,10463,11005,246745,240915,1151,10.470,1128,10.261,38130,11414,26716,4.738,15.827,26939,7106,19833,2.950,11.182,11191,4.645,22.364,853,854,3826
1988,3399,15569,16092,409781,404054,2268,14.307,1788,11.279,68009,19045,48964,4.713,16.832,56635,20688,35947,5.120,14.017,11374,2.815,28.033,1445,1452,14636
1988,4231,18781,22255,261075,261150,2333,10.439,2520,11.276,42572,13733,28839,5.259,16.302,42727,16637,26090,6.371,16.361,-155,-0.059,32.604,1709,1779,9979
1988,4232,7999,9093,112536,110022,1308,14.597,1043,11.640,23854,8779,15075,7.979,21.681,18658,6493,12165,5.902,16.959,5196,4.723,33.917,810,828,4579
1988,4233,7966,10221,134833,132789,1205,11.904,1009,9.967,24664,7425,17239,5.592,18.574,20585,7249,13336,5.459,15.502,4079,3.072,31.004,730,746,4837
1988,4234,25190,34459,609100,606030,4560,13.360,3904,11.438,109232,37174,72058,6.134,18.024,104153,51019,53134,8.419,17.186,5079,0.838,34.372,2405,2487,15280
1988,4235,6912,9137,137642,134123,926,10.184,838,9.216,24785,7059,17726,5.263,18.479,17483,6372,11111,4.751,13.035,7302,5.444,26.070,505,527,3247
1988,4236,15606,22023,308798,303528,2985,13.728,2428,11.166,61868,24682,37186,8.132,20.383,51604,23824,27780,7.849,17.001,10264,3.382,34.003,1397,1451,10080
1988,4237,10764,14424,156917,155548,1363,9.503,1202,8.380,23923,7329,16594,4.712,15.380,21363,7519,13844,4.834,13.734,2560,1.646,27.468,809,869,4695
1988,4238,47216,61436,656511,647803,5969,9.765,5349,8.751,113036,38689,74347,5.972,17.449,96333,35789,60544,5.525,14.871,16703,2.578,29.741,3372,3499,18802
1988,4239,25307,26999,264926,257448,4269,15.997,3642,13.648,62116,21328,40788,8.284,24.128,46756,19951,26805,7.750,18.161,15360,5.966,36.323,2881,2894,13513
1988,4241,8576,11592,172189,169102,1378,12.140,896,7.894,30099,9550,20549,5.647,17.799,23733,7065,16668,4.178,14.035,6366,3.765,28.070,588,595,3437
1988,4242,3043,3925,111586,109542,576,14.786,517,13.272,21331,8865,12466,8.093,19.473,17808,6213,11595,5.672,16.257,3523,3.216,32.514,322,324,2097
1988,4243,8263,8850,113477,113251,1577,18.070,1331,15.252,26448,9740,16708,8.600,23.354,26113,10127,15986,8.942,23.058,335,0.296,46.115,1014,1022,5638
1988,4244,27494,33995,676759,677833,3914,11.532,3806,11.214,115502,36446,79056,5.377,17.040,118562,52623,65939,7.763,17.491,-3060,-0.451,34.080,2787,2819,33940
1988,4245,7143,10082,88005,88692,680,6.726,735,7.270,14432,4021,10411,4.534,16.272,15774,4893,10881,5.517,17.785,-1342,-1.513,32.544,457,472,3233
1988,4246,7586,11039,127441,126997,1389,12.768,1068,9.818,24003,8333,15670,6.562,18.901,22882,7952,14930,6.262,18.018,1121,0.883,36.036,594,630,3933
1988,4247,9609,12690,134232,138352,1028,8.056,1170,9.169,21838,6411,15427,4.634,15.784,30061,9008,21053,6.511,21.728,-8223,-5.944,31.569,714,730,4844
1988,4248,3966,5058,139819,140810,315,6.168,413,8.087,15103,4016,11087,2.852,10.726,17029,4833,12196,3.432,12.094,-1926,-1.368,21.452,298,305,2691
1988,4249,19552,23413,278774,271568,3347,14.440,2878,12.417,55783,22111,33672,8.142,20.541,41763,15231,26532,5.609,15.378,14020,5.163,30.757,2030,2070,9845
1988,4251,30291,32724,296707,294962,3813,11.789,3055,9.445,56358,20966,35392,7.108,19.107,53064,18761,34303,6.360,17.990,3294,1.117,35.980,2037,2045,10865
1988,4411,39057,40897,1009920,1001664,4725,11.638,4130,10.173,141118,56648,84470,5.655,14.088,124589,47212,77377,4.713,12.438,16529,1.650,24.876,3351,3380,37415
1988,4412,11459,12122,92490,91681,1346,11.122,1306,10.792,18633,6282,12351,6.852,20.324,17061,6452,10609,7.037,18.609,1572,1.715,37.218,1057,1064,5148
1988,4413,44281,62623,466859,463574,5975,9.555,5791,9.261,82859,32568,50291,7.025,17.874,75703,27753,47950,5.987,16.330,7156,1.544,32.661,3799,4029,16796
1988,4421,22086,28125,240482,238833,3260,11.668,2889,10.340,45230,17312,27918,7.249,18.938,41848,15305,26543,6.408,17.522,3382,1.416,35.044,2102,2210,10764
1988,4422,23476,29317,189985,183442,4222,14.635,3287,11.394,46324,20654,25670,11.259,25.253,33112,13120,19992,7.152,18.050,13212,7.202,36.101,2272,2384,8798
1988,4431,29378,44098,313655,305569,6341,14.586,5091,11.711,76874,36573,40301,11.969,25.158,60435,23402,37033,7.659,19.778,16439,5.380,39.556,3374,3595,15093
1988,4441,56772,74053,823312,813138,6567,8.893,6156,8.336,135793,48022,87771,5.906,16.700,116026,40412,75614,4.970,14.269,19767,2.431,28.538,4263,4383,21279
1988,4442,17925,21845,169005,166220,2212,10.172,2016,9.270,33987,10059,23928,6.052,20.447,28251,9693,18558,5.831,16.996,5736,3.451,33.992,1343,1370,6078
1988,4451,62774,94924,2235588,2196963,12418,13.098,12193,12.860,399446,197408,202038,8.985,18.182,323226,136545,186681,6.215,14.712,76220,3.469,29.425,7694,7979,52292
1988,4452,21626,25829,166526,168054,3762,14.468,4108,15.799,38711,18838,19873,11.210,23.035,42245,17593,24652,10.469,25.138,-3534,-2.103,46.070,3170,3214,12898
1988,4453,27123,32101,154477,156030,3629,11.257,3905,12.113,29590,13428,16162,8.606,18.964,32703,13461,19242,8.627,20.959,-3113,-1.995,37.929,2919,2977,10332
1988,4461,50686,78277,722849,718607,8144,10.490,6864,8.841,132811,58525,74286,8.144,18.482,123740,43357,80383,6.033,17.219,9071,1.262,34.439,4245,4378,20350
1988,4471,87217,138075,973238,969020,16929,12.343,15093,11.004,218772,103389,115383,10.669,22.577,209625,80087,129538,8.265,21.633,9147,0.944,43.265,9539,9946,46226
1988,4481,55285,104305,947237,935934,14565,14.109,12421,12.032,220584,100402,120182,10.727,23.568,194982,65320,129662,6.979,20.833,25602,2.735,41.666,7294,7830,32354
1988,4482,11172,37226,202085,201235,4211,11.353,3939,10.620,43658,20181,23477,10.029,21.695,41836,15702,26134,7.803,20.790,1822,0.905,41.579,1641,1778,6482
1988,4483,19182,28800,176321,175033,3838,13.505,3075,10.820,39759,16683,23076,9.531,22.715,37841,13056,24785,7.459,21.619,1918,1.096,43.239,1908,2006,7118
1988,4511,32544,42564,310688,302270,6212,14.735,5398,12.805,71744,32580,39164,10.778,23.735,54970,21503,33467,7.114,18.186,16774,5.549,36.372,3899,4059,13360
1988,4512,8299,12708,88138,85477,1759,14.071,1345,10.759,19769,7435,12334,8.698,23.128,14611,5541,9070,6.482,17.093,5158,6.034,34.187,901,946,3567
1988,4522,227,6439,1164886,1139479,366,5.783,145,2.291,138620,45974,92646,4.035,12.165,89162,19447,69715,1.707,7.825,49458,4.340,15.650,13,16,4388
1988,4523,12949,29129,917524,893460,2984,10.251,2945,10.117,153788,75866,77922,8.491,17.213,107890,45810,62080,5.127,12.076,45898,5.137,24.151,1638,1749,10293
1988,4531,23471,24959,127404,125660,3542,14.369,2924,11.862,27131,10684,16447,8.502,21.591,23515,9093,14422,7.236,18.713,3616,2.878,37.427,2153,2199,6762
1988,4532,30659,38628,242108,234181,6850,18.209,4830,12.840,61887,28281,33606,12.077,26.427,46287,19914,26373,8.504,19.766,15600,6.662,39.531,3414,3636,14063
1988,4533,8967,10883,58026,56747,1904,17.765,1574,14.686,13191,6273,6918,11.054,23.245,10813,3943,6870,6.948,19.055,2378,4.191,38.110,1047,1058,2500
1988,4539,22142,25704,134751,131961,4608,18.191,3862,15.246,37482,18290,19192,13.860,28.404,31981,15513,16468,11.756,24.235,5501,4.169,48.470,2643,2857,11488
1988,4541,5535,6874,112961,106020,991,14.685,740,10.965,32340,13716,18624,12.937,30.504,17732,7755,9977,7.315,16.725,14608,13.779,33.450,563,572,4065
1988,4542,4009,4957,76880,74251,680,13.883,562,11.474,17474,5698,11776,7.674,23.534,12183,6252,5931,8.420,16.408,5291,7.126,32.816,374,378,3983
1988,4543,17141,23314,233829,231422,2579,11.116,2352,10.138,47242,13074,34168,5.649,20.414,42151,15907,26244,6.874,18.214,5091,2.200,36.428,1522,1550,7865
1988,4811,691,2717,421373,406285,342,12.620,328,12.103,65033,7266,57767,1.788,16.007,33572,12396,21176,3.051,8.263,31461,7.744,16.526,105,131,8687
1988,4812,854,919,11888,11460,167,18.504,134,14.848,2772,982,1790,8.569,24.188,2012,1152,860,10.052,17.557,760,6.632,35.113,49,49,342
1988,4831,339,614,32862,32252,82,13.301,87,14.112,6458,1006,5452,3.119,20.024,5211,2632,2579,8.161,16.157,1247,3.866,32.315,22,22,196
1988,4832,291,326,11883,12389,33,9.955,44,13.273,2057,745,1312,6.014,16.604,3083,945,2138,7.628,24.886,-1026,-8.282,33.208,30,30,356
1988,4841,24763,31492,632326,608676,5474,17.567,4813,15.445,150469,49660,100809,8.159,24.721,101699,39132,62567,6.429,16.708,48770,8.012,33.416,3578,3631,22062
1988,4842,41196,44889,470054,463778,7767,17.459,6965,15.656,111466,44655,66811,9.629,24.034,98947,36526,62421,7.876,21.335,12519,2.699,42.670,5425,5458,24219
1988,4851,362,383,30645,31506,49,12.827,47,12.304,1977,576,1401,1.828,6.275,3707,1610,2097,5.110,11.766,-1730,-5.491,12.550,31,31,897
1988,4852,327,525,18388,19479,67,11.652,167,29.043,3101,1307,1794,6.710,15.920,5353,2342,3011,12.024,27.482,-2252,-11.561,31.840,34,34,269
1988,4853,4951,5001,53761,53470,934,18.673,936,18.713,11590,4827,6763,9.028,21.676,11031,5284,5747,9.882,20.630,559,1.045,41.261,778,778,4372
1988,4854,3237,3595,104532,103641,443,12.426,383,10.743,22211,11554,10657,11.148,21.431,20138,9000,11138,8.684,19.431,2073,2.000,38.861,287,297,6773
1988,4855,726,772,18180,17845,136,17.895,112,14.737,4250,1962,2288,10.995,23.816,3650,1698,1952,9.515,20.454,600,3.362,40.908,76,81,960
1988,4859,1254,1287,30471,29566,274,21.746,220,17.460,5822,2570,3252,8.693,19.692,4140,2264,1876,7.658,14.003,1682,5.689,28.006,168,168,1472
1988,4861,59,302,9756,9491,43,14.626,27,9.184,1527,689,838,7.260,16.090,1093,571,522,6.017,11.517,434,4.573,23.034,5,6,153
1988,4862,263,1306,55333,56902,135,10.254,156,11.850,6868,2057,4811,3.615,12.070,9880,2524,7356,4.436,17.363,-3012,-5.293,24.140,23,23,127
1988,4869,68,373,7809,7696,58,16.269,25,7.013,1366,396,970,5.146,17.749,1159,404,755,5.249,15.060,207,2.690,30.120,4,4,135
1988,4871,238,244,4628,4511,66,28.633,39,16.920,1203,404,799,8.956,26.668,1018,209,809,4.633,22.567,185,4.101,45.134,30,30,133
1988,4872,798,812,7257,6969,166,21.120,114,14.504,2025,851,1174,12.211,29.057,1460,470,990,6.744,20.950,565,8.107,41.900,86,87,386
1988,4879,74,77,653,727,17,22.973,11,14.865,276,70,206,9.635,37.990,394,342,52,47.075,54.233,-118,-16.242,75.981,7,7,24
1988,4881,2158,2734,73718,71790,408,14.853,434,15.799,16052,4822,11230,6.717,22.360,12452,5552,6900,7.734,17.345,3600,5.015,34.690,249,249,2490
1988,4882,379,586,14519,13707,135,24.658,58,10.594,3637,1313,2324,9.579,26.535,2052,856,1196,6.245,14.971,1585,11.564,29.942,38,38,449
1988,4883,2166,2619,86491,88082,358,13.664,360,13.740,20994,8502,12492,9.652,23.835,24101,9448,14653,10.726,27.362,-3107,-3.527,47.669,267,269,3914
1988,4884,3451,3694,27425,26841,846,23.651,612,17.109,8333,4495,3838,16.747,31.046,7335,4117,3218,15.338,27.328,998,3.718,54.655,387,397,2271
1988,4885,6746,9089,103061,100795,1547,17.588,961,10.925,25438,11375,14063,11.285,25.237,20615,7298,13317,7.240,20.452,4823,4.785,40.905,707,720,4851
1988,4889,580,589,7146,6707,129,22.974,74,13.179,2113,607,1506,9.051,31.507,1183,532,651,7.933,17.640,930,13.867,35.279,61,61,417
1988,4921,1680,3971,297635,286797,965,25.851,489,13.099,54027,24112,29915,8.407,18.838,29525,7867,21658,2.743,10.295,24502,8.543,20.589,293,297,4079
1988,4922,3568,3823,63124,58835,755,20.225,575,15.403,18631,5134,13497,8.726,31.667,10560,3216,7344,5.466,17.949,8071,13.718,35.897,461,461,2145
1988,4931,5828,9371,406249,402214,1044,11.179,980,10.494,75310,24220,51090,6.022,18.724,67339,23974,43365,5.961,16.742,7971,1.982,33.484,310,320,2871
1988,5111,13943,16305,675110,673441,1942,12.030,1618,10.023,71062,24319,46743,3.611,10.552,67799,24003,43796,3.564,10.068,3263,0.485,20.135,1255,1261,13499
1988,5112,2889,3287,56332,54440,833,26.754,486,15.609,15555,6053,9502,11.119,28.573,11823,5536,6287,10.169,21.717,3732,6.855,43.435,334,338,2440
1988,5121,9231,13759,214383,215830,2236,16.094,2504,18.023,64906,25582,39324,11.853,30.073,67789,22808,44981,10.568,31.409,-2883,-1.336,60.146,1466,1593,9178
1988,5122,2250,2268,15914,14641,698,32.670,435,20.360,5867,3077,2790,21.017,40.074,3252,1854,1398,12.664,22.212,2615,17.861,44.425,349,349,1441
1988,5151,6061,7538,235825,232426,1018,13.624,886,11.858,41543,20529,21014,8.833,17.874,34784,17132,17652,7.371,14.966,6759,2.908,29.931,648,653,9725
1988,5152,220,297,8375,7970,69,26.087,4,1.512,1588,851,737,10.678,19.925,745,33,712,0.414,9.348,843,10.577,18.695,3,3,31
1988,5173,5038,22122,1026572,1018757,2206,9.911,2476,11.125,101101,36209,64892,3.554,9.924,86552,20244,66308,1.987,8.496,14549,1.428,16.992,408,414,4897
1988,5174,155,287,15470,17613,54,15.147,193,54.137,3766,985,2781,5.592,21.382,7972,7063,909,40.101,45.262,-4206,-23.880,42.764,88,88,1990
1988,5179,773,1431,38184,40533,308,19.871,546,35.226,5225,2348,2877,5.793,12.891,9903,6613,3290,16.315,24.432,-4678,-11.541,25.782,217,219,2260
1988,5182,5469,7296,256358,249669,1155,15.956,1040,14.368,62924,27008,35916,10.818,25.203,49042,18740,30302,7.506,19.643,13882,5.560,39.286,645,654,5826
1988,5191,2402,2857,34373,35690,370,13.207,259,9.245,4990,2042,2948,5.721,13.982,7857,4919,2938,13.783,22.015,-2867,-8.033,27.963,185,186,899
1988,5211,47,86,24884,24762,4,4.678,3,3.509,951,64,887,0.258,3.841,731,26,705,0.105,2.952,220,0.888,5.904,D,D,D
1988,5221,16851,73733,1953246,1962571,5839,8.035,3704,5.097,268413,101661,166752,5.180,13.677,286154,73316,212838,3.736,14.581,-17741,-0.904,27.353,921,986,24638
1988,5222,23589,42623,572092,577868,4850,11.415,4581,10.782,103999,46681,57318,8.078,17.997,114697,45481,69216,7.870,19.848,-10698,-1.851,35.994,1792,1897,11117
1988,5223,4998,5697,61427,60892,1622,30.555,845,15.918,18213,11422,6791,18.758,29.910,17139,6603,10536,10.844,28.147,1074,1.764,56.293,622,627,4382
1988,5231,6769,13614,337426,353183,2228,16.379,2205,16.210,57539,20217,37322,5.724,16.292,86331,25156,61175,7.123,24.444,-28792,-8.152,32.583,969,1003,6969
1988,5232,98,113,7202,7130,11,9.244,23,19.328,753,41,712,0.575,10.562,588,66,522,0.926,8.247,165,2.314,16.495,13,13,39
1988,5239,15220,15870,182376,172960,3320,21.168,2948,18.796,56358,20919,35439,12.095,32.584,37979,18468,19511,10.678,21.958,18379,10.626,43.917,2350,2351,11351
1988,5241,6921,36749,1331164,1338088,5771,16.461,2391,6.820,199519,50959,148560,3.808,14.911,210283,53276,157007,3.982,15.715,-10764,-0.804,29.822,437,442,13208
1988,5242,100583,105784,768638,765020,13500,12.850,12047,11.467,156845,68354,88491,8.935,20.502,151249,63912,87337,8.354,19.771,5596,0.731,39.541,8937,8951,42089
1988,5259,848,1059,12947,12743,100,9.315,129,12.017,2142,792,1350,6.215,16.809,1731,991,740,7.777,13.584,411,3.225,27.168,97,98,665
1988,5311,96420,100304,554609,547500,13776,13.876,11723,11.808,127905,61789,66116,11.286,23.362,113035,48441,64594,8.848,20.646,14870,2.716,41.291,9179,9248,36209
1988,5312,37243,39472,222941,223059,7252,18.617,6214,15.953,58726,28280,30446,12.678,26.328,58650,25051,33599,11.231,26.294,76,0.034,52.587,4701,4711,17009
1988,5313,26247,27769,317191,308372,5013,18.338,4147,15.170,85584,39778,45806,12.899,27.754,67739,33031,34708,10.711,21.967,17845,5.787,43.933,3136,3140,20832
1988,5321,5927,10829,143072,138564,2113,20.147,1431,13.644,32682,15187,17495,10.960,23.586,23274,9381,13893,6.770,16.797,9408,6.790,33.593,872,896,4958
1988,5322,20418,25032,162184,153269,5282,21.930,3389,14.071,54609,25756,28853,16.804,35.630,36809,15709,21100,10.249,24.016,17800,11.614,48.032,2571,2671,11492
1988,5323,4248,5698,38615,37486,997,18.029,661,11.953,10384,4787,5597,12.770,27.701,7993,3464,4529,9.241,21.323,2391,6.378,42.646,472,492,2271
1988,5324,8386,10384,133483,124162,1723,16.877,1373,13.449,44015,25369,18646,20.432,35.450,26024,8692,17332,7.001,20.960,17991,14.490,41.919,999,1030,5906
1988,5331,920,998,13031,12841,272,29.044,149,15.910,4754,2384,2370,18.566,37.023,4375,1472,2903,11.464,34.072,379,2.952,68.144,105,105,723
1988,5411,132146,137064,904095,883200,15925,11.744,12998,9.586,162772,55867,106905,6.326,18.430,120864,44292,76572,5.015,13.685,41908,4.745,27.370,9503,9584,31710
1988,5412,67181,71412,622248,602294,11369,16.140,9427,13.383,135806,51329,84477,8.522,22.548,96056,40369,55687,6.703,15.948,39750,6.600,31.897,6923,7006,29800
1988,5413,59826,66430,895395,869716,10440,16.003,8058,12.352,193262,64171,129091,7.378,22.221,141495,47206,94289,5.428,16.269,51767,5.952,32.538,5844,5895,25181
1988,5414,15893,16172,103790,104143,3086,19.490,2410,15.220,27061,12835,14226,12.324,25.984,27829,12726,15103,12.220,26.722,-768,-0.737,51.969,1953,1957,8329
1988,5415,19730,22390,335606,321164,5764,27.075,3562,16.732,90487,37849,52638,11.785,28.175,61524,27187,34337,8.465,19.157,28963,9.018,38.313,2605,2622,12708
1988,5416,42003,43740,347350,328024,11901,28.354,8366,19.932,126025,62179,63846,18.956,38.419,87454,41391,46063,12.618,26.661,38571,11.759,53.322,6558,6598,31431
1988,5417,6743,8211,435677,432623,1276,15.789,1017,12.584,59460,15730,43730,3.636,13.744,54179,19089,35090,4.412,12.523,5281,1.221,25.047,658,662,5895
1988,5418,27200,29472,351622,347847,5289,18.335,4037,13.995,80112,32561,47551,9.361,23.031,71894,32029,39865,9.208,20.668,8218,2.363,41.337,3083,3110,16988
1988,5419,32225,35899,271008,264674,4611,13.060,3426,9.704,59735,22400,37335,8.463,22.569,47353,16726,30627,6.319,17.891,12382,4.678,35.782,2449,2501,10528
1988,5511,25544,47447,3065068,3051563,8204,17.842,5272,11.466,647254,215247,432007,7.054,21.211,619915,189129,430786,6.198,20.315,27339,0.896,40.629,869,920,14636
1988,5611,12753,13564,234854,226072,2535,19.032,2047,15.368,68813,30012,38801,13.275,30.439,51347,21795,29552,9.641,22.713,17466,7.726,45.425,1582,1593,14698
1988,5612,434,604,63673,60640,140,24.801,61,10.806,13442,6267,7175,10.335,22.167,7149,1960,5189,3.232,11.789,6293,10.378,23.578,38,38,1123
1988,5613,16585,22747,1217457,1151625,4693,21.522,2810,12.887,429674,136774,292900,11.877,37.310,298312,78590,219722,6.824,25.904,131362,11.407,51.807,1921,1963,42347
1988,5614,19867,22537,260786,252169,4061,18.403,3122,14.148,66613,27198,39415,10.786,26.416,49164,20711,28453,8.213,19.496,17449,6.920,38.993,2383,2405,12072
1988,5615,23695,28112,220372,213651,4146,15.097,2848,10.370,52883,21934,30949,10.266,24.752,39429,14906,24523,6.977,18.455,13454,6.297,36.910,2117,2171,10716
1988,5616,12339,14798,481200,461911,2426,16.508,2222,15.120,139804,64154,75650,13.889,30.266,99878,51558,48320,11.162,21.623,39926,8.644,43.246,1584,1588,18247
1988,5617,78960,82839,1015903,992756,19042,23.743,13766,17.164,270792,105538,165254,10.631,27.277,224058,89437,134621,9.009,22.569,46734,4.708,45.139,10665,10720,61917
1988,5619,13447,14458,200067,191751,2781,19.663,2151,15.209,57713,22392,35321,11.678,30.098,40409,16217,24192,8.457,21.074,17304,9.024,42.147,1624,1643,9811
1988,5621,5491,5641,62146,60428,779,13.923,687,12.279,14219,5650,8569,9.350,23.530,10754,4339,6415,7.180,17.796,3465,5.734,35.593,555,555,3391
1988,5622,1771,2504,62250,60226,429,17.582,301,12.336,13853,5841,8012,9.698,23.002,9561,5150,4411,8.551,15.875,4292,7.126,31.750,178,214,3757
1988,5629,4710,5026,53601,50421,918,18.685,692,14.085,15967,6232,9735,12.360,31.667,9459,4288,5171,8.504,18.760,6508,12.907,37.520,524,532,2856
1988,6111,13407,14471,440058,435507,681,4.719,598,4.144,40836,7553,33283,1.734,9.377,31715,6909,24806,1.586,7.282,9121,2.094,14.565,436,441,5480
1988,6112,492,687,53146,52557,59,8.715,39,5.761,8186,2433,5753,4.629,15.575,6908,937,5971,1.783,13.144,1278,2.432,26.288,17,22,331
1988,6113,1994,2335,968344,966338,102,4.384,85,3.654,68705,3414,65291,0.353,7.110,64971,2120,62851,0.219,6.723,3734,0.386,13.447,54,54,859
1988,6114,2385,2912,47602,45830,557,19.717,383,13.558,12173,3379,8794,7.373,26.561,8602,4629,3973,10.100,18.770,3571,7.792,37.539,260,266,3412
1988,6115,4242,5102,66706,63427,697,13.953,484,9.689,16244,4633,11611,7.304,25.611,9787,2681,7106,4.227,15.430,6457,10.180,30.861,332,344,1781
1988,6116,12097,12762,100632,96724,2686,21.742,1870,15.137,27835,12526,15309,12.950,28.778,20268,9008,11260,9.313,20.955,7567,7.823,41.909,1455,1468,7062
1988,6117,1624,1694,19524,18272,360,21.884,262,15.927,5321,2027,3294,11.093,29.121,2788,1246,1542,6.819,15.258,2533,13.863,30.517,207,207,995
1988,6211,183189,192065,1252373,1250036,14875,7.755,14367,7.490,218169,71404,146765,5.712,17.453,213679,64825,148854,5.186,17.094,4490,0.359,34.188,11331,11501,49195
1988,6212,98569,101294,505009,498386,6098,6.056,4891,4.857,78564,22742,55822,4.563,15.764,65362,16485,48877,3.308,13.115,13202,2.649,26.229,3760,3805,13027
1988,6213,52000,54500,205691,196972,7899,14.938,4654,8.801,51959,22945,29014,11.649,26.379,34623,13605,21018,6.907,17.578,17336,8.801,35.155,3274,3318,9851
1988,6214,7472,11227,189428,184316,1612,14.733,1041,9.514,43058,16550,26508,8.979,23.361,32743,11970,20773,6.494,17.765,10315,5.596,35.529,658,669,7054
1988,6215,5135,6559,93799,90703,1116,17.594,684,10.784,19564,7396,12168,8.154,21.569,13534,5603,7931,6.177,14.921,6030,6.648,29.843,451,461,3261
1988,6216,4770,6972,305219,300704,1556,23.512,848,12.814,79830,29064,50766,9.665,26.548,70663,25038,45625,8.326,23.499,9167,3.049,46.998,500,525,9522
1988,6219,5108,5890,109618,107463,1188,20.776,844,14.760,26790,11078,15712,10.309,24.930,22483,10998,11485,10.234,20.922,4307,4.008,41.843,608,617,7358
1988,6221,3766,5183,3636612,3599904,218,4.179,285,5.463,311045,99939,211106,2.776,8.640,237555,119899,117656,3.331,6.599,73490,2.041,13.198,140,152,74015
1988,6222,525,838,321100,304678,80,9.786,39,4.771,45064,32714,12350,10.737,14.791,13721,6299,7422,2.067,4.503,31343,10.287,9.007,18,18,3357
1988,6223,223,268,100279,97607,28,10.626,19,7.211,10547,5135,5412,5.261,10.806,5151,3120,2031,3.196,5.277,5396,5.528,10.555,9,9,1350
1988,6231,8078,13505,1143365,1130309,1166,8.737,846,6.339,151605,66859,84746,5.915,13.413,126390,48721,77669,4.310,11.182,25215,2.231,22.364,477,489,26040
1988,6232,5410,8527,193981,184163,1659,21.048,369,4.682,44246,21176,23070,11.499,24.026,24469,6437,18032,3.495,13.287,19777,10.739,26.573,219,221,4255
1988,6233,8810,10408,262830,257821,1789,17.737,1146,11.362,50909,24567,26342,9.529,19.746,40988,19334,21654,7.499,15.898,9921,3.848,31.796,765,784,12145
1988,6239,3382,4383,106484,104183,617,14.598,304,7.193,17782,6798,10984,6.525,17.068,13199,4078,9121,3.914,12.669,4583,4.399,25.338,192,195,2845
1988,6241,16981,22656,317806,309180,2811,12.780,1488,6.765,59099,19974,39125,6.460,19.115,42188,9500,32688,3.073,13.645,16911,5.470,27.290,832,846,5216
1988,6242,4821,5686,59275,56882,696,12.635,341,6.190,12501,4694,7807,8.252,21.977,7730,2357,5373,4.144,13.590,4771,8.388,27.179,200,201,1659
1988,6243,4533,6715,265197,262394,648,9.809,430,6.509,46209,8993,37216,3.427,17.611,39967,5842,34125,2.226,15.232,6242,2.379,30.463,196,202,2183
1988,6244,32996,39517,373188,361391,5428,14.029,3778,9.764,79977,33967,46010,9.399,22.130,56354,21527,34827,5.957,15.594,23623,6.537,31.187,2835,2893,15572
1988,7111,4697,4744,64948,65396,866,18.303,841,17.774,16849,4515,12334,6.904,25.765,17507,5775,11732,8.831,26.771,-658,-1.006,51.529,616,616,3406
1988,7112,2317,2437,66419,68968,438,18.133,395,16.353,12203,3417,8786,4.954,17.694,17334,3687,13647,5.346,25.133,-5131,-7.440,35.387,290,290,1989
1988,7113,2036,2093,31559,31849,396,19.308,312,15.212,8851,2628,6223,8.252,27.791,9177,4058,5119,12.742,28.815,-326,-1.024,55.582,232,233,3711
1988,7114,1250,1272,15108,14127,253,20.379,192,15.465,4910,1951,2959,13.810,34.756,2961,1348,1613,9.542,20.960,1949,13.796,41.920,148,149,1077
1988,7115,11128,11174,70124,64641,4022,38.723,2447,23.559,34710,16255,18455,25.147,53.697,23807,11237,12570,17.384,36.830,10903,16.867,73.660,1850,1854,6564
1988,7121,2833,3057,55740,54317,336,11.313,162,5.455,7522,1462,6060,2.692,13.848,4734,1303,3431,2.399,8.716,2788,5.133,17.431,107,110,851
1988,7131,1653,2286,66448,64006,319,14.013,300,13.178,13575,5374,8201,8.396,21.209,8532,3275,5257,5.117,13.330,5043,7.879,26.660,233,237,1905
1988,7132,743,773,22116,21147,169,22.700,112,15.044,4824,1872,2952,8.853,22.812,2889,1125,1764,5.320,13.662,1935,9.150,27.324,85,85,886
1988,7139,36410,39597,591202,578596,6397,16.546,4526,11.707,127177,48991,78186,8.467,21.980,101773,39387,62386,6.807,17.590,25404,4.391,35.179,3408,3471,27506
1988,7211,29994,35771,1324484,1305879,5229,14.817,4270,12.099,275138,130825,144313,10.018,21.069,239202,110891,128311,8.492,18.317,35936,2.752,36.635,3031,3133,64493
1988,7212,3946,4234,26359,26027,623,15.096,409,9.910,7570,3315,4255,12.737,29.086,6919,3102,3817,11.919,26.584,651,2.501,53.169,264,266,1245
1988,7213,3732,3837,18595,19936,338,8.755,385,9.973,3621,1236,2385,6.200,18.164,6054,4462,1592,22.382,30.368,-2433,-12.204,36.327,270,270,4124
1988,7223,13035,18707,350437,342571,3918,21.464,3011,16.495,96941,51213,45728,14.950,28.298,81748,31796,49952,9.282,23.863,15193,4.435,47.726,2068,2082,18863
1988,7224,51524,52516,309450,311710,7964,15.091,8479,16.067,81168,43218,37950,13.865,26.040,86094,41276,44818,13.242,27.620,-4926,-1.580,52.079,6650,6677,33132
1988,7225,214929,295894,5624489,5533787,51063,17.539,41570,14.278,1326526,707938,618588,12.793,23.971,1151434,454608,696826,8.215,20.807,175092,3.164,41.615,28574,29369,287005
1988,8111,111269,117799,610394,596594,18979,16.352,15516,13.368,149633,70683,78950,11.848,25.081,122204,52657,69547,8.826,20.484,27429,4.598,40.967,11827,11997,41067
1988,8112,11455,13721,116791,113900,2208,16.392,1706,12.665,26280,11612,14668,10.195,23.073,20567,7682,12885,6.745,18.057,5713,5.016,36.114,1248,1255,3708
1988,8113,20670,21874,163789,160371,3042,14.014,2707,12.471,34851,11774,23077,7.342,21.731,27900,11444,16456,7.136,17.397,6951,4.334,34.794,2068,2074,8257
1988,8114,24168,25934,166978,160466,4398,17.085,4014,15.593,40096,17384,22712,10.833,24.987,27434,11470,15964,7.148,17.096,12662,7.891,34.193,3069,3080,8345
1988,8121,76417,85561,436622,430480,13718,16.182,12141,14.322,108148,59443,48705,13.809,25.123,95767,46606,49161,10.827,22.247,12381,2.876,44.493,9299,9407,31228
1988,8122,17208,20383,124982,124657,1602,7.897,1408,6.941,19673,7476,12197,5.997,15.782,18958,5335,13623,4.280,15.208,715,0.574,30.416,920,976,3924
1988,8123,33738,40330,374801,370977,5595,14.000,4863,12.168,72382,29958,42424,8.075,19.511,64589,25831,38758,6.963,17.411,7793,2.101,34.821,3495,3619,18244
1988,8129,13233,21645,172278,171541,4216,19.991,3104,14.719,42116,19318,22798,11.261,24.552,40651,16509,24142,9.624,23.698,1465,0.854,47.395,1706,1734,8859
1988,8131,127849,127914,1044700,1030431,6271,4.931,4795,3.770,127909,18671,109238,1.812,12.413,98815,15347,83468,1.489,9.590,29094,2.823,19.179,2954,2954,9042
1988,8132,8627,9807,134665,132284,1135,11.910,580,6.086,23096,7011,16085,5.300,17.459,18461,3710,14751,2.805,13.956,4635,3.504,27.911,401,402,2075
1988,8133,7654,8973,97288,96555,1181,13.586,621,7.144,16807,6345,10462,6.571,17.407,15328,3132,12196,3.244,15.875,1479,1.532,31.750,418,419,2123
1988,8134,29779,31260,276487,272468,2423,7.829,1801,5.819,40983,9473,31510,3.477,15.041,32771,6646,26125,2.439,12.027,8212,3.014,24.055,1164,1169,3972
1988,8139,57475,59886,478963,477815,5017,8.422,4383,7.358,82867,20910,61957,4.376,17.343,80828,22665,58163,4.743,16.916,2039,0.427,33.832,3044,3047,13421
1989,1131,211,222,2199,2292,38,17.117,38,17.117,490,229,261,9.993,21.383,644,353,291,15.405,28.104,-154,-6.720,42.767,33,33,320
1989,1132,88,103,1648,1603,16,15.842,12,11.881,479,99,380,6.178,29.891,357,50,307,3.120,22.278,122,7.613,44.555,7,7,34
1989,1133,10959,11041,89309,89700,1692,15.427,1545,14.087,20624,7611,13013,8.485,22.992,21395,7171,14224,7.994,23.852,-771,-0.860,45.985,1164,1164,5525
1989,1141,1015,1021,7153,7121,174,16.739,211,20.298,2482,1206,1276,16.936,34.855,2400,1036,1364,14.549,33.703,82,1.152,67.406,156,156,781
1989,1142,146,150,1250,1129,36,24.658,28,19.178,376,226,150,20.018,33.304,156,85,71,7.529,13.818,220,19.486,27.635,24,24,77
1989,1151,3874,4215,52845,53159,602,14.499,476,11.464,14429,5744,8685,10.805,27.143,15183,4336,10847,8.157,28.561,-754,-1.418,54.286,336,336,2681
1989,1152,1991,2009,13929,13975,316,15.935,264,13.313,2661,1006,1655,7.199,19.041,2773,830,1943,5.939,19.843,-112,-0.801,38.082,196,197,575
1989,1153,805,816,10895,10813,146,18.137,124,15.404,3024,1073,1951,9.923,27.966,2829,1010,1819,9.341,26.163,195,1.803,52.326,88,88,806
1989,2111,6898,8391,116210,120664,837,9.783,1167,13.640,16377,4432,11945,3.673,13.572,25210,9599,15611,7.955,20.893,-8833,-7.320,27.145,805,814,3414
1989,2121,2163,2725,137288,140895,430,15.523,520,18.773,19503,8084,11419,5.738,13.842,26593,10630,15963,7.545,18.874,-7090,-5.032,27.684,378,382,5344
1989,2122,477,639,44158,42211,114,17.910,109,17.125,8080,2426,5654,5.747,19.142,4278,1627,2651,3.854,10.135,3802,9.007,20.270,83,83,541
1989,2123,3489,5049,107168,107406,442,8.747,450,8.906,16620,6179,10441,5.753,15.474,17005,5866,11139,5.462,15.833,-385,-0.358,30.948,274,278,2586
1989,2131,7795,8911,154595,158149,1131,12.415,1529,16.784,41082,16747,24335,10.589,25.977,48447,21728,26719,13.739,30.634,-7365,-4.657,51.954,1015,1034,10207
1989,2211,1761,6116,593447,594565,253,4.171,153,2.522,26467,8069,18398,1.357,4.451,28680,2750,25930,0.463,4.824,-2213,-0.372,8.903,51,51,731
1989,2212,605,2460,139397,142119,174,7.008,220,8.860,8721,2999,5722,2.110,6.136,13914,6848,7066,4.819,9.790,-5193,-3.654,12.273,48,48,278
1989,2213,4038,4296,33286,32423,390,9.221,257,6.076,5164,1887,3277,5.820,15.927,3463,1316,2147,4.059,10.681,1701,5.246,21.361,188,188,731
1989,2361,110688,111100,660532,650846,22363,20.397,19439,17.730,211685,85763,125922,13.177,32.525,192353,76815,115538,11.802,29.554,19332,2.970,59.109,14292,14299,58141
1989,2362,38271,38978,717584,711560,5015,12.890,4872,12.522,180082,39396,140686,5.537,25.308,168882,39986,128896,5.619,23.734,11200,1.574,47.468,3733,3742,29360
1989,2371,13511,13814,297811,297769,1379,9.982,1380,9.990,64459,14685,49774,4.932,21.647,64407,13964,50443,4.690,21.630,52,0.017,43.260,1028,1029,7856
1989,2372,9934,10150,85735,82215,2210,21.884,2107,20.864,30950,15009,15941,18.256,37.645,24067,12109,11958,14.729,29.273,6883,8.372,58.547,1725,1728,8370
1989,2373,9558,9951,249755,256680,997,10.002,1031,10.343,45864,9820,36044,3.826,17.868,59541,10759,48782,4.192,23.197,-13677,-5.328,35.736,774,775,7212
1989,2379,4928,4985,76247,77268,700,13.932,779,15.504,17215,3782,13433,4.895,22.280,19353,6919,12434,8.955,25.047,-2138,-2.767,44.559,594,594,3766
1989,2381,77153,77576,757421,746385,11464,14.844,10775,13.952,210782,57620,153162,7.720,28.240,188669,61690,126979,8.265,25.278,22113,2.963,50.555,8357,8368,50486
1989,2382,119772,121566,1287189,1266184,15805,13.143,13189,10.967,286794,69376,217418,5.479,22.650,244807,82219,162588,6.493,19.334,41987,3.316,38.668,10106,10126,54616
1989,2383,80385,80842,700930,684944,14252,17.746,13187,16.420,207204,62922,144282,9.186,30.251,174603,59705,114898,8.717,25.492,32601,4.760,50.983,10145,10151,47084
1989,2389,41356,41596,371336,363405,6178,14.980,5471,13.265,102778,29579,73199,8.139,28.282,86332,28506,57826,7.844,23.756,16446,4.526,47.513,4151,4151,20931
1989,3111,1184,1784,47667,48228,88,4.885,123,6.828,5008,1166,3842,2.418,10.384,6160,2015,4145,4.178,12.773,-1152,-2.389,20.768,70,70,704
1989,3112,481,825,65581,65506,59,7.182,52,6.330,5104,1007,4097,1.537,7.792,4877,1221,3656,1.864,7.445,227,0.347,14.890,30,30,233
1989,3113,1606,1903,87395,87316,210,11.044,207,10.886,11003,2416,8587,2.767,12.601,10860,2958,7902,3.388,12.438,143,0.164,24.875,134,145,925
1989,3114,1188,1612,174151,171132,148,9.279,114,7.147,23326,4381,18945,2.560,13.630,17175,4554,12621,2.661,10.036,6151,3.594,20.072,73,76,1870
1989,3115,1469,2096,138837,138487,114,5.368,169,7.959,14780,2821,11959,2.037,10.672,14152,5933,8219,4.284,10.219,628,0.453,20.438,93,94,1218
1989,3116,3781,4400,371246,364323,338,7.648,377,8.530,44005,12658,31347,3.474,12.079,30319,9443,20876,2.592,8.322,13686,3.757,16.644,278,279,4409
1989,3117,712,824,47518,47059,83,10.103,78,9.495,9182,1916,7266,4.072,19.512,8292,3413,4879,7.253,17.621,890,1.891,35.241,50,50,1792
1989,3118,9097,10612,306706,307551,1331,12.487,1425,13.369,36792,11096,25696,3.608,11.963,38752,16073,22679,5.226,12.600,-1960,-0.637,23.926,1026,1047,9709
1989,3119,2068,2424,134349,136608,263,10.872,253,10.459,15404,3716,11688,2.720,11.276,20283,5718,14565,4.186,14.848,-4879,-3.572,22.552,179,182,2437
1989,3121,1747,2216,140987,144588,189,8.413,250,11.128,12447,2184,10263,1.510,8.609,19777,8998,10779,6.223,13.678,-7330,-5.070,17.217,164,165,2862
1989,3122,99,135,36705,35993,13,9.665,12,8.922,4907,2694,2213,7.485,13.633,3411,322,3089,0.895,9.477,1496,4.156,18.954,8,8,186
1989,3131,405,631,110908,111702,44,7.029,34,5.431,10213,2972,7241,2.661,9.143,11874,3348,8526,2.997,10.630,-1661,-1.487,18.286,18,18,704
1989,3132,1640,1986,256634,257407,168,8.478,159,8.024,22554,6055,16499,2.352,8.762,24162,5391,18771,2.094,9.387,-1608,-0.625,17.524,121,121,1925
1989,3133,5444,6133,148053,147842,511,8.215,685,11.013,20744,5362,15382,3.627,14.031,20009,7289,12720,4.930,13.534,735,0.497,27.068,512,516,3718
1989,3141,3725,4018,134437,132360,465,11.603,444,11.079,18489,4790,13699,3.619,13.969,14068,3384,10684,2.557,10.629,4421,3.340,21.257,361,367,2065
1989,3149,3845,3952,116103,113805,596,15.422,421,10.894,22768,8367,14401,7.352,20.006,18156,8337,9819,7.326,15.954,4612,4.053,31.907,341,342,5390
1989,3151,1260,1387,141642,140960,132,9.483,142,10.201,16743,3418,13325,2.425,11.878,15590,3853,11737,2.733,11.060,1153,0.818,22.120,114,115,2163
1989,3152,11392,12747,782568,785868,1975,15.409,2116,16.509,121976,41955,80021,5.339,15.521,128048,56459,71589,7.184,16.294,-6072,-0.773,31.042,1797,1810,36455
1989,3159,1834,1911,62413,61941,297,15.806,233,12.400,10799,3706,7093,5.983,17.434,9849,3931,5918,6.346,15.901,950,1.534,31.801,206,206,3115
1989,3161,333,360,16185,15575,39,10.986,29,8.169,2475,314,2161,2.016,15.891,1273,436,837,2.799,8.173,1202,7.717,16.347,25,25,277
1989,3162,370,493,77521,80294,33,6.483,65,12.770,5709,684,5025,0.852,7.110,11171,3996,7175,4.977,13.913,-5462,-6.803,14.220,44,45,1050
1989,3169,1098,1147,37387,37497,118,10.212,135,11.683,5334,1194,4140,3.184,14.225,5606,1665,3941,4.440,14.951,-272,-0.725,28.451,114,114,1379
1989,3211,4579,5104,144692,145243,504,9.870,509,9.968,17604,4897,12707,3.372,12.120,18728,6078,12650,4.185,12.894,-1124,-0.774,24.241,392,392,2876
1989,3212,1303,1603,104258,105147,143,8.882,157,9.752,11084,3157,7927,3.002,10.541,12622,5463,7159,5.196,12.004,-1538,-1.463,21.083,101,101,2017
1989,3219,9149,9828,293599,288948,1129,11.518,1077,10.988,52128,15510,36618,5.368,18.041,43035,16834,26201,5.826,14.894,9093,3.147,29.787,818,821,8725
1989,3221,227,544,192585,191478,25,4.587,27,4.954,9365,1663,7702,0.869,4.891,7445,2694,4751,1.407,3.888,1920,1.003,7.776,16,16,688
1989,3222,3583,5180,400039,398742,288,5.551,305,5.878,34586,6312,28274,1.583,8.674,31798,9667,22131,2.424,7.975,2788,0.699,15.949,206,208,4848
1989,3231,41602,43516,849322,840588,4755,11.017,4044,9.370,109736,28846,80890,3.432,13.055,92007,32350,59657,3.848,10.946,17729,2.109,21.891,3183,3203,20365
1989,3241,1252,2155,112258,112373,168,7.825,152,7.080,8514,2909,5605,2.589,7.577,8827,1619,7208,1.441,7.855,-313,-0.279,15.153,82,83,474
1989,3251,1132,2289,226609,226751,172,7.537,158,6.924,18687,5490,13197,2.421,8.241,18878,11235,7643,4.955,8.325,-191,-0.084,16.482,68,68,600
1989,3252,361,638,135295,133334,47,7.361,48,7.518,9519,2069,7450,1.552,7.139,5562,2278,3284,1.708,4.171,3957,2.968,8.343,22,25,1388
1989,3253,620,882,42561,41986,65,7.336,73,8.239,4701,948,3753,2.258,11.197,3472,1282,2190,3.053,8.270,1229,2.927,16.539,38,40,590
1989,3254,1078,1339,173137,168195,120,9.040,97,7.307,20302,4620,15682,2.747,12.071,10423,2866,7557,1.704,6.197,9879,5.874,12.394,58,58,492
1989,3255,1634,2163,77694,77421,162,7.549,128,5.965,7916,2225,5691,2.874,10.225,7237,2149,5088,2.776,9.348,679,0.877,18.695,82,83,925
1989,3256,2034,2290,122752,121765,204,8.912,202,8.825,15401,3131,12270,2.571,12.648,13494,5650,7844,4.640,11.082,1907,1.566,22.164,145,145,1360
1989,3259,2098,2744,143133,142789,244,8.891,245,8.927,14479,2803,11676,1.963,10.140,14035,6323,7712,4.428,9.829,444,0.311,19.658,143,143,1975
1989,3261,9964,11867,682578,669382,1107,9.395,938,7.961,100787,23756,77031,3.549,15.057,73947,25199,48748,3.765,11.047,26840,4.010,22.094,632,646,10238
1989,3262,2130,2603,200119,196023,245,9.511,191,7.415,21093,3688,17405,1.881,10.760,12879,3791,9088,1.934,6.570,8214,4.190,13.140,129,130,1127
1989,3271,1414,1706,83403,83238,200,11.880,155,9.207,9586,1816,7770,2.182,11.516,9416,2261,7155,2.716,11.312,170,0.204,22.624,110,111,981
1989,3272,1733,1987,147818,145864,233,11.833,197,10.005,14177,2724,11453,1.867,9.719,10058,2605,7453,1.786,6.895,4119,2.824,13.791,143,143,1252
1989,3273,6469,9006,191285,190929,682,7.553,729,8.074,31327,8857,22470,4.639,16.408,30392,10109,20283,5.295,15.918,935,0.490,31.836,459,465,5729
1989,3274,269,359,18383,18285,40,11.189,37,10.350,1748,668,1080,3.653,9.560,1505,815,690,4.457,8.231,243,1.329,16.462,23,23,130
1989,3279,1900,2200,77653,77922,199,9.085,180,8.217,7918,1865,6053,2.393,10.161,8463,3179,5284,4.080,10.861,-545,-0.699,20.323,129,130,1449
1989,3311,344,414,191225,194081,32,7.646,41,9.797,7233,1150,6083,0.593,3.727,13249,6977,6272,3.595,6.827,-6016,-3.100,7.454,27,28,646
1989,3312,532,723,68669,67651,59,8.258,42,5.878,7313,2212,5101,3.270,10.810,5423,1979,3444,2.925,8.016,1890,2.794,16.032,22,22,389
1989,3313,338,486,89538,88311,37,7.676,29,6.017,7305,1764,5541,1.997,8.272,4813,1858,2955,2.104,5.450,2492,2.822,10.900,16,16,364
1989,3314,763,928,82559,82476,80,8.611,82,8.827,7421,1817,5604,2.203,8.998,7244,3243,4001,3.932,8.783,177,0.215,17.566,54,56,942
1989,3315,2538,2801,225507,219799,192,6.860,188,6.717,28103,6081,22022,2.767,12.786,16650,6848,9802,3.116,7.575,11453,5.211,15.150,126,127,2546
1989,3321,3305,3506,147339,146128,249,7.103,248,7.075,17788,3906,13882,2.673,12.173,15345,6374,8971,4.362,10.501,2443,1.672,21.002,161,173,2971
1989,3322,1310,1446,82956,80565,120,8.345,104,7.232,9968,3610,6358,4.481,12.373,5363,1283,4080,1.593,6.657,4605,5.716,13.313,78,78,691
1989,3323,10077,10905,351018,345624,953,8.763,893,8.211,55258,13547,41711,3.920,15.988,44628,17815,26813,5.154,12.912,10630,3.076,25.825,674,681,9407
1989,3324,1515,1850,119557,117234,131,7.087,128,6.925,15257,2669,12588,2.277,13.014,10758,2908,7850,2.481,9.177,4499,3.838,18.353,94,102,2128
1989,3325,995,1085,73717,74460,105,9.758,87,8.086,8827,2722,6105,3.656,11.855,10283,5256,5027,7.059,13.810,-1456,-1.955,23.709,62,63,708
1989,3326,1780,1984,75166,73768,268,13.980,134,6.990,10391,2796,7595,3.790,14.086,7566,2799,4767,3.794,10.257,2825,3.830,20.513,95,95,1232
1989,3327,21436,21747,345596,336692,1995,9.218,1784,8.243,55080,10976,44104,3.260,16.359,37235,13159,24076,3.908,11.059,17845,5.300,22.118,1380,1381,8877
1989,3328,5530,5874,143668,140556,434,7.406,407,6.945,22342,4790,17552,3.408,15.896,16070,5169,10901,3.678,11.433,6272,4.462,22.866,304,305,3323
1989,3329,6717,7212,371754,366774,869,12.291,586,8.288,43179,12083,31096,3.294,11.773,32748,8711,24037,2.375,8.929,10431,2.844,17.857,454,456,4983
1989,3331,2913,3169,212018,205950,252,7.933,267,8.405,28681,4410,24271,2.141,13.926,16491,6314,10177,3.066,8.007,12190,5.919,16.015,189,190,2708
1989,3332,4186,4427,177783,172999,374,8.540,279,6.371,25513,5315,20198,3.072,14.747,16118,4718,11400,2.727,9.317,9395,5.431,18.634,202,202,2328
1989,3333,2240,2370,153405,153204,204,8.620,197,8.325,17175,3888,13287,2.538,11.211,16738,5500,11238,3.590,10.925,437,0.285,21.851,136,136,1289
1989,3334,1626,1879,165013,164514,172,9.166,167,8.900,18237,4418,13819,2.685,11.085,17207,6730,10477,4.091,10.459,1030,0.626,20.919,114,114,2257
1989,3335,9363,9687,231826,225152,738,7.668,613,6.369,32769,6767,26002,3.006,14.554,19532,7508,12024,3.335,8.675,13237,5.879,17.350,479,481,4822
1989,3336,735,884,134250,132007,49,5.496,64,7.179,14549,3482,11067,2.638,11.021,9724,3380,6344,2.560,7.366,4825,3.655,14.733,38,38,726
1989,3339,5387,5975,327712,323474,450,7.544,430,7.209,40514,8525,31989,2.635,12.525,31948,13356,18592,4.129,9.877,8566,2.648,19.753,289,290,3674
1989,3341,1626,1776,266506,269803,263,14.918,237,13.443,35642,7348,28294,2.723,13.210,43194,12552,30642,4.652,16.009,-7552,-2.799,26.421,180,181,6284
1989,3342,1564,1764,255388,253705,218,12.689,126,7.334,31257,6445,24812,2.540,12.320,27896,5782,22114,2.279,10.995,3361,1.325,21.991,79,79,1681
1989,3343,410,435,35528,33564,62,14.815,29,6.930,6314,822,5492,2.449,18.812,2302,432,1870,1.287,6.859,4012,11.953,13.717,23,23,268
1989,3344,4868,5482,531766,526754,762,14.238,502,9.380,71062,21458,49604,4.074,13.491,61773,23893,37880,4.536,11.727,9289,1.763,23.454,337,342,6363
1989,3345,4405,5034,669407,672892,394,7.783,451,8.909,68738,25444,43294,3.781,10.215,75407,25729,49678,3.824,11.206,-6669,-0.991,20.431,262,262,2907
1989,3346,748,787,45618,46417,115,14.668,109,13.903,8429,1783,6646,3.841,18.159,10190,6228,3962,13.417,21.953,-1761,-3.794,36.319,85,85,596
1989,3351,1170,1293,84764,85685,110,8.481,118,9.098,7462,1148,6314,1.340,8.709,9188,3018,6170,3.522,10.723,-1726,-2.014,17.417,90,90,1000
1989,3352,330,411,111421,112209,38,9.190,43,10.399,10436,2577,7859,2.297,9.301,12032,5124,6908,4.566,10.723,-1596,-1.422,18.601,24,24,622
1989,3353,2130,2571,233375,232816,193,7.520,184,7.169,22118,2865,19253,1.231,9.500,20864,7845,13019,3.370,8.962,1254,0.539,17.923,106,112,1219
1989,3359,2251,2646,214387,212095,205,7.715,227,8.543,24230,7160,17070,3.376,11.424,19828,7371,12457,3.475,9.349,4402,2.075,18.697,145,146,1387
1989,3361,238,299,230972,235684,40,13.722,25,8.576,22948,3763,19185,1.597,9.737,32545,5506,27039,2.336,13.809,-9597,-4.072,19.474,17,17,247
1989,3362,1848,2056,124854,126369,198,9.570,224,10.826,17766,4163,13603,3.294,14.059,20885,10930,9955,8.649,16.527,-3119,-2.468,28.118,155,156,2701
1989,3363,4052,4902,683287,669597,491,10.122,389,8.019,72439,16869,55570,2.519,10.818,45381,17276,28105,2.580,6.777,27058,4.041,13.555,257,260,4225
1989,3364,1415,1729,679663,668008,152,8.873,120,7.005,90713,60531,30182,9.061,13.580,65327,9058,56269,1.356,9.779,25386,3.800,19.559,88,90,5248
1989,3365,167,201,31449,29519,25,12.788,14,7.161,5682,1254,4428,4.248,19.249,1835,365,1470,1.236,6.216,3847,13.032,12.433,11,11,255
1989,3366,1278,1386,168363,166943,164,11.984,129,9.426,21116,3379,17737,2.024,12.649,18470,3714,14756,2.225,11.064,2646,1.585,22.127,87,87,1482
1989,3369,492,507,31674,31011,58,11.451,57,11.254,4483,1208,3275,3.895,14.456,3178,1076,2102,3.470,10.248,1305,4.208,20.496,42,43,427
1989,3371,13725,14449,404085,406003,1940,13.482,1822,12.662,52919,14649,38270,3.608,13.034,56809,22308,34501,5.495,13.992,-3890,-0.958,26.068,1436,1454,14649
1989,3372,3113,3300,163672,163185,381,11.743,270,8.322,20212,5309,14903,3.253,12.386,19408,5913,13495,3.624,11.893,804,0.493,23.787,206,206,2906
1989,3379,1123,1281,42868,42691,134,10.539,115,9.044,6003,2123,3880,4.973,14.062,5730,1783,3947,4.177,13.422,273,0.639,26.844,84,86,778
1989,3391,10462,10958,258006,252118,1082,9.860,1114,10.151,40384,9524,30860,3.778,16.018,28822,13483,15339,5.348,11.432,11562,4.586,22.864,802,803,4311
1989,3399,16100,16610,422719,416606,2236,13.658,1759,10.744,66545,18478,48067,4.435,15.973,54386,20644,33742,4.955,13.055,12159,2.919,26.109,1409,1409,11685
1989,4231,18636,22192,266945,263891,2325,10.474,2335,10.519,43530,14995,28535,5.682,16.495,37383,15149,22234,5.741,14.166,6147,2.329,28.332,1709,1768,9051
1989,4232,8068,9170,116502,114477,1209,13.236,1137,12.448,22021,7444,14577,6.503,19.236,18163,6958,11205,6.078,15.866,3858,3.370,31.732,870,884,4580
1989,4233,8080,10444,138231,136824,1213,11.714,1035,9.995,23650,7536,16114,5.508,17.285,20712,7359,13353,5.378,15.138,2938,2.147,30.275,727,742,4628
1989,4234,24783,34093,625095,615743,4316,12.646,4390,12.863,117906,41540,76366,6.746,19.149,98147,52218,45929,8.480,15.940,19759,3.209,31.879,2470,2566,18208
1989,4235,6980,9307,141941,139977,947,10.265,784,8.498,22810,7590,15220,5.422,16.296,19186,5993,13193,4.281,13.707,3624,2.589,27.413,495,517,2798
1989,4236,15911,22368,308346,307355,2848,12.833,2498,11.256,66721,22145,44576,7.205,21.708,65244,35109,30135,11.423,21.228,1477,0.481,42.455,1391,1440,10026
1989,4237,10757,14592,161724,159944,1347,9.283,1184,8.160,24015,7596,16419,4.749,15.015,20380,7363,13017,4.604,12.742,3635,2.273,25.484,819,851,5114
1989,4238,48371,62873,693641,676672,6176,9.912,5048,8.102,117292,33721,83571,4.983,17.334,83702,30281,53421,4.475,12.370,33590,4.964,24.739,3235,3392,17485
1989,4239,25298,27080,273611,268634,3690,13.684,3460,12.831,55525,16635,38890,6.192,20.669,45587,18761,26826,6.984,16.970,9938,3.699,33.940,2724,2752,12495
1989,4241,8763,11827,175140,173795,1183,10.099,957,8.170,25091,7535,17556,4.336,14.437,22389,8357,14032,4.809,12.882,2702,1.555,25.765,635,652,4086
1989,4242,3101,4119,115947,113784,709,17.611,523,12.991,21376,6745,14631,5.928,18.787,16970,9114,7856,8.010,14.914,4406,3.872,29.829,358,364,2733
1989,4243,8750,9355,121768,117719,1855,20.357,1370,15.034,30303,10404,19899,8.838,25.742,22263,9093,13170,7.724,18.912,8040,6.830,37.824,1092,1107,6506
1989,4244,27431,33960,696329,688272,3883,11.413,4007,11.778,114776,33690,81086,4.895,16.676,97970,40085,57885,5.824,14.234,16806,2.442,28.468,2942,2987,23261
1989,4245,6963,9907,84811,86200,572,5.721,755,7.551,11281,3262,8019,3.784,13.087,14058,3706,10352,4.299,16.309,-2777,-3.222,26.174,498,538,2605
1989,4246,7730,11221,132319,129757,1156,10.385,976,8.768,23410,6149,17261,4.739,18.041,18450,6902,11548,5.319,14.219,4960,3.823,28.438,547,559,2783
1989,4247,9345,12525,135206,135381,897,7.117,1054,8.363,23164,7666,15498,5.663,17.110,23692,8145,15547,6.016,17.500,-528,-0.390,34.220,686,710,4658
1989,4248,3881,4930,138380,139742,320,6.390,475,9.486,16696,5498,11198,3.934,11.948,19383,9268,10115,6.632,13.871,-2687,-1.923,23.896,318,335,3696
1989,4249,20048,24039,288726,283112,3338,14.051,2771,11.665,53771,18545,35226,6.550,18.993,42564,17525,25039,6.190,15.034,11207,3.959,30.069,2059,2081,11193
1989,4251,30877,33367,307241,302245,3709,11.228,3044,9.215,57532,19184,38348,6.347,19.035,47653,18491,29162,6.118,15.766,9879,3.269,31.533,2093,2104,9804
1989,4411,39423,41361,1029449,1019539,4768,11.591,4319,10.499,145912,57827,88085,5.672,14.312,126225,53489,72736,5.246,12.381,19687,1.931,24.761,3474,3498,41218
1989,4412,11449,12140,93591,93046,1307,10.779,1278,10.540,18131,6161,11970,6.621,19.486,17032,6961,10071,7.481,18.305,1099,1.181,36.610,1051,1072,5797
1989,4413,43573,62588,478894,472806,5366,8.578,5299,8.471,82747,30675,52072,6.488,17.501,70448,25562,44886,5.406,14.900,12299,2.601,29.800,3631,3865,17117
1989,4421,21993,28294,244905,243275,3067,10.872,2898,10.273,43521,15653,27868,6.434,17.890,40159,14638,25521,6.017,16.508,3362,1.382,33.015,2114,2285,10542
1989,4422,23638,29982,201290,195562,3903,13.169,3213,10.841,45935,18353,27582,9.385,23.489,34882,13199,21683,6.749,17.837,11053,5.652,35.674,2380,2478,9169
1989,4431,29514,45002,334749,324318,5844,13.120,4925,11.057,76693,33003,43690,10.176,23.647,55652,23293,32359,7.182,17.160,21041,6.488,34.319,3353,3585,15074
1989,4441,56815,75072,849450,837128,6599,8.844,5686,7.620,135461,51887,83574,6.198,16.182,111653,35243,76410,4.210,13.338,23808,2.844,26.675,4151,4275,23079
1989,4442,17980,21951,170235,169489,1970,9.005,1820,8.320,28729,8977,19752,5.297,16.950,27245,7796,19449,4.600,16.075,1484,0.876,32.150,1344,1375,5474
1989,4451,62978,94861,2365299,2300563,11082,11.678,11156,11.756,384846,175717,209129,7.638,16.728,256875,109795,147080,4.773,11.166,127971,5.563,22.331,7475,7683,48851
1989,4452,21127,25196,165695,165908,3342,13.098,3979,15.595,36921,15071,21850,9.084,22.254,37528,18026,19502,10.865,22.620,-607,-0.366,44.508,3023,3101,13784
1989,4453,26807,31666,153525,154286,3394,10.636,3884,12.171,29035,11654,17381,7.554,18.819,30519,13252,17267,8.589,19.781,-1484,-0.962,37.638,2970,3046,9956
1989,4461,50818,79473,754402,739326,7608,9.643,6456,8.183,136515,55906,80609,7.562,18.465,107164,39281,67883,5.313,14.495,29351,3.970,28.990,4283,4463,23368
1989,4471,85610,137779,998467,985449,14294,10.365,14548,10.549,213498,88389,125109,8.969,21.665,186958,80534,106424,8.172,18.972,26540,2.693,37.944,9307,9826,48555
1989,4481,54479,105330,957604,953019,13832,13.195,12821,12.231,202532,88844,113688,9.322,21.252,195176,71753,123423,7.529,20.480,7356,0.772,40.960,7746,8545,37690
1989,4482,10888,37482,215222,209207,4006,10.726,3740,10.014,48021,18338,29683,8.766,22.954,36117,14644,21473,7.000,17.264,11904,5.690,34.528,1577,1749,6576
1989,4483,19515,29429,179825,178406,3757,12.896,3164,10.861,37297,18120,19177,10.157,20.906,34354,14214,20140,7.967,19.256,2943,1.650,38.512,1887,2080,7597
1989,4511,33051,43522,323502,317196,6233,14.475,5311,12.334,69259,34009,35250,10.722,21.835,56073,23712,32361,7.476,17.678,13186,4.157,35.355,3910,4078,14951
1989,4512,8618,13534,91739,89956,2038,15.525,1224,9.324,19558,8889,10669,9.881,21.742,15821,5318,10503,5.912,17.587,3737,4.154,35.175,842,856,3196
1989,4522,211,6588,1129669,1141370,503,7.821,190,2.954,116286,55041,61245,4.822,10.188,139663,22165,117498,1.942,12.236,-23377,-2.048,20.377,10,13,1676
1989,4523,12772,29497,984073,958906,2852,9.690,2725,9.258,163505,68423,95082,7.136,17.051,117218,41157,76061,4.292,12.224,46287,4.827,24.448,1525,1624,11777
1989,4531,24343,25863,134323,131057,3748,14.731,2909,11.433,29237,11511,17726,8.783,22.309,22825,8946,13879,6.826,17.416,6412,4.893,34.832,2327,2366,7182
1989,4532,31418,39480,252451,247002,6125,15.671,5335,13.650,58760,24872,33888,10.070,23.789,48193,20275,27918,8.208,19.511,10567,4.278,39.022,3785,4408,15040
1989,4533,9567,11490,63398,60731,1969,17.558,1418,12.644,14546,7034,7512,11.582,23.952,9413,3763,5650,6.196,15.499,5133,8.452,30.999,1014,1021,2502
1989,4539,23438,27097,143866,139544,4909,18.536,3682,13.903,38436,18044,20392,12.931,27.544,29738,14060,15678,10.076,21.311,8698,6.233,42.622,2652,2764,9932
1989,4541,5810,7197,118412,116457,1142,16.219,830,11.788,23506,9418,14088,8.087,20.184,19467,5881,13586,5.050,16.716,4039,3.468,33.432,597,602,2943
1989,4542,4167,5076,76954,77046,726,14.487,597,11.913,11614,4565,7049,5.925,15.074,11818,4704,7114,6.105,15.339,-204,-0.265,30.148,382,395,2360
1989,4543,17188,23476,230044,231438,2461,10.526,2270,9.709,41425,14334,27091,6.193,17.899,43855,13050,30805,5.639,18.949,-2430,-1.050,35.798,1641,1693,8961
1989,4811,707,2718,403867,412710,301,11.074,301,11.074,50140,8241,41899,1.997,12.149,68623,11483,57140,2.782,16.627,-18483,-4.478,24.298,85,85,2099
1989,4812,891,967,12925,11998,180,18.977,143,15.076,3804,1622,2182,13.519,31.705,1940,553,1387,4.609,16.169,1864,15.536,32.339,101,101,481
1989,4831,355,631,32608,32634,89,14.332,69,11.111,5793,1843,3950,5.647,17.751,5680,1757,3923,5.384,17.405,113,0.346,34.810,31,31,610
1989,4832,307,340,12701,12155,57,17.221,39,11.782,2651,761,1890,6.261,21.811,1648,613,1035,5.043,13.559,1003,8.252,27.118,24,24,119
1989,4841,25125,31880,645314,638580,5092,16.070,4706,14.852,116062,33917,82145,5.311,18.175,102202,47102,55100,7.376,16.005,13860,2.170,32.009,3472,3511,21116
1989,4842,41962,45614,483978,476726,7417,16.387,6710,14.825,108954,38407,70547,8.056,22.855,93978,41174,52804,8.637,19.713,14976,3.141,39.426,5225,5260,26888
1989,4851,391,418,34599,34032,70,17.413,38,9.453,3670,744,2926,2.186,10.784,2440,835,1605,2.454,7.170,1230,3.614,14.340,27,27,362
1989,4852,315,518,18808,18558,46,8.838,51,9.798,2682,359,2323,1.934,14.452,2067,754,1313,4.063,11.138,615,3.314,22.276,30,30,676
1989,4853,5029,5084,54161,53836,962,19.091,872,17.305,11718,4452,7266,8.270,21.766,11108,5342,5766,9.923,20.633,610,1.133,41.266,726,726,4586
1989,4854,3208,3718,106220,105042,465,12.705,349,9.536,17968,8129,9839,7.739,17.106,15461,8119,7342,7.729,14.719,2507,2.387,29.438,277,280,6228
1989,4855,774,821,20247,20088,142,17.783,97,12.148,3680,1444,2236,7.188,18.319,3367,1610,1757,8.015,16.761,313,1.558,33.523,75,77,1235
1989,4859,1374,1413,32196,31161,335,24.870,203,15.071,6733,2450,4283,7.863,21.607,4619,2262,2357,7.259,14.823,2114,6.784,29.647,164,164,1880
1989,4861,58,337,9048,8928,70,21.978,33,10.361,2021,1163,858,13.027,22.638,1748,783,965,8.771,19.580,273,3.058,39.160,D,D,D
1989,4862,256,1413,54145,54681,203,14.943,94,6.919,7507,3178,4329,5.812,13.729,8714,1496,7218,2.736,15.936,-1207,-2.207,27.457,26,27,282
1989,4869,72,359,6633,7212,31,8.470,45,12.295,712,316,396,4.382,9.872,1829,1059,770,14.684,25.361,-1117,-15.488,19.745,7,7,41
1989,4871,243,251,4849,4675,55,22.267,47,19.028,1013,367,646,7.851,21.671,671,306,365,6.546,14.354,342,7.316,28.709,36,36,268
1989,4872,835,852,8370,7935,162,19.436,125,14.997,2573,931,1642,11.733,32.426,1769,635,1134,8.003,22.294,804,10.132,44.587,94,94,492
1989,4879,87,90,892,775,26,30.769,15,17.751,356,211,145,27.243,45.965,126,79,47,10.200,16.269,230,29.697,32.537,9,9,67
1989,4881,2240,2902,81724,78039,453,16.052,293,10.383,18213,6804,11409,8.719,23.338,11001,3009,7992,3.856,14.097,7212,9.242,28.194,200,200,1766
1989,4882,379,590,18157,16430,93,15.789,91,15.450,5134,906,4228,5.514,31.249,1809,763,1046,4.644,11.011,3325,20.238,22.021,32,71,422
1989,4883,2171,2596,83904,85183,299,11.493,310,11.916,14249,2952,11297,3.466,16.728,16770,5114,11656,6.004,19.687,-2521,-2.960,33.455,216,220,3253
1989,4884,3721,3988,30661,29130,863,22.477,566,14.742,8774,4236,4538,14.542,30.121,5694,2759,2935,9.471,19.547,3080,10.573,39.094,421,439,2090
1989,4885,7018,9328,109131,105759,1326,14.472,995,10.859,23704,7828,15876,7.402,22.413,17257,7598,9659,7.184,16.317,6447,6.096,32.635,647,679,4595
1989,4889,609,631,7543,7326,141,23.191,95,15.625,1923,763,1160,10.415,26.249,1522,569,953,7.767,20.775,401,5.474,41.551,81,83,498
1989,4921,1670,4099,334008,315400,601,14.909,465,11.536,68872,19897,48975,6.308,21.836,32410,8136,24274,2.580,10.276,36462,11.561,20.552,299,301,2436
1989,4922,3536,3794,65819,64403,618,16.287,619,16.313,17122,9478,7644,14.717,26.586,14408,9083,5325,14.103,22.372,2714,4.214,44.744,505,511,2854
1989,4931,5899,9612,423433,415154,1073,11.282,870,9.148,80268,34938,45330,8.416,19.335,64477,20062,44415,4.832,15.531,15791,3.804,31.062,312,321,2930
1989,5111,14178,16638,684737,679478,2130,12.937,1782,10.824,72131,22116,50015,3.255,10.616,62049,23700,38349,3.488,9.132,10082,1.484,18.264,1362,1377,11964
1989,5112,3566,4044,72159,64787,1095,29.345,470,12.595,23526,10557,12969,16.295,36.313,8705,3517,5188,5.429,13.436,14821,22.877,26.873,323,329,2205
1989,5121,9290,13606,201340,207046,2039,14.890,2214,16.168,45874,16559,29315,7.998,22.156,56671,20521,36150,9.911,27.371,-10797,-5.215,44.313,1203,1286,8132
1989,5122,2516,2542,19172,17584,663,27.335,430,17.728,7157,4379,2778,24.904,40.703,3989,1791,2198,10.186,22.686,3168,18.017,45.372,347,347,1410
1989,5151,6131,7671,239411,237866,1047,13.770,912,11.994,39021,19739,19282,8.298,16.405,35706,17440,18266,7.332,15.011,3315,1.394,30.022,652,661,9940
1989,5152,189,292,8840,8633,54,18.336,59,20.034,2062,609,1453,7.055,23.886,1754,1287,467,14.909,20.319,308,3.568,40.637,40,40,339
1989,5173,5057,24032,1045353,1036170,4078,17.670,2172,9.411,183171,57505,125666,5.550,17.678,164860,53039,111821,5.119,15.911,18311,1.767,31.821,785,815,8506
1989,5174,174,329,14266,14445,79,25.733,35,11.401,3348,1641,1707,11.361,23.178,4004,3059,945,21.178,27.720,-656,-4.542,46.357,14,14,1827
1989,5179,942,1689,36284,37204,488,31.132,245,15.630,7616,3463,4153,9.308,20.471,9725,2778,6947,7.467,26.140,-2109,-5.669,40.942,125,126,636
1989,5182,5429,7582,274384,272085,1319,17.706,1054,14.149,55653,21114,34539,7.760,20.454,51114,20609,30505,7.574,18.786,4539,1.668,37.572,619,626,5899
1989,5191,2607,3071,37420,36376,399,13.307,254,8.471,7599,4063,3536,11.170,20.890,5524,2992,2532,8.225,15.186,2075,5.704,30.372,186,186,846
1989,5211,47,85,25426,25004,6,7.018,7,8.187,1303,85,1218,0.340,5.211,468,103,365,0.412,1.872,835,3.340,3.743,4,4,88
1989,5221,18362,78223,2041224,2027911,6010,7.817,3325,4.325,277844,102080,175764,5.034,13.701,250637,55136,195501,2.719,12.359,27207,1.342,24.719,882,1029,21334
1989,5222,21653,40220,488672,504001,4257,10.511,4816,11.892,94415,36973,57442,7.336,18.733,122775,74498,48277,14.781,24.360,-28360,-5.627,37.466,1839,1861,17166
1989,5223,5486,6200,63766,62406,1506,25.307,1008,16.938,18638,9556,9082,15.313,29.866,15919,7474,8445,11.977,25.509,2719,4.357,51.018,734,737,3725
1989,5231,6780,14550,335410,335909,2663,18.915,1721,12.224,62763,27604,35159,8.218,18.685,64853,19297,45556,5.745,19.307,-2090,-0.622,37.369,992,1016,8977
1989,5232,92,110,7245,7212,15,13.514,17,15.315,567,191,376,2.648,7.862,509,74,435,1.026,7.058,58,0.804,14.115,15,15,52
1989,5239,15316,16010,188978,190251,3040,19.112,2833,17.810,58662,30094,28568,15.818,30.834,61155,24022,37133,12.627,32.144,-2493,-1.310,61.668,2191,2192,16190
1989,5241,7029,38186,1393878,1359923,13118,35.037,11626,31.052,258218,125882,132336,9.257,18.988,203805,82000,121805,6.030,14.987,54413,4.001,29.973,538,552,4639
1989,5242,102216,107694,791722,780769,13068,12.244,11146,10.443,164661,68409,96252,8.762,21.090,143130,74516,68614,9.544,18.332,21531,2.758,36.664,8333,8335,54968
1989,5259,813,1022,12452,13078,72,6.916,110,10.567,2483,411,2072,3.143,18.986,3826,578,3248,4.420,29.255,-1343,-10.269,37.972,82,82,327
1989,5311,98096,102120,575422,565374,14599,14.417,12882,12.722,130903,60903,70000,10.772,23.153,110941,53846,57095,9.524,19.623,19962,3.531,39.245,10171,10216,40938
1989,5312,37624,39914,225997,224159,6736,16.994,6182,15.597,55957,23025,32932,10.272,24.963,52384,23501,28883,10.484,23.369,3573,1.594,46.738,4750,4781,17468
1989,5313,26936,28602,327099,320953,4866,17.276,3994,14.180,72873,28992,43881,9.033,22.705,60168,23013,37155,7.170,18.747,12705,3.959,37.493,3070,3088,16658
1989,5321,5707,10558,140553,142110,1206,11.299,1437,13.463,27591,9045,18546,6.365,19.415,31008,9706,21302,6.830,21.820,-3417,-2.404,38.830,822,883,4434
1989,5322,20739,26085,182077,172034,5035,19.728,3910,15.320,58253,27222,31031,15.824,33.861,38062,17761,20301,10.324,22.125,20191,11.737,44.249,3014,3167,13723
1989,5323,4285,6044,42718,40871,1009,17.128,703,11.933,11814,4571,7243,11.184,28.906,7998,3716,4282,9.092,19.569,3816,9.337,39.138,466,506,2527
1989,5324,8331,10519,124287,129117,1511,14.459,1374,13.148,29976,9314,20662,7.214,23.216,38304,7580,30724,5.871,29.666,-8328,-6.450,46.432,973,1006,4661
1989,5331,982,1029,13502,12816,223,22.289,166,16.592,4284,1410,2874,11.002,33.428,2976,1836,1140,14.326,23.222,1308,10.206,46.444,113,113,1407
1989,5411,133897,139027,951885,928978,15217,11.021,13313,9.642,162689,53382,109307,5.746,17.513,116852,45608,71244,4.909,12.579,45837,4.934,25.157,10091,10182,33556
1989,5412,67519,71756,667858,642718,9979,14.031,8709,12.245,145620,43985,101635,6.844,22.657,95970,47666,48304,7.416,14.932,49650,7.725,29.864,6505,6577,25854
1989,5413,60549,67751,938588,917418,9559,14.287,7871,11.764,196632,62957,133675,6.862,21.433,154099,56742,97357,6.185,16.797,42533,4.636,33.594,5660,5746,27815
1989,5414,16634,16915,111867,108302,3119,18.796,2477,14.927,29929,12957,16972,11.964,27.635,22872,10706,12166,9.885,21.119,7057,6.516,42.238,1976,1984,7294
1989,5415,22086,25047,377551,356231,6542,27.515,4000,16.824,113378,50687,62691,14.229,31.827,71106,34263,36843,9.618,19.961,42272,11.866,39.921,2760,2789,13535
1989,5416,45069,46879,399414,374235,11009,24.247,8057,17.746,137153,64123,73030,17.134,36.649,86746,40890,45856,10.926,23.180,50407,13.469,46.359,6234,6275,30586
1989,5417,6656,8229,442691,440774,1059,12.930,982,11.990,58057,16223,41834,3.681,13.172,53988,17635,36353,4.001,12.248,4069,0.923,24.497,618,632,5256
1989,5418,28344,30654,374419,363936,5332,17.704,4258,14.138,86618,33278,53340,9.144,23.800,65983,26810,39173,7.367,18.130,20635,5.670,36.261,3326,3375,18055
1989,5419,33531,37246,292351,281778,4594,12.565,3228,8.829,64934,22417,42517,7.956,23.044,44081,16408,27673,5.823,15.644,20853,7.401,31.288,2391,2397,11002
1989,5511,26566,49793,3181866,3126658,6778,13.941,4433,9.118,617713,234608,383105,7.503,19.756,509600,123783,385817,3.959,16.299,108113,3.458,32.597,956,989,14571
1989,5611,12107,13032,244296,239435,1707,12.875,2159,16.285,60438,20309,40129,8.482,25.242,50482,20543,29939,8.580,21.084,9956,4.158,42.168,1652,1658,13939
1989,5612,437,732,70251,68825,210,31.320,87,12.975,18974,11861,7113,17.234,27.568,16286,4936,11350,7.172,23.663,2688,3.906,47.326,46,49,1067
1989,5613,17971,25062,1382881,1300169,5307,22.165,3069,12.818,460678,159838,300840,12.294,35.432,297801,85639,212162,6.587,22.905,162877,12.527,45.810,2085,2139,50632
1989,5614,20871,23721,291148,276823,4151,17.910,3062,13.212,77267,30751,46516,11.109,27.912,48812,18909,29903,6.831,17.633,28455,10.279,35.266,2373,2397,10659
1989,5615,24736,29817,238518,230105,4477,15.430,2874,9.905,53923,21034,32889,9.141,23.434,37312,15597,21715,6.778,16.215,16611,7.219,32.430,2181,2251,10714
1989,5616,12575,15267,504198,491979,2548,16.935,2106,13.997,119478,40535,78943,8.239,24.285,95102,32876,62226,6.682,19.331,24376,4.955,38.661,1553,1572,19633
1989,5617,84365,88464,1082895,1048891,19568,22.821,14132,16.481,280573,95534,185039,9.108,26.749,212908,86301,126607,8.228,20.298,67665,6.451,40.597,11115,11151,57949
1989,5619,14031,15210,210689,205958,2769,18.638,2062,13.879,56596,20512,36084,9.959,27.479,46333,13464,32869,6.537,22.496,10263,4.983,44.993,1621,1630,9515
1989,5621,5626,5798,67391,64638,792,13.852,631,11.036,15576,6334,9242,9.799,24.097,10103,5272,4831,8.156,15.630,5473,8.467,31.260,498,498,3839
1989,5622,1865,2678,70567,67519,404,15.530,251,9.648,14816,4618,10198,6.840,21.944,8955,3540,5415,5.243,13.263,5861,8.681,26.526,174,174,1827
1989,5629,4874,5219,64424,58986,873,17.047,677,13.220,21744,7994,13750,13.552,36.863,10983,4257,6726,7.217,18.620,10761,18.243,37.240,516,516,2727
1989,6111,13521,14593,448445,443087,567,3.889,538,3.690,42172,7326,34846,1.653,9.518,31412,6970,24442,1.573,7.089,10760,2.428,14.179,377,388,4696
1989,6112,504,710,55777,54601,58,8.280,39,5.567,8243,2290,5953,4.194,15.097,5897,1511,4386,2.767,10.800,2346,4.297,21.601,18,20,1019
1989,6113,1998,2353,995878,979475,113,4.835,81,3.466,85290,7615,77675,0.777,8.708,52226,8303,43923,0.848,5.332,33064,3.376,10.664,40,40,5768
1989,6114,2598,3167,51692,50613,652,21.381,417,13.674,13438,5630,7808,11.124,26.551,11372,5098,6274,10.073,22.469,2066,4.082,44.938,298,324,3917
1989,6115,4409,5403,74999,71009,778,14.785,496,9.426,18706,7162,11544,10.086,26.343,10906,3084,7822,4.343,15.359,7800,10.985,30.717,346,361,2119
1989,6116,12871,13560,111870,106301,2683,20.329,1959,14.843,30668,11828,18840,11.127,28.850,19341,8336,11005,7.842,18.195,11327,10.656,36.389,1555,1564,6205
1989,6117,1677,1733,21219,20331,321,18.866,258,15.163,5001,1632,3369,8.027,24.598,3318,960,2358,4.722,16.320,1683,8.278,32.640,194,194,722
1989,6211,182397,192033,1313489,1284045,14065,7.324,14089,7.336,221456,69895,151561,5.443,17.247,163109,58828,104281,4.581,12.703,58347,4.544,25.405,11435,11596,45910
1989,6212,99342,102117,521126,513030,5871,5.772,5057,4.972,78677,22349,56328,4.356,15.336,62562,18593,43969,3.624,12.195,16115,3.141,24.389,4045,4122,15550
1989,6213,55636,58280,230335,217915,8557,15.167,4834,8.568,59804,25741,34063,11.812,27.444,34774,15239,19535,6.993,15.958,25030,11.486,31.915,3597,3699,11921
1989,6214,7646,11823,216729,203214,1533,13.331,886,7.705,49825,17983,31842,8.849,24.518,22837,8692,14145,4.277,11.238,26988,13.281,22.476,552,572,4109
1989,6215,5418,7007,105736,99848,1234,18.144,822,12.086,27992,10841,17151,10.858,28.035,16279,6826,9453,6.836,16.304,11713,11.731,32.608,501,514,3280
1989,6216,5172,7632,320710,313538,1477,20.093,915,12.447,84505,26509,57996,8.455,26.952,68882,18262,50620,5.825,21.969,15623,4.983,43.939,537,567,8132
1989,6219,5300,6100,117978,113678,1017,17.008,776,12.978,28089,9428,18661,8.294,24.709,19427,8234,11193,7.243,17.089,8662,7.620,34.179,536,540,4563
1989,6221,3478,4900,3717500,3662721,167,3.354,326,6.547,257667,61071,196596,1.667,7.035,147551,69661,77890,1.902,4.028,110116,3.006,8.057,198,203,37562
1989,6222,534,871,326771,323330,72,8.456,33,3.876,18366,7232,11134,2.237,5.680,11456,6453,5003,1.996,3.543,6910,2.137,7.086,17,17,4552
1989,6223,223,287,105890,103173,32,11.532,13,4.685,10330,3762,6568,3.646,10.012,4812,3003,1809,2.911,4.664,5518,5.348,9.328,5,5,749
1989,6231,8094,13657,1188833,1166601,1068,7.860,930,6.844,161593,64571,97022,5.535,13.852,117622,58298,59324,4.997,10.082,43971,3.769,20.165,533,577,35336
1989,6232,5878,9773,217061,205926,1663,18.162,430,4.696,45102,19866,25236,9.647,21.902,22889,6402,16487,3.109,11.115,22213,10.787,22.230,297,304,4698
1989,6233,9327,11116,277012,269893,1800,16.709,1113,10.332,47987,19829,28158,7.347,17.780,33879,15813,18066,5.859,12.553,14108,5.227,25.106,736,778,10857
1989,6239,3491,4586,115064,110819,529,11.787,333,7.420,18663,5378,13285,4.853,16.841,10242,3391,6851,3.060,9.242,8421,7.599,18.484,204,208,2030
1989,6241,18007,24060,346719,333085,2818,12.046,1484,6.344,64646,20294,44352,6.093,19.408,37725,9375,28350,2.815,11.326,26921,8.082,22.652,916,921,5550
1989,6242,5111,5994,61442,60524,641,10.955,355,6.067,10490,3313,7177,5.474,17.332,8484,2410,6074,3.982,14.018,2006,3.314,28.035,215,215,1031
1989,6243,4751,7060,275439,271181,766,11.113,432,6.267,45144,9825,35319,3.623,16.647,36627,6947,29680,2.562,13.507,8517,3.141,27.013,194,215,2011
1989,6244,34562,41508,399508,386464,5873,14.496,3887,9.594,80222,35118,45104,9.087,20.758,53985,22067,31918,5.710,13.969,26237,6.789,27.938,3061,3112,16760
1989,7111,4894,4936,70449,67930,908,18.724,735,15.156,18554,6049,12505,8.905,27.314,13471,5186,8285,7.634,19.831,5083,7.483,39.662,510,513,2467
1989,7112,2395,2510,65712,66095,473,19.115,402,16.246,14305,5359,8946,8.108,21.643,14781,3342,11439,5.056,22.363,-476,-0.720,43.287,308,308,2192
1989,7113,2152,2210,35278,34323,418,19.406,306,14.206,9572,2807,6765,8.178,27.888,7672,2372,5300,6.911,22.353,1900,5.536,44.705,235,237,1952
1989,7114,1350,1371,14575,14857,286,21.593,193,14.572,3352,1441,1911,9.699,22.562,3947,1630,2317,10.971,26.567,-595,-4.005,45.124,151,151,916
1989,7115,12749,12805,71311,71769,3787,31.158,2485,20.446,27979,14045,13934,19.570,38.985,28370,9246,19124,12.883,39.530,-391,-0.545,77.970,1864,1867,6918
1989,7121,2962,3227,61222,58577,321,10.210,155,4.930,9470,1675,7795,2.859,16.167,4145,683,3462,1.166,7.076,5325,9.091,14.152,118,119,549
1989,7131,1680,2463,76283,71788,434,18.289,254,10.704,15627,3331,12296,4.640,21.768,6953,1048,5905,1.460,9.686,8674,12.083,19.371,203,205,865
1989,7132,797,840,22983,22022,164,20.335,97,12.027,4897,2089,2808,9.486,22.237,2927,1595,1332,7.243,13.292,1970,8.946,26.583,80,80,1437
1989,7139,36585,39802,616576,603931,5499,13.872,5177,13.060,122838,42524,80314,7.041,20.340,97073,40606,56467,6.724,16.074,25765,4.266,32.147,4059,4153,31199
1989,7211,30221,36404,1402300,1365109,4894,13.560,4271,11.833,274203,127644,146559,9.350,20.087,201535,100967,100568,7.396,14.763,72668,5.323,29.527,3108,3190,63028
1989,7212,4073,4381,28399,27452,580,13.438,450,10.426,7441,3138,4303,11.431,27.106,5624,1835,3789,6.685,20.487,1817,6.619,40.974,311,315,1258
1989,7213,3687,3796,20299,19810,331,8.664,380,9.946,4354,2004,2350,10.116,21.979,3394,1253,2141,6.325,17.133,960,4.846,34.266,275,275,962
1989,7223,13085,19396,359784,355988,3552,18.641,2869,15.057,85787,39865,45922,11.198,24.098,78893,31657,47236,8.893,22.162,6894,1.937,44.323,2122,2141,20992
1989,7224,51420,52432,325383,317785,7957,15.152,8119,15.461,91477,49809,41668,15.674,28.786,76358,36924,39434,11.619,24.028,15119,4.758,48.056,6555,6569,29814
1989,7225,220412,304543,5803985,5714567,49882,16.613,41323,13.762,1277664,665984,611680,11.654,22.358,1096058,481339,614719,8.423,19.180,181606,3.178,38.360,29642,30783,311257
1989,8111,114907,122296,652544,632526,19331,16.093,14987,12.476,160326,78499,81827,12.410,25.347,119742,52637,67105,8.322,18.931,40584,6.416,37.862,11624,11843,41954
1989,8112,11664,13898,127029,121946,1997,14.482,1780,12.908,30771,10015,20756,8.213,25.233,21015,9872,11143,8.095,17.233,9756,8.000,34.466,1229,1269,5058
1989,8113,20990,22255,173500,168591,2904,13.165,2511,11.383,37194,12494,24700,7.411,22.062,27212,12280,14932,7.284,16.141,9982,5.921,32.282,1963,1972,8784
1989,8114,24759,26669,176482,171537,4441,16.880,3721,14.143,38894,19537,19357,11.389,22.674,29292,12566,16726,7.326,17.076,9602,5.598,34.152,2874,2892,9595
1989,8121,77567,87290,453060,445526,13629,15.750,12115,14.000,109779,56900,52879,12.771,24.640,94494,41378,53116,9.287,21.210,15285,3.431,42.419,9739,9966,32054
1989,8122,17263,20519,127487,126198,1723,8.422,1600,7.821,23095,9120,13975,7.227,18.301,20353,8623,11730,6.833,16.128,2742,2.173,32.256,1121,1205,6267
1989,8123,33781,40485,379481,377029,5311,13.143,5158,12.765,69883,27624,42259,7.327,18.535,64907,29315,35592,7.775,17.215,4976,1.320,34.431,3922,4141,20962
1989,8129,13844,22832,176959,174212,4195,18.829,3090,13.869,43784,20031,23753,11.498,25.133,38626,16579,22047,9.517,22.172,5158,2.961,44.344,1905,2001,9756
1989,8131,129678,129744,1076286,1060851,5993,4.649,4316,3.348,127285,17102,110183,1.612,11.998,96616,13358,83258,1.259,9.107,30669,2.891,18.215,2605,2605,7888
1989,8132,9005,10383,146517,140600,1171,11.587,617,6.105,24789,6569,18220,4.672,17.631,13147,3910,9237,2.781,9.351,11642,8.280,18.701,408,413,2141
1989,8133,8114,9524,104921,101418,1114,12.000,632,6.808,18627,5847,12780,5.765,18.367,11738,2896,8842,2.856,11.574,6889,6.793,23.148,400,420,2009
1989,8134,30760,32305,289738,283641,2757,8.665,1783,5.604,42611,10684,31927,3.767,15.023,30373,6589,23784,2.323,10.708,12238,4.315,21.417,1286,1295,4274
1989,8139,57989,60376,498276,489014,4838,8.038,4457,7.405,87211,18729,68482,3.830,17.834,68700,21903,46797,4.479,14.049,18511,3.785,28.097,3239,3276,16491
1990,1131,212,232,2402,2313,44,19.426,33,14.570,638,436,202,18.854,27.589,480,136,344,5.881,20.757,158,6.832,41.514,21,21,73
1990,1132,95,110,1643,1638,16,15.166,7,6.635,201,73,128,4.457,12.271,188,41,147,2.503,11.477,13,0.794,22.955,4,4,25
1990,1133,11271,11364,90444,89873,1859,16.582,1553,13.852,21079,8381,12698,9.325,23.454,19969,7073,12896,7.870,22.219,1110,1.235,44.439,1165,1165,5539
1990,1141,1003,1012,8175,7725,172,16.929,180,17.717,2972,1219,1753,15.781,38.475,2036,998,1038,12.920,26.358,936,12.117,52.715,133,133,727
1990,1142,154,158,1287,1247,30,19.544,21,13.681,271,137,134,10.986,21.732,195,107,88,8.581,15.638,76,6.095,31.275,15,15,80
1990,1151,4056,4390,53813,53712,654,15.181,490,11.374,14538,5709,8829,10.629,27.067,14406,5253,9153,9.780,26.821,132,0.246,53.642,316,328,2613
1990,1152,2115,2150,14431,14208,387,18.557,258,12.371,3099,1425,1674,10.030,21.812,2617,1032,1585,7.264,18.419,482,3.392,36.838,190,190,570
1990,1153,827,837,11176,10989,162,19.732,130,15.834,3301,1567,1734,14.260,30.040,2918,935,1983,8.509,26.555,383,3.485,53.110,90,90,727
1990,2111,6816,8215,119471,117701,850,10.237,1027,12.368,21241,8242,12999,7.003,18.047,17780,5761,12019,4.895,15.106,3461,2.941,30.212,661,674,2808
1990,2121,2089,2635,135614,136319,409,15.253,502,18.721,20266,7282,12984,5.342,14.867,21760,8942,12818,6.560,15.963,-1494,-1.096,29.733,365,368,4987
1990,2122,432,614,47338,45583,87,13.942,107,17.147,7846,2365,5481,5.188,17.213,4408,1838,2570,4.032,9.670,3438,7.542,19.341,79,79,928
1990,2123,3452,5086,104656,105158,407,8.024,379,7.472,16156,3832,12324,3.644,15.364,17126,5562,11564,5.289,16.286,-970,-0.922,30.727,236,241,1436
1990,2131,7836,8864,161018,157650,1229,13.803,1309,14.701,38129,9390,28739,5.956,24.186,31171,14529,16642,9.216,19.772,6958,4.414,39.545,866,876,6285
1990,2211,1763,6210,595685,594555,297,4.824,190,3.086,31160,7956,23204,1.338,5.241,28762,3098,25664,0.521,4.838,2398,0.403,9.675,71,71,687
1990,2212,617,2622,147815,143716,303,11.931,138,5.434,15607,9817,5790,6.831,10.860,8033,2207,5826,1.536,5.589,7574,5.270,11.179,48,48,533
1990,2213,4126,4382,33511,33383,383,8.830,294,6.778,4038,1432,2606,4.290,12.096,3813,1512,2301,4.529,11.422,225,0.674,22.844,220,220,836
1990,2361,114670,115081,666673,664182,23633,20.885,19782,17.482,210073,87810,122263,13.221,31.629,205202,80207,124995,12.076,30.895,4871,0.733,61.791,14550,14554,61019
1990,2362,38366,39052,735683,724521,5052,12.948,4983,12.771,181073,39282,141791,5.422,24.992,158200,37526,120674,5.179,21.835,22873,3.157,43.670,3796,3800,29451
1990,2371,13609,13934,312835,306066,1377,9.927,1251,9.019,76945,11927,65018,3.897,25.140,62804,12317,50487,4.024,20.520,14141,4.620,41.040,941,944,9267
1990,2372,9788,9989,83737,83446,2034,20.167,2228,22.090,25718,11245,14473,13.476,30.820,25116,13036,12080,15.622,30.099,602,0.721,60.197,1823,1825,10018
1990,2373,9512,9909,263086,256712,921,9.267,980,9.861,61086,8561,52525,3.335,23.796,48425,12270,36155,4.780,18.864,12661,4.932,37.727,721,722,8228
1990,2379,4852,4927,78755,77648,666,13.450,715,14.440,19596,4920,14676,6.336,25.237,17645,4492,13153,5.785,22.724,1951,2.513,45.449,561,561,3368
1990,2381,78192,78622,771061,763704,11603,14.860,10525,13.479,213778,59682,154096,7.815,27.992,199312,62475,136837,8.181,26.098,14466,1.894,52.196,8084,8094,50581
1990,2382,122423,124230,1307316,1298882,15723,12.789,13148,10.694,270584,67259,203325,5.178,20.832,254133,71945,182188,5.539,19.566,16451,1.267,39.131,10294,10309,57588
1990,2383,81796,82248,714855,708018,14592,17.904,13102,16.075,202609,64433,138176,9.100,28.616,189014,62505,126509,8.828,26.696,13595,1.920,53.392,10101,10110,49554
1990,2389,41921,42176,389885,380776,6173,14.743,5564,13.288,109898,30500,79398,8.010,28.862,91424,27108,64316,7.119,24.010,18474,4.852,48.020,4185,4187,20667
1990,3111,1163,1770,48854,48360,102,5.748,111,6.255,5885,1564,4321,3.234,12.169,4873,1567,3306,3.240,10.077,1012,2.093,20.153,76,77,690
1990,3112,481,833,65270,65346,38,4.581,31,3.737,3565,624,2941,0.955,5.456,3797,210,3587,0.321,5.811,-232,-0.355,10.911,22,22,120
1990,3113,1638,1929,87317,87260,223,11.633,199,10.381,9148,1882,7266,2.157,10.484,8913,1634,7279,1.873,10.214,235,0.269,20.429,144,145,952
1990,3114,1177,1595,175113,174731,121,7.563,131,8.188,20313,3335,16978,1.909,11.625,19940,4348,15592,2.488,11.412,373,0.213,22.824,86,86,1902
1990,3115,1418,2032,137449,138161,114,5.537,168,8.159,12559,3698,8861,2.677,9.090,14102,4372,9730,3.164,10.207,-1543,-1.117,18.180,117,117,1764
1990,3116,3733,4361,385692,377940,326,7.443,364,8.311,42592,7170,35422,1.897,11.270,26648,6531,20117,1.728,7.051,15944,4.219,14.102,270,271,4057
1990,3117,700,816,46062,46729,73,8.913,79,9.646,7952,2431,5521,5.202,17.017,9312,2173,7139,4.650,19.928,-1360,-2.910,34.035,56,56,1253
1990,3118,9011,10467,304248,305133,1264,11.991,1413,13.404,34144,10642,23502,3.488,11.190,35801,14138,21663,4.633,11.733,-1657,-0.543,22.380,1057,1083,8124
1990,3119,2063,2428,132378,132993,237,9.773,231,9.526,15306,4472,10834,3.363,11.509,16916,6325,10591,4.756,12.719,-1610,-1.211,23.018,166,166,2138
1990,3121,1749,2190,139622,138993,212,9.720,194,8.895,18872,8649,10223,6.223,13.578,17822,7432,10390,5.347,12.822,1050,0.755,25.644,136,137,1484
1990,3122,98,132,37607,37154,6,4.511,8,6.015,3519,2520,999,6.783,9.472,2450,462,1988,1.243,6.594,1069,2.877,13.189,3,3,10
1990,3131,399,639,108174,109528,46,7.221,42,6.593,9020,2990,6030,2.730,8.235,11625,3185,8440,2.908,10.614,-2605,-2.378,16.471,26,26,919
1990,3132,1642,1987,246129,250595,159,8.008,156,7.857,19088,6810,12278,2.718,7.617,27965,7435,20530,2.967,11.159,-8877,-3.542,15.234,119,119,3093
1990,3133,5423,6151,149406,149036,582,9.472,569,9.260,22278,8549,13729,5.736,14.948,21618,9112,12506,6.114,14.505,660,0.443,29.010,420,422,3385
1990,3141,3592,3888,131578,133072,411,10.406,534,13.521,17256,7833,9423,5.886,12.967,20488,8878,11610,6.672,15.396,-3232,-2.429,25.935,432,437,3175
1990,3149,3924,4039,117475,116663,571,14.300,479,11.996,20232,7565,12667,6.484,17.342,18762,6476,12286,5.551,16.082,1470,1.260,32.164,398,398,5056
1990,3151,1220,1351,136019,139147,146,10.669,181,13.226,17492,6276,11216,4.510,12.571,23994,5783,18211,4.156,17.244,-6502,-4.673,25.142,142,143,2167
1990,3152,11461,12792,742840,762731,2082,16.300,2044,16.003,103246,41328,61918,5.418,13.536,143289,54429,88860,7.136,18.786,-40043,-5.250,27.073,1701,1728,38646
1990,3159,1832,1916,59096,59966,258,13.494,250,13.075,8999,2419,6580,4.034,15.007,10818,3943,6875,6.575,18.040,-1819,-3.033,30.014,209,209,2656
1990,3161,318,343,16113,16148,22,6.250,40,11.364,1631,304,1327,1.883,10.101,1724,726,998,4.496,10.677,-93,-0.576,20.201,31,31,416
1990,3162,347,467,72953,74964,37,7.732,60,12.539,5597,1644,3953,2.193,7.466,9675,3183,6492,4.246,12.906,-4078,-5.440,14.933,46,49,1345
1990,3169,1071,1117,36385,36910,107,9.448,138,12.185,4726,741,3985,2.008,12.804,5818,1884,3934,5.104,15.763,-1092,-2.959,25.608,104,107,1427
1990,3211,4475,5001,143048,144015,431,8.541,522,10.344,15638,4402,11236,3.057,10.859,17652,5786,11866,4.018,12.257,-2014,-1.398,21.717,393,393,3062
1990,3212,1303,1608,103453,103722,138,8.601,131,8.165,10629,2956,7673,2.850,10.248,11338,4229,7109,4.077,10.931,-709,-0.684,20.495,88,88,1810
1990,3219,9175,9877,284966,289918,1075,10.891,1062,10.759,36389,10803,25586,3.726,12.552,46410,14005,32405,4.831,16.008,-10021,-3.457,25.103,836,841,10187
1990,3221,229,550,195827,193926,26,4.766,17,3.116,9821,3227,6594,1.664,5.064,6062,2142,3920,1.105,3.126,3759,1.938,6.252,7,7,217
1990,3222,3546,5190,403228,401764,290,5.593,280,5.400,33290,8113,25177,2.019,8.286,30504,7781,22723,1.937,7.593,2786,0.693,15.185,194,194,3152
1990,3231,42101,44080,854081,856408,4531,10.347,3956,9.034,101921,30429,71492,3.553,11.901,107374,33617,73757,3.925,12.538,-5453,-0.637,23.802,3226,3234,22226
1990,3241,1257,2170,112564,112147,171,7.924,147,6.812,7461,1648,5813,1.469,6.653,6602,1554,5048,1.386,5.887,859,0.766,11.774,83,83,662
1990,3251,1160,2345,234441,231690,173,7.455,124,5.344,15738,3770,11968,1.627,6.793,10206,1957,8249,0.845,4.405,5532,2.388,8.810,57,57,613
1990,3252,374,650,134344,135077,50,7.746,41,6.352,6587,1785,4802,1.321,4.876,7919,3220,4699,2.384,5.863,-1332,-0.986,9.753,19,19,300
1990,3253,630,888,42771,42671,61,6.866,62,6.978,4278,685,3593,1.605,10.026,4122,1717,2405,4.024,9.660,156,0.366,19.320,34,34,605
1990,3254,1080,1344,174740,173933,109,8.137,100,7.465,15470,1459,14011,0.839,8.894,13508,2475,11033,1.423,7.766,1962,1.128,15.532,69,69,1040
1990,3255,1624,2141,76619,76802,130,6.056,141,6.569,6925,1594,5331,2.075,9.017,7351,1660,5691,2.161,9.571,-426,-0.555,18.033,83,83,711
1990,3256,2074,2347,124438,123540,238,10.263,182,7.848,13743,3416,10327,2.765,11.124,11908,2764,9144,2.237,9.639,1835,1.485,19.278,138,138,1612
1990,3259,2114,2780,140814,141897,234,8.445,216,7.795,12059,3181,8878,2.242,8.498,14005,3621,10384,2.552,9.870,-1946,-1.371,16.997,146,149,1700
1990,3261,10092,12079,676428,679530,1073,8.967,847,7.078,79462,21271,58191,3.130,11.694,85510,22520,62990,3.314,12.584,-6048,-0.890,23.387,595,600,9199
1990,3262,2144,2630,194409,197192,213,8.155,177,6.776,12642,3392,9250,1.720,6.411,18137,2808,15329,1.424,9.198,-5495,-2.787,12.822,127,127,1575
1990,3271,1450,1752,82391,82883,210,12.192,151,8.766,7397,2066,5331,2.493,8.925,8327,1271,7056,1.533,10.047,-930,-1.122,17.849,116,116,904
1990,3272,1792,2058,145571,146741,263,12.965,204,10.057,12151,3900,8251,2.658,8.281,14411,4112,10299,2.802,9.821,-2260,-1.540,16.561,159,159,1669
1990,3273,6457,9131,190732,191222,716,7.892,600,6.613,30502,8323,22179,4.353,15.951,31453,8061,23392,4.216,16.448,-951,-0.497,31.902,368,382,4765
1990,3274,266,378,18707,18288,55,15.048,30,8.208,2151,1255,896,6.863,11.762,1283,369,914,2.018,7.016,868,4.746,14.031,24,24,186
1990,3279,1905,2214,78055,77948,200,9.040,197,8.904,7865,2511,5354,3.221,10.090,7693,2302,5391,2.953,9.869,172,0.221,19.739,139,139,907
1990,3311,351,425,187979,190205,37,8.778,30,7.117,3809,771,3038,0.405,2.003,8282,439,7843,0.231,4.354,-4473,-2.352,4.005,21,21,243
1990,3312,531,724,66665,67793,48,6.621,50,6.897,4520,1060,3460,1.564,6.667,6801,1562,5239,2.304,10.032,-2281,-3.365,13.335,34,34,537
1990,3313,346,502,89271,88997,39,7.927,19,3.862,5516,1396,4120,1.569,6.198,4963,658,4305,0.739,5.577,553,0.621,11.153,14,14,401
1990,3314,773,945,84258,83522,87,9.290,70,7.475,7624,3600,4024,4.310,9.128,6229,1760,4469,2.107,7.458,1395,1.670,14.916,49,49,518
1990,3315,2574,2850,215295,220020,203,7.181,157,5.554,15175,4354,10821,1.979,6.897,24621,3539,21082,1.608,11.190,-9446,-4.293,13.794,110,110,1620
1990,3321,3326,3529,144252,146238,235,6.668,226,6.412,13273,3861,9412,2.640,9.076,17345,4478,12867,3.062,11.861,-4072,-2.785,18.153,172,172,2848
1990,3322,1335,1461,81918,82435,109,7.491,97,6.667,6705,1393,5312,1.690,8.134,7852,2572,5280,3.120,9.525,-1147,-1.391,16.267,64,64,789
1990,3323,10241,11076,343476,346838,958,8.709,805,7.319,42806,11504,31302,3.317,12.342,49663,13505,36158,3.894,14.319,-6857,-1.977,24.684,616,619,8370
1990,3324,1520,1849,115658,117318,114,6.169,112,6.061,10733,2823,7910,2.406,9.149,14234,5169,9065,4.406,12.133,-3501,-2.984,18.297,63,63,592
1990,3325,974,1067,72006,72909,70,6.503,89,8.268,5802,1848,3954,2.535,7.958,7667,1386,6281,1.901,10.516,-1865,-2.558,15.916,62,63,666
1990,3326,1868,2066,74801,75042,218,10.715,155,7.619,8563,2433,6130,3.242,11.411,9110,2820,6290,3.758,12.140,-547,-0.729,22.822,110,110,1029
1990,3327,21445,21760,343208,344473,1794,8.259,1715,7.896,42098,10384,31714,3.014,12.221,44701,10186,34515,2.957,12.977,-2603,-0.756,24.442,1392,1395,7781
1990,3328,5510,5876,138649,141079,389,6.624,382,6.505,15462,3918,11544,2.777,10.960,20415,5282,15133,3.744,14.471,-4953,-3.511,21.920,300,302,3213
1990,3329,7048,7556,366899,369149,872,11.759,591,7.970,37001,12399,24602,3.359,10.023,41337,10617,30720,2.876,11.198,-4336,-1.175,20.047,450,451,4544
1990,3331,2891,3144,216946,214555,219,6.950,233,7.394,24171,5975,18196,2.785,11.266,19207,6839,12368,3.188,8.952,4964,2.314,17.904,154,154,2542
1990,3332,4193,4452,173860,175801,353,7.955,324,7.301,19999,4502,15497,2.561,11.376,23559,8688,14871,4.942,13.401,-3560,-2.025,22.752,246,246,2366
1990,3333,2289,2421,152308,152306,227,9.486,171,7.146,15890,3966,11924,2.604,10.433,15586,3686,11900,2.420,10.233,304,0.200,20.467,127,129,1428
1990,3334,1632,1885,159874,161294,152,8.092,139,7.400,14230,3767,10463,2.335,8.822,17086,3263,13823,2.023,10.593,-2856,-1.771,17.645,97,97,949
1990,3335,9399,9735,230201,231060,613,6.309,576,5.928,22142,5239,16903,2.267,9.583,23846,5795,18051,2.508,10.320,-1704,-0.737,19.166,463,463,3497
1990,3336,731,880,131400,132531,49,5.556,53,6.009,8155,1773,6382,1.338,6.153,10339,1251,9088,0.944,7.801,-2184,-1.648,12.307,33,33,536
1990,3339,5412,6008,325227,326067,439,7.333,397,6.631,34340,9713,24627,2.979,10.532,36120,11579,24541,3.551,11.077,-1780,-0.546,21.063,290,290,3673
1990,3341,1620,1764,263801,264487,209,11.841,211,11.955,31495,6751,24744,2.552,11.908,32831,9436,23395,3.568,12.413,-1336,-0.505,23.816,142,142,1870
1990,3342,1656,1862,243952,250745,232,12.761,144,7.921,27115,11374,15741,4.536,10.814,40531,14118,26413,5.630,16.164,-13416,-5.350,21.628,89,89,803
1990,3343,425,459,35984,36032,61,13.616,39,8.705,4008,1258,2750,3.491,11.123,3975,542,3433,1.504,11.032,33,0.092,22.064,30,30,386
1990,3344,5107,5727,517912,525054,771,13.746,535,9.538,51393,16949,34444,3.228,9.788,65499,17544,47955,3.341,12.475,-14106,-2.687,19.576,384,386,5198
1990,3345,4423,5059,643096,656184,366,7.247,349,6.910,46456,10626,35830,1.619,7.080,72324,14012,58312,2.135,11.022,-25868,-3.942,14.159,222,223,3511
1990,3346,754,799,51111,48104,104,13.131,90,11.364,12162,2536,9626,5.272,25.283,6356,1223,5133,2.542,13.213,5806,12.070,26.426,67,67,579
1990,3351,1171,1295,83409,85395,92,7.077,102,7.846,6565,1740,4825,2.038,7.688,10518,2304,8214,2.698,12.317,-3953,-4.629,15.376,73,74,1027
1990,3352,353,434,108767,109918,51,12.085,27,6.398,8774,2511,6263,2.284,7.982,11125,1095,10030,0.996,10.121,-2351,-2.139,15.965,17,17,336
1990,3353,2173,2637,228575,231248,216,8.285,156,5.984,19536,6842,12694,2.959,8.448,24601,5136,19465,2.221,10.638,-5065,-2.190,16.896,107,107,964
1990,3359,2172,2561,207838,211001,152,5.843,233,8.956,17989,3674,14315,1.741,8.526,24511,6390,18121,3.028,11.617,-6522,-3.091,17.051,163,163,1954
1990,3361,247,306,223369,225618,34,11.184,30,9.868,17016,1039,15977,0.461,7.542,20980,2647,18333,1.173,9.299,-3964,-1.757,15.084,25,25,333
1990,3362,1828,2027,110457,117205,199,9.762,222,10.890,11141,3266,7875,2.787,9.506,24236,5491,18745,4.685,20.678,-13095,-11.173,19.011,171,172,2128
1990,3363,4089,4966,653888,669534,434,8.795,371,7.518,48149,16451,31698,2.457,7.191,79836,11101,68735,1.658,11.924,-31687,-4.733,14.383,283,286,5201
1990,3364,1468,1801,688478,698793,182,10.309,111,6.287,54320,27929,26391,3.997,7.773,74599,25491,49108,3.648,10.675,-20279,-2.902,15.547,84,84,1389
1990,3365,166,205,32075,31691,22,10.864,17,8.395,4490,1446,3044,4.563,14.168,3593,824,2769,2.600,11.338,897,2.830,22.675,11,11,353
1990,3366,1312,1417,163280,165577,160,11.396,134,9.544,16527,3173,13354,1.916,9.981,21047,2913,18134,1.759,12.711,-4520,-2.730,19.963,92,92,1286
1990,3369,488,503,30239,30964,55,10.934,55,10.934,2807,308,2499,0.995,9.065,4131,782,3349,2.526,13.341,-1324,-4.276,18.131,50,50,468
1990,3371,13697,14395,392443,398109,1839,12.757,1881,13.048,48170,17147,31023,4.307,12.100,59382,20010,39372,5.026,14.916,-11212,-2.816,24.199,1484,1502,14376
1990,3372,3156,3359,161757,162980,384,11.514,336,10.075,18310,4703,13607,2.886,11.235,20728,4955,15773,3.040,12.718,-2418,-1.484,22.469,272,273,3293
1990,3379,1138,1287,43491,43143,126,9.790,126,9.790,6645,1374,5271,3.185,15.402,5926,2181,3745,5.055,13.736,719,1.667,27.472,96,101,944
1990,3391,10463,11007,264013,260611,1083,9.879,994,9.067,33004,8637,24367,3.314,12.664,25861,6202,19659,2.380,9.923,7143,2.741,19.846,797,797,3603
1990,3399,16381,16911,417487,419342,2234,13.344,1895,11.319,56170,17945,38225,4.279,13.395,59774,18067,41707,4.308,14.254,-3604,-0.859,26.790,1521,1524,10741
1990,4231,18436,22005,266627,266800,2158,9.770,2326,10.530,40446,12119,28327,4.542,15.160,40753,16575,24178,6.213,15.275,-307,-0.115,30.319,1719,1778,10394
1990,4232,8133,9268,117565,116788,1204,13.059,1107,12.007,20949,7875,13074,6.743,17.938,19549,7117,12432,6.094,16.739,1400,1.199,33.478,846,863,4609
1990,4233,8049,10467,134809,136911,1130,10.804,1114,10.651,19560,6355,13205,4.642,14.287,23906,7900,16006,5.770,17.461,-4346,-3.174,28.573,800,819,4940
1990,4234,25076,34473,635070,629396,4149,12.114,3700,10.803,102091,31296,70795,4.972,16.220,91137,35022,56115,5.564,14.480,10954,1.740,28.960,2268,2381,17100
1990,4235,7057,9456,143099,142336,870,9.274,720,7.675,18806,5168,13638,3.631,13.212,17392,4873,12519,3.424,12.219,1414,0.993,24.438,468,493,3030
1990,4236,16360,23396,318742,312706,3239,14.156,2209,9.654,66085,29475,36610,9.426,21.133,53257,17179,36078,5.494,17.031,12828,4.102,34.062,1406,1447,9204
1990,4237,10794,14685,164939,163257,1236,8.445,1139,7.782,23270,7091,16179,4.343,14.254,19879,6841,13038,4.190,12.177,3391,2.077,24.353,771,795,4319
1990,4238,48791,63797,712433,702432,5846,9.228,4953,7.818,106612,31174,75438,4.438,15.178,86638,32182,54456,4.582,12.334,19974,2.844,24.668,3412,3533,20756
1990,4239,25386,27305,278337,276287,3656,13.459,3372,12.414,53852,17686,36166,6.401,19.491,49938,20145,29793,7.291,18.075,3914,1.417,36.149,2693,2723,14213
1990,4241,8896,12029,187409,181610,1210,10.140,1018,8.531,32633,16023,16610,8.823,17.969,21728,8415,13313,4.634,11.964,10905,6.005,23.928,671,685,4345
1990,4242,3175,4399,118819,117071,786,18.464,502,11.792,20146,8107,12039,6.925,17.208,16601,6397,10204,5.464,14.180,3545,3.028,28.361,332,337,2109
1990,4243,9009,9664,127363,124713,1800,18.917,1503,15.795,29246,9387,19859,7.527,23.451,23786,9993,13793,8.013,19.073,5460,4.378,38.145,1212,1234,6924
1990,4244,27331,33875,708720,704231,3644,10.737,3772,11.114,109946,34395,75551,4.884,15.612,100598,37697,62901,5.353,14.285,9348,1.327,28.570,2822,2857,21300
1990,4245,6717,9712,83764,84343,575,5.858,783,7.977,11437,3060,8377,3.628,13.560,12578,4713,7865,5.588,14.913,-1141,-1.353,27.120,561,593,3372
1990,4246,7892,11440,138093,135291,1221,10.781,991,8.751,23147,7044,16103,5.207,17.109,17671,5288,12383,3.909,13.062,5476,4.048,26.123,596,630,3021
1990,4247,9208,12280,137569,136263,776,6.259,1014,8.178,21259,5742,15517,4.214,15.601,18706,6132,12574,4.500,13.728,2553,1.874,27.456,601,626,3418
1990,4248,3733,4788,137601,137769,267,5.493,413,8.496,14444,4323,10121,3.138,10.484,14684,5086,9598,3.692,10.658,-240,-0.174,20.968,307,317,3240
1990,4249,20574,24708,305855,297459,3395,13.922,2751,11.281,58542,18933,39609,6.365,19.681,41718,16342,25376,5.494,14.025,16824,5.656,28.050,2065,2122,11511
1990,4251,31547,34056,314184,310401,3677,10.912,2957,8.776,55037,18365,36672,5.917,17.731,47384,17220,30164,5.548,15.265,7653,2.466,30.531,2097,2113,11662
1990,4411,39486,41507,990672,1010403,4642,11.197,4546,10.965,115132,50304,64828,4.979,11.395,154557,59781,94776,5.917,15.297,-39425,-3.902,22.789,3652,3692,47693
1990,4412,11123,11825,89058,91201,1128,9.416,1437,11.995,14991,5324,9667,5.838,16.437,19299,7391,11908,8.104,21.161,-4308,-4.724,32.875,1173,1206,6429
1990,4413,42853,62122,483035,481213,4888,7.841,5320,8.534,73140,25113,48027,5.219,15.199,69020,26589,42431,5.525,14.343,4120,0.856,28.686,3635,3848,17790
1990,4421,21863,28229,244179,244564,2878,10.184,2940,10.403,41710,16701,25009,6.829,17.055,42495,14760,27735,6.035,17.376,-785,-0.321,34.110,2150,2321,11079
1990,4422,23680,30356,201968,201432,3682,12.219,3237,10.742,40740,16596,24144,8.239,20.225,39676,13754,25922,6.828,19.697,1064,0.528,39.394,2417,2568,10116
1990,4431,29932,45901,343295,338751,6000,13.207,5061,11.140,74074,32582,41492,9.618,21.867,64755,26240,38515,7.746,19.116,9319,2.751,38.232,3294,3630,16333
1990,4441,56709,75256,851426,849427,5887,7.830,5751,7.649,118349,38573,79776,4.541,13.933,114850,35516,79334,4.181,13.521,3499,0.412,27.042,4198,4399,22967
1990,4442,17926,21938,178063,174280,1797,8.190,1806,8.231,31926,10131,21795,5.813,18.319,24549,8453,16096,4.850,14.086,7377,4.233,28.172,1367,1395,6197
1990,4451,62591,93897,2470725,2422417,10521,11.147,11502,12.186,365515,153789,211726,6.349,15.089,268098,110465,157633,4.560,11.067,97417,4.021,22.135,7690,7907,50760
1990,4452,20536,25021,163403,165106,3629,14.463,3770,15.025,34456,15039,19417,9.109,20.869,38132,15879,22253,9.617,23.095,-3676,-2.226,41.738,2892,2947,12384
1990,4453,26551,31454,154019,155398,3475,11.006,3715,11.766,29462,12605,16857,8.111,18.959,32224,12634,19590,8.130,20.736,-2762,-1.777,37.918,2831,2884,9334
1990,4461,50780,80428,766124,760944,7826,9.787,6904,8.634,121049,57522,63527,7.559,15.908,110675,41845,68830,5.499,14.544,10374,1.363,29.089,4422,4593,23136
1990,4471,83286,136448,993035,995550,12761,9.309,14036,10.239,187391,78689,108702,7.904,18.823,192400,76877,115523,7.722,19.326,-5009,-0.503,37.646,9456,9952,50337
1990,4481,52766,106096,982412,971145,13022,12.297,12623,11.920,198113,87747,110366,9.035,20.400,174632,62169,112463,6.402,17.982,23481,2.418,35.964,8046,8776,35606
1990,4482,10471,36975,209106,212228,3426,9.204,3922,10.536,39689,16393,23296,7.724,18.701,45400,18381,27019,8.661,21.392,-5711,-2.691,37.402,1556,1748,6955
1990,4483,19676,29567,182069,179972,3475,11.829,3095,10.535,37756,15363,22393,8.536,20.979,33379,13643,19736,7.581,18.547,4377,2.432,37.094,1973,2092,7382
1990,4511,33211,44040,334287,328923,5663,12.930,5180,11.827,67756,26281,41475,7.990,20.599,57511,19931,37580,6.059,17.485,10245,3.115,34.969,3998,4176,14265
1990,4512,8920,14138,100631,96225,1804,13.020,1239,8.942,22346,8031,14315,8.346,23.223,13574,5354,8220,5.564,14.107,8772,9.116,28.213,904,935,3902
1990,4522,189,6582,1158486,1137357,286,4.404,109,1.679,127041,35248,91793,3.099,11.170,84325,9975,74350,0.877,7.414,42716,3.756,14.828,8,8,690
1990,4523,12472,29748,1012112,1005490,2895,9.743,2826,9.511,130295,66098,64197,6.574,12.958,119947,33075,86872,3.289,11.929,10348,1.029,23.858,1505,1576,9565
1990,4531,24759,26235,137654,136233,3394,13.015,3079,11.807,27747,10662,17085,7.826,20.367,24808,10157,14651,7.456,18.210,2939,2.157,36.420,2445,2509,8139
1990,4532,31582,40023,272808,263199,5671,14.258,5176,13.013,68044,34326,33718,13.042,25.853,49483,20593,28890,7.824,18.801,18561,7.052,37.601,3995,4193,15432
1990,4533,10083,12091,66418,64579,1980,16.783,1394,11.816,14148,6008,8140,9.303,21.908,10510,4401,6109,6.815,16.275,3638,5.633,32.549,1092,1102,3206
1990,4539,24385,28642,150567,147522,5305,19.011,3830,13.725,38477,19014,19463,12.889,26.082,32444,14039,18405,9.517,21.993,6033,4.090,43.985,2856,2984,10473
1990,4541,5957,7328,125768,121815,1033,14.209,917,12.613,24776,6852,17924,5.625,20.339,16554,6208,10346,5.096,13.589,8222,6.750,27.179,628,638,3539
1990,4542,4261,5198,76666,76826,712,13.847,600,11.669,10792,4591,6201,5.976,14.047,11155,4619,6536,6.012,14.520,-363,-0.472,28.095,428,430,2172
1990,4543,17316,23839,235861,232888,2464,10.416,2098,8.869,41826,13489,28337,5.792,17.960,36041,11511,24530,4.943,15.476,5785,2.484,30.951,1599,1631,8747
1990,4811,689,2805,454168,429740,371,13.267,354,12.659,91462,18054,73408,4.201,21.283,41891,23714,18177,5.518,9.748,49571,11.535,19.496,97,106,3250
1990,4812,951,1044,13947,13428,216,21.471,140,13.917,3119,992,2127,7.388,23.228,2055,956,1099,7.120,15.304,1064,7.924,30.609,101,101,678
1990,4831,351,617,32006,31890,80,12.998,77,12.510,5360,1395,3965,4.374,16.808,5004,2103,2901,6.595,15.691,356,1.116,31.383,40,47,1080
1990,4832,308,342,12602,12764,43,12.628,40,11.747,1883,456,1427,3.573,14.753,2188,957,1231,7.498,17.143,-305,-2.390,29.506,25,25,323
1990,4841,25190,32021,650742,647959,4968,15.551,4821,15.090,116802,38131,78671,5.885,18.026,112632,37755,74877,5.827,17.383,4170,0.644,34.765,3700,3758,24891
1990,4842,42317,46017,485562,484322,7248,15.825,6816,14.882,100151,34154,65997,7.052,20.679,97949,38761,59188,8.003,20.224,2202,0.455,40.448,5337,5375,27516
1990,4851,407,434,35897,35165,59,13.882,41,9.647,3374,826,2548,2.349,9.595,1960,630,1330,1.792,5.574,1414,4.021,11.147,33,33,473
1990,4852,317,512,18074,18363,46,8.949,50,9.728,2912,973,1939,5.299,15.858,3544,747,2797,4.068,19.300,-632,-3.442,31.717,24,26,520
1990,4853,4982,5035,54200,54137,866,17.123,911,18.013,11538,4434,7104,8.190,21.313,11441,6128,5313,11.319,21.133,97,0.179,42.267,764,765,5387
1990,4854,3233,3762,113707,110441,332,8.870,294,7.855,20257,7084,13173,6.414,18.342,13573,4984,8589,4.513,12.290,6684,6.052,24.580,224,224,3393
1990,4855,791,841,19727,19411,132,15.884,112,13.478,4122,1443,2679,7.434,21.236,3499,1653,1846,8.516,18.026,623,3.210,36.053,87,87,1038
1990,4859,1496,1532,34477,33379,317,21.499,202,13.700,6577,2718,3859,8.143,19.704,4474,1837,2637,5.504,13.404,2103,6.300,26.808,163,163,1411
1990,4861,55,331,9795,9525,16,4.769,25,7.452,1255,548,707,5.754,13.177,743,176,567,1.848,7.801,512,5.376,15.602,8,8,56
1990,4862,257,1411,52522,53309,92,6.523,91,6.452,5023,1271,3752,2.384,9.422,6548,915,5633,1.716,12.283,-1525,-2.861,18.845,23,23,101
1990,4869,73,363,6466,6587,32,8.864,28,7.756,590,165,425,2.505,8.957,825,218,607,3.310,12.525,-235,-3.568,17.914,6,6,45
1990,4871,261,270,4899,4905,62,23.755,44,16.858,954,396,558,8.074,19.452,996,313,683,6.382,20.308,-42,-0.856,38.903,33,33,191
1990,4872,910,933,9573,9000,192,21.417,119,13.274,3035,1355,1680,15.056,33.722,1885,578,1307,6.422,20.944,1150,12.778,41.889,91,92,470
1990,4879,92,95,1047,971,18,19.355,14,15.054,259,95,164,9.789,26.687,109,78,31,8.037,11.231,150,15.456,22.463,10,10,74
1990,4881,2327,2898,83476,81450,438,15.275,377,13.147,15568,4381,11187,5.379,19.114,11284,5270,6014,6.470,13.854,4284,5.260,27.708,229,229,1532
1990,4882,409,603,18699,18321,79,13.233,67,11.223,2920,953,1967,5.202,15.938,2241,707,1534,3.859,12.232,679,3.706,24.464,25,25,421
1990,4883,2152,2578,86349,85147,274,10.581,297,11.469,15172,3263,11909,3.832,17.819,12735,3591,9144,4.217,14.956,2437,2.862,29.913,216,216,1771
1990,4884,3951,4199,31386,31031,784,19.159,570,13.930,7290,3272,4018,10.544,23.493,6597,2600,3997,8.379,21.260,693,2.233,42.519,433,448,1917
1990,4885,7368,9847,120236,115822,1519,15.820,1029,10.717,29160,11108,18052,9.591,25.177,20179,8055,12124,6.955,17.422,8981,7.754,34.845,709,722,4887
1990,4889,687,715,8266,7921,165,24.408,87,12.870,2174,1390,784,17.549,27.448,1518,369,1149,4.659,19.165,656,8.282,38.331,71,71,240
1990,4921,1690,4255,349844,341580,627,15.045,452,10.846,42526,13906,28620,4.071,12.450,26174,9595,16579,2.809,7.663,16352,4.787,15.325,280,281,2252
1990,4922,3542,3794,65422,65608,613,16.170,607,16.012,11047,3560,7487,5.426,16.838,11390,5260,6130,8.017,17.361,-343,-0.523,33.676,490,500,3596
1990,4931,6074,9933,436907,430027,1019,10.423,705,7.212,74421,27669,46752,6.434,17.306,60226,15195,45031,3.534,14.005,14195,3.301,28.010,303,314,3150
1990,5111,14501,17049,701244,693134,2148,12.752,1740,10.329,77608,24762,52846,3.572,11.197,61370,23224,38146,3.351,8.854,16238,2.343,17.708,1374,1390,10811
1990,5112,3833,4472,82154,77024,1056,24.736,650,15.226,21997,7732,14265,10.038,28.559,11847,5777,6070,7.500,15.381,10150,13.178,30.762,476,478,3927
1990,5121,9484,14052,242719,222005,2298,16.610,1864,13.473,76747,25819,50928,11.630,34.570,34811,12962,21849,5.839,15.680,41936,18.890,31.361,1158,1193,7162
1990,5122,2429,2454,19634,19301,425,17.165,469,18.942,5242,1604,3638,8.311,27.160,4598,2375,2223,12.305,23.823,644,3.337,47.646,395,395,2003
1990,5151,6237,7762,238876,239383,987,12.782,907,11.746,33483,15191,18292,6.346,13.987,34809,13843,20966,5.783,14.541,-1326,-0.554,27.974,618,635,8805
1990,5152,188,281,10732,9808,40,13.962,51,17.801,2944,1548,1396,15.783,30.016,1131,694,437,7.076,11.531,1813,18.485,23.063,22,22,76
1990,5173,5193,23896,1052028,1050743,2343,9.784,2444,10.206,126062,39120,86942,3.723,11.997,124774,36371,88403,3.461,11.875,1288,0.123,23.750,647,661,7680
1990,5174,203,361,16508,15495,63,18.000,41,11.714,4524,2730,1794,17.619,29.197,2542,452,2090,2.917,16.406,1982,12.792,32.812,19,19,252
1990,5179,1060,1823,41145,38917,415,23.533,296,16.785,10342,4790,5552,12.308,26.575,5930,2280,3650,5.859,15.238,4412,11.337,30.476,164,164,735
1990,5182,5471,7701,290723,282703,1216,15.898,1112,14.538,60833,25045,35788,8.859,21.518,44260,17699,26561,6.261,15.656,16573,5.862,31.312,604,613,4937
1990,5191,2660,3048,35968,36685,345,11.289,361,11.813,5620,2257,3363,6.152,15.320,6841,4645,2196,12.662,18.648,-1221,-3.328,30.639,221,221,1056
1990,5211,48,82,25144,25368,3,3.704,D,D,580,30,550,0.118,2.286,1016,D,871,D,4.005,-436,-1.719,4.573,0,0,0
1990,5221,17808,79752,2079906,2059871,4798,6.074,3278,4.150,271753,96173,175580,4.669,13.193,233147,51189,181958,2.485,11.319,38606,1.874,22.637,1050,1097,19498
1990,5222,21622,40302,502760,497081,4833,12.005,4745,11.786,104397,38529,65868,7.751,21.002,92017,40226,51791,8.092,18.511,12380,2.491,37.023,1814,1833,12264
1990,5223,6103,7099,71906,69001,1833,27.385,1022,15.269,21036,9274,11762,13.440,30.487,15312,6142,9170,8.901,22.191,5724,8.296,44.382,764,765,4543
1990,5231,6823,16593,318216,328058,4040,25.932,2013,12.921,72689,33883,38806,10.328,22.157,91847,31954,59893,9.740,27.997,-19158,-5.840,44.315,1050,1061,7915
1990,5232,90,103,7392,7345,6,5.634,13,12.207,441,8,433,0.109,6.004,335,113,222,1.538,4.561,106,1.443,9.122,8,8,84
1990,5239,15691,16567,205349,196605,3171,19.496,2567,15.782,55305,19727,35578,10.034,28.130,38052,16390,21662,8.337,19.355,17253,8.775,38.709,1958,1959,9600
1990,5241,7077,39110,1419412,1407727,4589,11.872,3676,9.510,200080,64772,135308,4.601,14.213,178294,45151,133143,3.207,12.665,21786,1.548,25.331,562,571,6591
1990,5242,104264,110455,836763,829671,13939,12.781,11151,10.225,175956,73272,102684,8.831,21.208,159185,63353,95832,7.636,19.187,16771,2.021,38.373,8230,8245,38533
1990,5259,819,1002,17267,14913,97,9.594,115,11.375,6556,961,5595,6.444,43.963,2103,1084,1019,7.269,14.102,4453,29.861,28.205,63,63,790
1990,5311,99286,103836,592846,583235,14053,13.649,12307,11.953,131956,63645,68311,10.912,22.625,112525,51736,60789,8.871,19.293,19431,3.332,38.587,9793,9816,37009
1990,5312,37781,40167,219158,221426,6645,16.605,6347,15.860,52796,24493,28303,11.062,23.844,57214,25365,31849,11.455,25.839,-4418,-1.995,47.687,4736,4752,17861
1990,5313,27426,29142,343350,335978,4765,16.506,4217,14.608,75398,31169,44229,9.277,22.441,60743,22458,38285,6.684,18.079,14655,4.362,36.159,3140,3153,13735
1990,5321,5478,10311,142103,141246,1081,10.356,1336,12.799,23453,7349,16104,5.203,16.604,21847,8721,13126,6.174,15.467,1606,1.137,30.935,807,910,6699
1990,5322,20909,27038,194269,188292,5027,18.934,4052,15.261,57299,27662,29637,14.691,30.431,45348,19484,25864,10.348,24.084,11951,6.347,48.168,3221,3375,16109
1990,5323,4237,6072,45744,44168,694,11.469,652,10.775,10963,4345,6618,9.837,24.821,7863,3178,4685,7.195,17.802,3100,7.019,35.605,431,454,2318
1990,5324,8147,10435,129110,126810,1269,12.110,1357,12.950,31123,7690,23433,6.064,24.543,26612,13644,12968,10.759,20.986,4511,3.557,41.972,950,969,5070
1990,5331,1027,1101,16726,16032,234,21.637,195,18.031,4697,1264,3433,7.884,29.299,3177,1766,1411,11.016,19.817,1520,9.481,39.634,136,136,1269
1990,5411,136057,141383,982067,967893,15055,10.737,12732,9.080,147949,50160,97789,5.182,15.286,119262,45925,73337,4.745,12.322,28687,2.964,24.644,9707,9772,35288
1990,5412,69749,73970,676626,672691,10407,14.279,8238,11.303,117073,44983,72090,6.687,17.404,109955,38038,71917,5.655,16.346,7118,1.058,32.691,6160,6215,25703
1990,5413,62843,70539,990475,965746,10222,14.777,7494,10.833,202222,66655,135567,6.902,20.939,153117,42321,110796,4.382,15.855,49105,5.085,31.710,5459,5525,26066
1990,5414,17415,17686,115451,113924,3360,19.429,2575,14.890,26973,11653,15320,10.229,23.676,23904,10362,13542,9.096,20.982,3069,2.694,41.965,2093,2098,8145
1990,5415,24063,27330,415595,396125,6781,25.889,4506,17.203,106020,47493,58527,11.989,26.764,67706,29740,37966,7.508,17.092,38314,9.672,34.184,3328,3351,16278
1990,5416,45022,47176,424549,409082,8931,19.080,8197,17.512,121534,47748,73786,11.672,29.709,90945,42191,48754,10.314,22.231,30589,7.477,44.463,6546,6576,33065
1990,5417,6843,8500,462174,452058,1113,13.310,837,10.010,56827,16366,40461,3.620,12.571,36547,8604,27943,1.903,8.085,20280,4.486,16.169,530,534,4042
1990,5418,29342,31700,404447,390047,5236,16.784,4230,13.559,93443,25457,67986,6.527,23.957,65570,26062,39508,6.682,16.811,27873,7.146,33.622,3351,3384,19207
1990,5419,34553,38388,310339,301964,4503,11.908,3360,8.885,66940,22242,44698,7.366,22.168,49914,17576,32338,5.821,16.530,17026,5.638,33.060,2579,2594,11813
1990,5511,27647,52036,3257969,3214607,6803,13.364,4544,8.926,559237,184855,374382,5.750,17.397,471939,116154,355785,3.613,14.681,87298,2.716,29.362,1034,1063,12361
1990,5611,12169,13168,252319,248498,2035,15.536,1896,14.475,63898,26893,37005,10.822,25.714,56430,23536,32894,9.471,22.708,7468,3.005,45.417,1458,1482,18024
1990,5612,455,807,76430,76446,142,18.264,83,10.675,15113,5702,9411,7.459,19.770,14856,4089,10767,5.349,19.433,257,0.336,38.867,40,40,1891
1990,5613,19084,26739,1567969,1482150,4828,18.631,3178,12.264,493852,159031,334821,10.730,33.320,323642,79840,243802,5.387,21.836,170210,11.484,43.672,2239,2283,44729
1990,5614,21663,24600,319131,306221,4094,16.942,3225,13.345,77710,28860,48850,9.425,25.377,51603,21575,30028,7.046,16.852,26107,8.526,33.703,2500,2527,12743
1990,5615,25146,30541,246509,243077,4096,13.568,3390,11.230,51901,19610,32291,8.067,21.352,44682,19109,25573,7.861,18.382,7219,2.970,36.764,2473,2595,13597
1990,5616,12952,15888,537301,521488,2695,17.306,2064,13.254,124325,41386,82939,7.936,23.840,92532,32283,60249,6.191,17.744,31793,6.097,35.488,1566,1580,19973
1990,5617,89492,93746,1137441,1110790,20115,22.078,14840,16.288,285679,105074,180605,9.459,25.719,232420,93666,138754,8.432,20.924,53259,4.795,41.848,11869,11893,61565
1990,5619,14772,15997,221291,216169,2879,18.444,2103,13.473,55944,20669,35275,9.562,25.880,45575,18009,27566,8.331,21.083,10369,4.797,42.166,1630,1640,12711
1990,5621,5666,5865,69941,68354,751,12.905,660,11.341,14155,4456,9699,6.519,20.708,10949,5100,5849,7.461,16.018,3206,4.690,32.036,548,548,4074
1990,5622,1927,2795,78212,75116,383,13.915,298,10.827,16100,4508,11592,6.001,21.434,10021,5001,5020,6.658,13.341,6079,8.093,26.682,184,185,1954
1990,5629,5044,5393,68882,67083,849,16.001,675,12.721,18453,5161,13292,7.693,27.508,14804,5840,8964,8.706,22.068,3649,5.440,44.136,503,503,3894
1990,6111,13559,14681,465158,457648,634,4.329,561,3.831,45844,8043,37801,1.757,10.017,30736,6876,23860,1.502,6.716,15108,3.301,13.432,395,396,5050
1990,6112,506,719,58851,57385,59,8.234,54,7.537,9566,4429,5137,7.718,16.670,6906,1518,5388,2.645,12.035,2660,4.635,24.069,27,34,1035
1990,6113,2033,2395,1046165,1027296,105,4.419,67,2.820,89654,17992,71662,1.751,8.727,52321,12539,39782,1.221,5.093,37333,3.634,10.186,36,36,1724
1990,6114,2778,3342,51793,51553,630,19.310,471,14.437,12022,4394,7628,8.523,23.320,11582,5392,6190,10.459,22.466,440,0.853,44.932,328,346,3788
1990,6115,4598,5629,77817,77041,767,13.887,555,10.049,17368,5547,11821,7.200,22.544,15858,4699,11159,6.099,20.584,1510,1.960,41.168,376,376,2479
1990,6116,13753,14503,123543,118173,2841,20.199,1965,13.971,32302,12557,19745,10.626,27.335,21479,8813,12666,7.458,18.176,10823,9.159,36.352,1555,1568,6518
1990,6117,1889,1949,23065,22254,435,23.539,233,12.608,4533,1525,3008,6.853,20.369,2957,1284,1673,5.770,13.287,1576,7.082,26.575,190,190,944
1990,6211,182797,193140,1395803,1356426,13970,7.253,12922,6.709,231924,68983,162941,5.086,17.098,153385,56369,97016,4.156,11.308,78539,5.790,22.616,10657,10812,43768
1990,6212,100248,103124,539116,530236,5574,5.431,4597,4.479,78328,19987,58341,3.769,14.772,60753,16983,43770,3.203,11.458,17575,3.315,22.915,3713,3757,14370
1990,6213,59063,61922,254873,242792,8558,14.235,4955,8.242,62839,24951,37888,10.277,25.882,38735,15770,22965,6.495,15.954,24104,9.928,31.908,3862,3920,12287
1990,6214,7797,12278,232806,225517,1397,11.596,935,7.761,43850,14323,29527,6.351,19.444,29116,10620,18496,4.709,12.911,14734,6.533,25.822,528,560,6241
1990,6215,5572,7250,115645,109591,1000,14.028,757,10.619,26337,9832,16505,8.972,24.032,14012,5399,8613,4.926,12.786,12325,11.246,25.571,537,561,3803
1990,6216,5326,8066,366491,345156,1222,15.535,822,10.450,91149,28803,62346,8.345,26.408,47836,13579,34257,3.934,13.859,43313,12.549,27.718,533,545,7802
1990,6219,5454,6351,126801,122504,949,15.273,674,10.847,28933,10123,18810,8.263,23.618,20129,9541,10588,7.788,16.431,8804,7.187,32.863,499,501,5878
1990,6221,3465,4929,3865845,3806021,145,2.938,156,3.161,237108,43253,193855,1.136,6.230,118277,39622,78655,1.041,3.108,118831,3.122,6.215,78,89,18069
1990,6222,560,927,339485,334395,64,7.060,23,2.537,31458,19070,12388,5.703,9.407,19341,2245,17096,0.671,5.784,12117,3.624,11.568,11,11,1453
1990,6223,231,304,112599,110501,24,8.067,11,3.697,7890,1631,6259,1.476,7.140,3552,1690,1862,1.529,3.214,4338,3.926,6.429,8,8,1404
1990,6231,8339,13971,1237931,1214333,981,7.094,698,5.047,150372,55648,94724,4.583,12.383,103495,40954,62541,3.373,8.523,46877,3.860,17.046,357,391,22043
1990,6232,6303,10903,241865,230847,1615,15.587,531,5.125,48754,21738,27016,9.417,21.120,26163,7415,18748,3.212,11.334,22591,9.786,22.667,344,371,4697
1990,6233,9662,11562,288991,282946,1676,14.770,1246,10.981,46701,18997,27704,6.714,16.505,34737,15090,19647,5.333,12.277,11964,4.228,24.554,845,858,9285
1990,6239,3716,4911,124480,119797,622,13.088,305,6.418,20701,7377,13324,6.158,17.280,11429,3905,7524,3.260,9.540,9272,7.740,19.081,180,180,2427
1990,6241,19109,25687,370639,358818,3165,12.700,1632,6.549,62464,19542,42922,5.446,17.408,38744,10127,28617,2.822,10.798,23720,6.611,21.595,1128,1143,6473
1990,6242,5338,6273,66863,64200,674,10.981,404,6.582,12297,4053,8244,6.313,19.154,6968,2433,4535,3.790,10.854,5329,8.301,21.707,276,276,1625
1990,6243,4919,7408,286164,281460,732,10.081,439,6.046,42886,7803,35083,2.772,15.237,33622,4643,28979,1.650,11.946,9264,3.291,23.891,216,244,2012
1990,6244,36059,43668,432020,415768,6166,14.475,4026,9.451,87604,37071,50533,8.916,21.070,54874,21583,33291,5.191,13.198,32730,7.872,26.396,3233,3280,17232
1990,7111,5227,5274,79042,74673,1061,20.757,736,14.399,20767,6302,14465,8.440,27.811,11973,3666,8307,4.909,16.034,8794,11.777,32.068,545,545,2416
1990,7112,2449,2578,70902,68507,476,18.692,413,16.218,14654,4525,10129,6.605,21.391,9980,3449,6531,5.035,14.568,4674,6.823,29.136,319,319,2610
1990,7113,2211,2269,40668,37828,377,16.823,321,14.324,11834,3485,8349,9.213,31.284,6072,2227,3845,5.887,16.052,5762,15.232,32.104,244,245,1341
1990,7114,1425,1446,16749,15644,283,20.085,209,14.833,5185,2537,2648,16.217,33.144,2834,1224,1610,7.824,18.116,2351,15.028,36.231,166,166,998
1990,7115,11808,11875,80334,75046,1996,16.335,2684,21.966,30698,7859,22839,10.472,40.906,20708,9748,10960,12.989,27.594,9990,13.312,55.188,2134,2134,8039
1990,7121,3077,3340,64293,62750,331,10.081,218,6.639,8733,2522,6211,4.019,13.917,5613,1651,3962,2.631,8.945,3120,4.972,17.890,156,159,1475
1990,7131,1626,2485,80499,78363,336,13.581,314,12.692,11560,2486,9074,3.172,14.752,7049,2012,5037,2.568,8.995,4511,5.757,17.991,217,221,1337
1990,7132,851,907,26143,24680,187,21.408,120,13.738,5764,2904,2860,11.767,23.355,2802,1272,1530,5.154,11.354,2962,12.002,22.707,91,91,901
1990,7139,37243,40335,644369,630112,5602,13.974,5111,12.749,127449,45589,81860,7.235,20.226,98571,37901,60670,6.015,15.643,28878,4.583,31.287,3919,3980,27802
1990,7211,30330,36825,1447153,1425968,4515,12.329,4104,11.207,255168,111064,144104,7.789,17.894,211623,92761,118862,6.505,14.841,43545,3.054,29.681,2990,3075,59137
1990,7212,4154,4467,28928,28611,573,12.937,497,11.221,7051,2549,4502,8.909,24.645,6300,2535,3765,8.860,22.020,751,2.625,44.040,321,337,1897
1990,7213,3619,3732,19751,19957,287,7.629,347,9.224,3126,851,2275,4.264,15.664,3518,1257,2261,6.299,17.628,-392,-1.964,31.328,258,258,836
1990,7223,13035,19907,373998,367514,3466,17.645,2939,14.962,89236,42535,46701,11.574,24.281,76029,29618,46411,8.059,20.687,13207,3.594,41.375,2198,2208,20169
1990,7224,51655,52618,336691,330794,8128,15.470,7976,15.180,90050,47932,42118,14.490,27.222,78418,38251,40167,11.563,23.706,11632,3.516,47.412,6478,6505,31957
1990,7225,224046,310561,5936519,5870656,48374,15.726,42455,13.802,1240754,649740,591014,11.068,21.135,1110297,466010,644287,7.938,18.913,130457,2.222,37.825,30758,31704,307053
1990,8111,118236,126288,672599,663026,18677,15.020,14798,11.900,149281,68997,80284,10.406,22.515,130055,55230,74825,8.330,19.615,19226,2.900,39.231,11794,11910,45779
1990,8112,12037,14337,134949,132132,2089,14.788,1668,11.808,28560,10892,17668,8.243,21.615,22885,9124,13761,6.905,17.320,5675,4.295,34.640,1214,1238,4821
1990,8113,21343,22669,182139,178513,2843,12.651,2450,10.902,35687,11366,24321,6.367,19.991,28612,10111,18501,5.664,16.028,7075,3.963,32.056,1918,1928,7440
1990,8114,25431,27454,178144,178135,4488,16.566,3763,13.890,34696,14340,20356,8.050,19.477,34697,13373,21324,7.507,19.478,-1,-0.001,38.955,2965,2987,8893
1990,8121,77383,87852,468368,460473,13161,15.033,12550,14.335,109759,54720,55039,11.883,23.836,94413,41713,52700,9.059,20.504,15346,3.333,41.007,10190,10371,32706
1990,8122,17028,20479,130100,128793,1483,7.232,1539,7.505,20194,6821,13373,5.296,15.679,17600,6175,11425,4.795,13.665,2594,2.014,27.331,1168,1223,5084
1990,8123,34333,41208,385821,383153,5563,13.611,4887,11.957,67526,28005,39521,7.309,17.624,62231,24742,37489,6.457,16.242,5295,1.382,32.484,3786,3969,19292
1990,8129,14261,23268,182466,179866,3727,16.175,3274,14.209,43117,18112,25005,10.070,23.972,37721,17196,20525,9.560,20.972,5396,3.000,41.944,2006,2061,9446
1990,8131,131827,131890,1109033,1092505,6233,4.764,4108,3.140,129643,19281,110362,1.765,11.867,96354,11524,84830,1.055,8.820,33289,3.047,17.639,2448,2448,7177
1990,8132,9451,10899,156184,151111,1141,10.715,640,6.010,25703,6007,19696,3.975,17.009,15559,3497,12062,2.314,10.296,10144,6.713,20.593,416,416,2129
1990,8133,8453,9956,110313,108356,1075,11.028,659,6.760,18910,5188,13722,4.788,17.452,14876,4213,10663,3.888,13.729,4034,3.723,27.458,451,452,2675
1990,8134,31117,32718,304579,297396,2346,7.213,1959,6.023,43932,9676,34256,3.254,14.772,29349,6689,22660,2.249,9.869,14583,4.904,19.737,1437,1437,4831
1990,8139,58869,61170,518445,508173,4957,8.156,4169,6.860,86208,20998,65210,4.132,16.964,65040,17013,48027,3.348,12.799,21168,4.166,25.598,3005,3013,11353
1991,1131,236,256,2752,2615,42,16.834,29,11.623,737,311,426,11.893,28.184,470,90,380,3.442,17.973,267,10.210,35.946,23,23,76
1991,1132,104,119,1687,1670,16,13.913,8,6.957,265,169,96,10.123,15.873,227,23,204,1.378,13.597,38,2.276,27.194,5,5,8
1991,1133,11152,11242,84295,88132,1513,13.291,1796,15.777,17330,6027,11303,6.839,19.664,25069,8970,16099,10.178,28.445,-7739,-8.781,39.327,1275,1278,6741
1991,1141,1002,1009,10559,9498,152,14.924,171,16.789,4091,1321,2770,13.909,43.074,2043,808,1235,8.508,21.511,2048,21.564,43.022,123,123,545
1991,1142,182,188,1423,1370,36,20.225,16,8.989,286,165,121,12.044,20.876,180,52,128,3.796,13.139,106,7.737,26.277,12,12,22
1991,1151,4312,4622,56268,55950,596,12.995,525,11.447,15592,5568,10024,9.952,27.868,15092,4776,10316,8.536,26.974,500,0.894,53.948,339,341,3070
1991,1152,2260,2297,15366,15048,360,15.947,281,12.447,3064,1434,1630,9.530,20.362,2435,857,1578,5.695,16.182,629,4.180,32.363,224,224,686
1991,1153,917,935,11496,11388,189,21.165,105,11.758,3276,1161,2115,10.195,28.767,3119,1073,2046,9.422,27.388,157,1.379,54.777,75,75,800
1991,2111,6878,8236,117045,117211,921,11.120,1014,12.243,18667,7744,10923,6.607,15.926,19215,7102,12113,6.059,16.394,-548,-0.468,31.852,658,670,3278
1991,2121,1922,2452,128052,131856,325,12.818,492,19.404,18278,7550,10728,5.726,13.862,25701,10124,15577,7.678,19.492,-7423,-5.630,27.724,365,367,5819
1991,2122,407,587,45899,46576,74,12.354,98,16.361,3868,1287,2581,2.763,8.305,5182,604,4578,1.297,11.126,-1314,-2.821,16.609,62,62,320
1991,2123,3491,5151,101341,103260,401,7.741,460,8.879,13978,4289,9689,4.154,13.537,17878,5237,12641,5.072,17.314,-3900,-3.777,27.073,261,266,2202
1991,2131,8577,9621,177928,172757,1312,13.749,1155,12.104,45176,17286,27890,10.006,26.150,34877,13457,21420,7.790,20.188,10299,5.962,40.377,817,826,7330
1991,2211,1693,6575,596067,596675,613,9.598,237,3.711,39763,18357,21406,3.077,6.664,40916,6319,34597,1.059,6.857,-1153,-0.193,13.328,92,92,1549
1991,2212,769,2842,146326,147964,196,6.928,170,6.009,9394,2806,6588,1.896,6.349,12543,3178,9365,2.148,8.477,-3149,-2.128,12.698,73,74,743
1991,2213,4115,4463,32700,32706,418,9.478,312,7.075,4584,2408,2176,7.363,14.016,4564,1778,2786,5.436,13.955,20,0.061,27.909,235,236,926
1991,2361,113628,114058,577926,625922,20759,18.034,22867,19.865,152553,66583,85970,10.638,24.373,248742,88374,160368,14.119,39.740,-96189,-15.368,48.745,15836,15840,64376
1991,2362,37473,38153,655087,693571,4425,11.444,5450,14.095,123607,26613,96994,3.837,17.822,200791,49322,151469,7.111,28.950,-77184,-11.128,35.644,4092,4102,36272
1991,2371,13700,14056,300532,307490,1283,9.085,1416,10.027,57824,12648,45176,4.113,18.805,72027,15629,56398,5.083,23.424,-14203,-4.619,37.610,1027,1031,10890
1991,2372,9587,9797,79659,86438,1557,15.161,2503,24.372,20511,8898,11613,10.294,23.729,33996,13729,20267,15.883,39.330,-13485,-15.601,47.459,2013,2018,10261
1991,2373,9305,9700,233068,246443,789,8.017,1072,10.893,40524,6719,33805,2.726,16.444,67237,13401,53836,5.438,27.283,-26713,-10.839,32.887,787,790,10283
1991,2379,4720,4791,76887,79049,602,12.349,770,15.795,18871,4066,14805,5.144,23.873,22942,5696,17246,7.206,29.023,-4071,-5.150,47.745,583,583,3423
1991,2381,76635,77052,663486,719458,9801,12.524,12212,15.605,149493,44420,105073,6.174,20.779,261486,70591,190895,9.812,36.345,-111993,-15.566,41.557,8830,8836,54218
1991,2382,123436,125301,1204438,1260256,13879,11.034,14841,11.799,213895,55947,157948,4.439,16.972,325849,92185,233664,7.315,25.856,-111954,-8.883,33.945,11122,11145,72307
1991,2383,81465,81943,615826,668169,13003,15.739,14350,17.369,143393,51591,91802,7.721,21.461,249386,70694,178692,10.580,37.324,-105993,-15.863,42.921,10343,10353,52556
1991,2389,41630,41889,348813,370483,5343,12.637,6125,14.487,80313,26158,54155,7.061,21.678,124207,32632,91575,8.808,33.526,-43894,-11.848,43.356,4410,4412,24520
1991,3111,1195,1804,49178,49383,106,5.869,110,6.091,5281,1337,3944,2.707,10.694,5628,2134,3494,4.321,11.397,-347,-0.703,21.388,61,63,745
1991,3112,474,818,65363,65293,31,3.733,56,6.743,4203,712,3491,1.090,6.437,4137,1348,2789,2.065,6.336,66,0.101,12.672,37,37,435
1991,3113,1575,1826,86182,86928,165,8.833,249,13.330,8342,2221,6121,2.555,9.596,9806,3454,6352,3.973,11.281,-1464,-1.684,19.193,156,164,2499
1991,3114,1186,1608,172939,174649,121,7.492,135,8.359,18634,4464,14170,2.556,10.669,22172,6183,15989,3.540,12.695,-3538,-2.026,21.339,93,93,3274
1991,3115,1364,1960,134593,136073,52,2.585,155,7.706,10753,731,10022,0.537,7.902,13566,5268,8298,3.871,9.970,-2813,-2.067,15.805,98,99,2098
1991,3116,3739,4372,394311,389476,307,6.934,418,9.441,45316,9186,36130,2.359,11.635,35254,14626,20628,3.755,9.052,10062,2.583,18.103,314,316,7847
1991,3117,703,819,45628,46119,66,7.942,90,10.830,7888,2074,5814,4.497,17.104,8861,2850,6011,6.180,19.214,-973,-2.110,34.208,62,64,2251
1991,3118,9149,10554,304410,304846,1210,11.435,1266,11.964,34989,10017,24972,3.286,11.478,36149,12706,23443,4.168,11.858,-1160,-0.381,22.955,931,939,8237
1991,3119,2146,2520,133745,133706,232,9.219,225,8.941,17558,5117,12441,3.827,13.132,17184,7111,10073,5.318,12.852,374,0.280,25.704,178,182,4843
1991,3121,1750,2176,138050,138095,144,6.553,187,8.510,13110,1902,11208,1.377,9.493,13165,3302,9863,2.391,9.533,-55,-0.040,18.987,133,134,1684
1991,3122,89,122,35249,36324,7,5.600,13,10.400,1031,83,948,0.228,2.838,3085,224,2861,0.617,8.493,-2054,-5.655,5.677,10,10,41
1991,3131,382,627,101609,104102,34,5.371,46,7.267,11274,7449,3825,7.156,10.830,16443,3043,13400,2.923,15.795,-5169,-4.965,21.660,29,29,1444
1991,3132,1647,1994,232142,238651,162,8.080,184,9.177,14076,4364,9712,1.829,5.898,27212,7726,19486,3.237,11.402,-13136,-5.504,11.796,130,132,4033
1991,3133,5163,5904,142752,144487,576,9.728,610,10.302,18354,5094,13260,3.526,12.703,21646,7616,14030,5.271,14.981,-3292,-2.278,25.406,442,448,5837
1991,3141,3411,3698,119517,126231,330,8.698,522,13.759,10489,2571,7918,2.037,8.309,24022,6191,17831,4.905,19.030,-13533,-10.721,16.619,429,438,3742
1991,3149,3987,4097,112836,115144,541,13.232,524,12.816,18199,6528,11671,5.669,15.805,22944,8031,14913,6.975,19.926,-4745,-4.121,31.611,435,437,6313
1991,3151,1165,1295,122478,129417,101,7.563,182,13.628,11630,1799,9831,1.390,8.986,25433,8752,16681,6.763,19.652,-13803,-10.666,17.973,144,144,4940
1991,3152,11582,12810,695100,719835,2097,16.265,2263,17.552,101720,39061,62659,5.426,14.131,151461,70027,81434,9.728,21.041,-49741,-6.910,28.262,1828,1862,43139
1991,3159,1791,1877,56442,57788,243,12.783,291,15.308,7214,2559,4655,4.428,12.484,9911,3702,6209,6.406,17.151,-2697,-4.667,24.967,235,237,2606
1991,3161,324,350,15175,15654,30,8.499,36,10.198,1547,766,781,4.893,9.883,2579,421,2158,2.689,16.476,-1032,-6.593,19.766,27,27,239
1991,3162,350,465,64168,67860,30,6.336,47,9.926,3829,1105,2724,1.628,5.643,11321,3511,7810,5.174,16.683,-7492,-11.040,11.285,32,32,1739
1991,3169,1057,1101,33345,34851,107,9.575,140,12.528,4207,1445,2762,4.146,12.072,7267,2712,4555,7.782,20.852,-3060,-8.780,24.143,111,113,2186
1991,3211,4372,4890,123788,131692,391,7.877,539,10.858,10279,3218,7061,2.444,7.805,25988,9041,16947,6.865,19.734,-15709,-11.929,15.611,401,402,5191
1991,3212,1292,1597,88713,96210,107,6.619,146,9.032,5990,2007,3983,2.086,6.226,20935,5116,15819,5.318,21.760,-14945,-15.534,12.452,106,107,3083
1991,3219,9274,9962,255682,272352,1068,10.663,1175,11.732,28014,9525,18489,3.497,10.286,61230,18839,42391,6.917,22.482,-33216,-12.196,20.572,879,883,12253
1991,3221,231,543,192577,193756,18,3.288,27,4.932,7208,2238,4970,1.155,3.720,9417,4873,4544,2.515,4.860,-2209,-1.140,7.440,11,11,956
1991,3222,3540,5171,394182,398671,245,4.700,329,6.311,28695,5482,23213,1.375,7.198,37844,12572,25272,3.153,9.493,-9149,-2.295,14.395,216,218,6076
1991,3231,42545,44496,817620,835901,4044,9.065,4274,9.581,82737,24355,58382,2.914,9.898,118972,45978,72994,5.500,14.233,-36235,-4.335,19.796,3447,3462,33935
1991,3241,1283,2226,112800,113018,156,6.997,163,7.311,7191,1707,5484,1.510,6.363,7524,2540,4984,2.247,6.657,-333,-0.295,12.725,83,89,873
1991,3251,1188,2418,239086,236351,157,6.550,115,4.798,16626,3728,12898,1.577,7.034,11054,3391,7663,1.435,4.677,5572,2.358,9.354,57,57,926
1991,3252,364,637,132617,133147,27,4.163,50,7.710,5744,978,4766,0.735,4.314,6848,1381,5467,1.037,5.143,-1104,-0.829,8.628,25,25,652
1991,3253,645,891,42510,42943,49,5.444,67,7.444,2681,536,2145,1.248,6.243,3506,1040,2466,2.422,8.164,-825,-1.921,12.486,43,43,536
1991,3254,1132,1405,177157,177025,130,9.289,119,8.503,16357,3872,12485,2.187,9.240,15840,5004,10836,2.827,8.948,517,0.292,17.896,79,81,3094
1991,3255,1671,2175,74002,75390,119,5.454,133,6.095,6946,1482,5464,1.966,9.213,9644,3244,6400,4.303,12.792,-2698,-3.579,18.427,71,71,938
1991,3256,2102,2353,118979,122007,154,6.417,248,10.333,12687,3137,9550,2.571,10.399,18714,8528,10186,6.990,15.339,-6027,-4.940,20.797,179,181,3136
1991,3259,2175,2838,134008,135021,225,7.932,222,7.827,10669,3309,7360,2.451,7.902,12606,4262,8344,3.157,9.336,-1937,-1.435,15.803,144,144,2292
1991,3261,10269,12293,637809,657943,983,8.003,962,7.832,64319,16919,47400,2.572,9.776,104973,29398,75575,4.468,15.955,-40654,-6.179,19.552,702,717,16868
1991,3262,2140,2640,186988,190374,244,9.361,177,6.791,12593,4480,8113,2.353,6.615,19164,4317,14847,2.268,10.067,-6571,-3.452,13.230,128,130,3319
1991,3271,1453,1744,74748,78689,171,9.724,200,11.373,5003,1424,3579,1.810,6.358,12962,3078,9884,3.912,16.473,-7959,-10.115,12.716,141,143,2039
1991,3272,1781,2045,132735,139170,188,9.120,221,10.720,7720,3272,4448,2.351,5.547,20331,6202,14129,4.456,14.609,-12611,-9.062,11.094,159,164,3778
1991,3273,6246,9086,169891,180482,623,6.815,734,8.029,20659,6984,13675,3.870,11.447,41997,10501,31496,5.818,23.269,-21338,-11.823,22.893,466,473,5626
1991,3274,247,341,16871,17786,18,5.014,54,15.042,710,116,594,0.652,3.992,2556,824,1732,4.633,14.371,-1846,-10.379,7.984,23,23,264
1991,3279,1895,2192,70917,74539,158,7.111,218,9.811,5014,1237,3777,1.660,6.727,12297,3210,9087,4.306,16.497,-7283,-9.771,13.453,139,140,1688
1991,3311,338,416,178157,182890,31,7.346,43,10.190,3630,442,3188,0.242,1.985,13375,1233,12142,0.674,7.313,-9745,-5.328,3.970,39,40,1187
1991,3312,535,721,61453,64313,31,4.229,55,7.503,4360,968,3392,1.505,6.779,9934,4075,5859,6.336,15.446,-5574,-8.667,13.559,34,36,2653
1991,3313,342,491,83965,87067,17,3.386,39,7.769,3140,486,2654,0.558,3.606,9191,3285,5906,3.773,10.556,-6051,-6.950,7.213,21,22,2142
1991,3314,777,943,78971,81421,69,7.233,91,9.539,3707,854,2853,1.049,4.553,8627,2698,5929,3.314,10.596,-4920,-6.043,9.106,60,60,552
1991,3315,2570,2839,200532,207816,155,5.413,204,7.124,13057,3624,9433,1.744,6.283,27641,6942,20699,3.340,13.301,-14584,-7.018,12.566,159,159,3872
1991,3321,3285,3490,135784,140142,195,5.533,264,7.490,11277,3133,8144,2.236,8.047,20070,6770,13300,4.831,14.321,-8793,-6.274,16.094,197,199,4376
1991,3322,1305,1439,73779,77172,101,6.997,110,7.620,6281,2657,3624,3.443,8.139,12904,6635,6269,8.598,16.721,-6623,-8.582,16.278,83,83,4498
1991,3323,10297,11111,311037,328718,800,7.133,1008,8.988,34647,10720,23927,3.261,10.540,69887,21409,48478,6.513,21.260,-35240,-10.720,21.080,775,778,13677
1991,3324,1548,1879,111450,114585,99,5.267,100,5.321,9288,1772,7516,1.546,8.106,15580,2961,12619,2.584,13.597,-6292,-5.491,16.212,70,71,1855
1991,3325,966,1058,66374,69804,63,5.921,75,7.049,3525,553,2972,0.792,5.050,10348,1992,8356,2.854,14.824,-6823,-9.775,10.100,52,52,988
1991,3326,1702,1884,67886,70772,139,7.247,207,10.792,5819,1948,3871,2.753,8.222,11626,3945,7681,5.574,16.427,-5807,-8.205,16.444,155,156,2563
1991,3327,21831,22165,331295,339233,1742,7.826,1932,8.679,38440,8751,29689,2.580,11.331,54463,16748,37715,4.937,16.055,-16023,-4.723,22.663,1515,1521,12954
1991,3328,5491,5865,130989,134978,352,5.968,418,7.087,13136,3218,9918,2.384,9.732,21042,5976,15066,4.427,15.589,-7906,-5.857,19.464,325,327,4586
1991,3329,6586,7102,342541,353056,514,7.157,674,9.385,27371,5764,21607,1.633,7.753,48242,14711,33531,4.167,13.664,-20871,-5.912,15.505,529,529,8425
1991,3331,3001,3256,205159,210889,248,7.621,244,7.498,17524,4902,12622,2.324,8.310,29037,6285,22752,2.980,13.769,-11513,-5.459,16.619,168,169,2667
1991,3332,4178,4434,159950,166709,285,6.367,370,8.265,15524,3527,11997,2.116,9.312,29221,11663,17558,6.996,17.528,-13697,-8.216,18.624,275,277,6603
1991,3333,2420,2552,144489,148526,213,8.366,201,7.895,10576,2828,7748,1.904,7.121,18887,4255,14632,2.865,12.716,-8311,-5.596,14.241,153,154,2856
1991,3334,1593,1845,145165,152478,104,5.557,157,8.389,9198,2043,7155,1.340,6.032,23978,6233,17745,4.088,15.726,-14780,-9.693,12.065,116,117,3141
1991,3335,9572,9913,219080,224586,602,6.056,658,6.619,18940,4809,14131,2.141,8.433,29993,8350,21643,3.718,13.355,-11053,-4.922,16.867,514,514,6136
1991,3336,738,885,124982,128106,37,4.160,46,5.171,6046,959,5087,0.749,4.720,12158,1722,10436,1.344,9.491,-6112,-4.771,9.439,33,33,1056
1991,3339,5504,6122,315162,321537,381,6.187,454,7.372,27685,8309,19376,2.584,8.610,40324,11190,29134,3.480,12.541,-12639,-3.931,17.220,332,333,6660
1991,3341,1686,1814,247585,254241,242,13.348,240,13.238,25265,6744,18521,2.653,9.937,38852,13398,25454,5.270,15.282,-13587,-5.344,19.875,174,176,5065
1991,3342,1842,2041,230408,237633,198,9.725,188,9.234,21043,5231,15812,2.201,8.855,35224,8051,27173,3.388,14.823,-14181,-5.968,17.711,119,119,2952
1991,3343,419,450,32166,33883,42,9.140,61,13.275,2474,593,1881,1.750,7.302,5804,1628,4176,4.805,17.130,-3330,-9.828,14.603,52,52,1529
1991,3344,5275,5858,485293,502251,591,10.079,602,10.267,47065,12294,34771,2.448,9.371,80902,34089,46813,6.787,16.108,-33837,-6.737,18.742,426,432,16067
1991,3345,4487,5118,594744,618707,350,6.780,438,8.485,35476,10608,24868,1.715,5.734,84012,19153,64859,3.096,13.579,-48536,-7.845,11.468,302,303,8171
1991,3346,753,801,46438,48675,100,12.446,105,13.068,6866,2418,4448,4.968,14.106,10965,2214,8751,4.549,22.527,-4099,-8.421,28.212,82,83,1437
1991,3351,1189,1305,74601,79022,108,8.173,141,10.670,4911,1535,3376,1.942,6.215,13819,4362,9457,5.520,17.488,-8908,-11.273,12.429,109,111,2818
1991,3352,397,474,98113,103387,37,7.700,50,10.406,5590,678,4912,0.656,5.407,16450,5382,11068,5.206,15.911,-10860,-10.504,10.814,28,28,612
1991,3353,2184,2622,214497,222800,144,5.414,220,8.271,11965,2084,9881,0.935,5.370,28541,9484,19057,4.257,12.810,-16576,-7.440,10.741,133,133,2913
1991,3359,2132,2519,193712,200337,133,5.186,224,8.735,14770,3517,11253,1.756,7.373,27935,9458,18477,4.721,13.944,-13165,-6.571,14.745,148,149,4595
1991,3361,265,321,191861,208376,37,11.544,36,11.232,10070,220,9850,0.106,4.833,43308,731,42577,0.351,20.784,-33238,-15.951,9.665,24,24,304
1991,3362,1780,1969,93066,101585,145,7.180,246,12.181,9341,2375,6966,2.338,9.195,26306,8392,17914,8.261,25.896,-16965,-16.700,18.391,180,182,4437
1991,3363,4155,5023,595392,624415,363,7.178,431,8.523,36396,11596,24800,1.857,5.829,94584,17326,77258,2.775,15.148,-58188,-9.319,11.658,297,304,7238
1991,3364,1501,1839,648530,669059,134,7.255,150,8.121,39357,23854,15503,3.565,5.882,80043,8656,71387,1.294,11.964,-40686,-6.081,11.765,107,107,2096
1991,3365,172,212,30651,31124,18,8.612,12,5.742,3302,347,2955,1.115,10.609,4430,940,3490,3.020,14.233,-1128,-3.624,21.218,7,7,253
1991,3366,1321,1416,153801,158654,135,9.444,162,11.333,17173,2214,14959,1.395,10.824,26756,6393,20363,4.030,16.864,-9583,-6.040,21.648,111,112,3079
1991,3369,467,480,29307,29736,46,9.350,70,14.228,2697,250,2447,0.841,9.070,3654,699,2955,2.351,12.288,-957,-3.218,18.140,54,54,442
1991,3371,13272,13930,349034,370259,1632,11.562,2002,14.183,34518,10465,24053,2.826,9.323,77206,29235,47971,7.896,20.852,-42688,-11.529,18.645,1546,1565,21316
1991,3372,3056,3255,145571,154323,294,8.897,393,11.893,14211,5608,8603,3.634,9.209,31814,10100,21714,6.545,20.615,-17603,-11.407,18.417,309,309,5829
1991,3379,1115,1258,38284,40835,92,7.236,119,9.359,3085,917,2168,2.246,7.555,8223,2007,6216,4.915,20.137,-5138,-12.582,15.110,99,99,1470
1991,3391,9971,10534,264898,265084,958,9.078,996,9.438,32173,7278,24895,2.746,12.137,32395,12085,20310,4.559,12.221,-222,-0.084,24.274,742,746,5321
1991,3399,16152,16677,391537,403192,1870,11.147,2069,12.333,45081,12836,32245,3.184,11.181,68439,21844,46595,5.418,16.974,-23358,-5.793,22.362,1688,1693,15402
1991,4231,17497,21238,245886,253802,2232,10.451,2469,11.561,32715,12687,20028,4.999,12.890,48543,18141,30402,7.148,19.126,-15828,-6.236,25.780,1808,1866,12741
1991,4232,7721,8820,107360,111410,1038,11.599,1296,14.482,16048,5030,11018,4.515,14.405,23933,9059,14874,8.131,21.482,-7885,-7.077,28.809,956,982,6575
1991,4233,7749,10139,123126,127491,1021,9.960,1246,12.154,18150,7394,10756,5.800,14.236,26958,9310,17648,7.302,21.145,-8808,-6.909,28.473,849,860,5903
1991,4234,23077,32588,604968,607069,4762,14.797,3952,12.280,104890,45040,59850,7.419,17.278,109217,45190,64027,7.444,17.991,-4327,-0.713,34.556,2283,2383,20131
1991,4235,6822,9253,132923,136858,824,8.897,842,9.091,14401,4648,9753,3.396,10.523,22204,7900,14304,5.772,16.224,-7803,-5.702,21.045,551,580,4897
1991,4236,16118,23400,304803,310449,2916,12.558,2556,11.008,52685,21705,30980,6.991,16.971,64011,23952,40059,7.715,20.619,-11326,-3.648,33.941,1571,1630,12157
1991,4237,10348,14331,154806,158525,1316,9.199,1266,8.849,20406,7942,12464,5.010,12.872,27904,10628,17276,6.704,17.602,-7498,-4.730,25.745,792,812,6372
1991,4238,46544,61819,662930,676357,5501,8.889,5628,9.095,85672,28109,57563,4.156,12.667,112591,41618,70973,6.153,16.647,-26919,-3.980,25.333,3777,3896,24302
1991,4239,23803,25785,259918,263467,3539,13.729,3523,13.667,46958,16733,30225,6.351,17.823,54480,21100,33380,8.009,20.678,-7522,-2.855,35.646,2766,2784,15643
1991,4241,8627,11694,177994,180633,1048,8.939,1107,9.443,22479,5203,17276,2.880,12.445,27895,10043,17852,5.560,15.443,-5416,-2.998,24.889,712,724,6940
1991,4242,3223,4387,123747,121068,626,14.252,637,14.502,22194,8800,13394,7.269,18.332,16614,6583,10031,5.437,13.723,5580,4.609,27.446,362,370,2210
1991,4243,9108,9785,118796,122440,1717,17.554,1709,17.473,23863,9628,14235,7.863,19.490,31281,13173,18108,10.759,25.548,-7418,-6.059,38.979,1370,1388,9394
1991,4244,25980,32471,670637,679312,3656,11.226,3847,11.813,89310,28342,60968,4.172,13.147,106858,43353,63505,6.382,15.730,-17548,-2.583,26.294,2894,2947,27331
1991,4245,6389,9365,80631,82278,564,5.930,856,9.000,10990,3140,7850,3.816,13.357,14327,4705,9622,5.718,17.413,-3337,-4.056,26.714,550,597,3104
1991,4246,7727,11527,134814,134878,1433,12.635,1062,9.364,21397,9365,12032,6.943,15.864,21460,8579,12881,6.361,15.911,-63,-0.047,31.728,585,601,3200
1991,4247,9031,12129,130736,133687,912,7.439,1175,9.584,19326,6632,12694,4.961,14.456,25334,9387,15947,7.022,18.950,-6008,-4.494,28.912,656,676,5276
1991,4248,3559,4591,132370,134483,219,4.661,434,9.237,12016,2832,9184,2.106,8.935,16162,7102,9060,5.281,12.018,-4146,-3.083,17.870,318,330,5199
1991,4249,20965,25334,296274,300633,3252,12.847,3210,12.681,48261,17989,30272,5.984,16.053,57302,24673,32629,8.207,19.060,-9041,-3.007,32.106,2350,2381,14278
1991,4251,30816,33348,299570,303030,3740,11.291,3289,9.930,46584,16595,29989,5.476,15.373,53739,19891,33848,6.564,17.734,-7155,-2.361,30.745,2251,2259,13669
1991,4411,38604,40649,918678,952502,4156,10.116,5027,12.236,97825,42930,54895,4.507,10.270,165435,70848,94587,7.438,17.368,-67610,-7.098,20.541,4078,4144,60468
1991,4412,9934,10627,74348,79292,1030,9.504,1450,13.380,11025,4323,6702,5.452,13.904,20916,8030,12886,10.127,26.378,-9891,-12.474,27.809,1156,1185,6497
1991,4413,39484,59176,452122,460897,4657,7.817,5449,9.147,66274,25379,40895,5.506,14.379,83519,29320,54199,6.362,18.121,-17245,-3.742,28.759,3718,3915,19698
1991,4421,20955,27478,225966,233353,2877,10.406,3216,11.632,34183,14933,19250,6.399,14.649,49075,17239,31836,7.388,21.030,-14892,-6.382,29.297,2223,2425,12574
1991,4422,21447,28536,182604,187227,3679,12.912,3594,12.613,34368,15333,19035,8.190,18.356,43481,15193,28288,8.115,23.224,-9113,-4.867,36.713,2519,2632,10283
1991,4431,28598,45273,333081,334980,5845,12.999,5232,11.635,64571,28988,35583,8.654,19.276,67925,26960,40965,8.048,20.277,-3354,-1.001,38.552,3528,3754,17166
1991,4441,53695,72383,798809,818476,5210,7.143,6319,8.664,98442,36221,62221,4.425,12.027,138303,45021,93282,5.501,16.898,-39861,-4.870,24.055,4435,4607,28376
1991,4442,16769,20790,167459,169718,1682,8.046,1909,9.132,25147,7630,17517,4.496,14.817,29739,9399,20340,5.538,17.523,-4592,-2.706,29.634,1386,1408,6730
1991,4451,61503,91822,2429981,2448079,9804,10.568,11710,12.622,301261,145262,155999,5.934,12.306,336674,123431,213243,5.042,13.753,-35413,-1.447,24.612,7623,7834,71424
1991,4452,19269,23389,152129,155946,3074,12.855,4121,17.234,30038,13412,16626,8.600,19.262,37697,18062,19635,11.582,24.173,-7659,-4.911,38.524,2698,2788,12631
1991,4453,26728,31394,150170,154519,2877,9.020,3882,12.171,25432,9089,16343,5.882,16.459,34392,15065,19327,9.750,22.258,-8960,-5.799,32.918,2874,2942,10117
1991,4461,51523,81639,794619,791262,6582,8.022,7395,9.013,124139,45724,78415,5.779,15.689,116636,48470,68166,6.126,14.741,7503,0.948,29.481,4743,4930,27342
1991,4471,79626,133155,949385,971843,12014,8.912,15313,11.359,168436,73135,95301,7.525,17.332,212700,83510,129190,8.593,21.886,-44264,-4.555,34.663,9732,10184,51517
1991,4481,49653,103435,980325,977787,11958,11.447,14025,13.425,197220,88384,108836,9.039,20.170,192275,76379,115896,7.811,19.664,4945,0.506,39.329,7909,9345,40945
1991,4482,9411,35434,194171,200969,2854,7.923,4027,11.180,30263,15254,15009,7.590,15.059,43354,16325,27029,8.123,21.572,-13091,-6.514,30.117,1552,1680,6427
1991,4483,19812,29435,171600,177987,3052,10.270,3617,12.171,29302,12752,16550,7.165,16.463,42419,17631,24788,9.906,23.833,-13117,-7.370,32.926,2135,2337,9046
1991,4511,33436,44785,332191,335210,5554,12.395,5603,12.504,61876,30143,31733,8.992,18.459,67239,24211,43028,7.223,20.059,-5363,-1.600,36.918,4184,4401,16799
1991,4512,9335,14785,107292,105326,1573,10.720,1351,9.207,21949,7315,14634,6.945,20.839,18097,6458,11639,6.131,17.182,3852,3.657,34.364,994,1017,4419
1991,4522,188,6476,1076295,1115843,275,4.226,338,5.194,71674,34796,36878,3.118,6.423,151827,27661,124166,2.479,13.606,-80153,-7.183,12.847,14,25,1951
1991,4523,12417,29781,1051887,1041783,2615,8.688,3252,10.804,137531,68769,68762,6.601,13.202,121992,41467,80525,3.980,11.710,15539,1.492,23.420,1552,1676,7969
1991,4531,25347,26837,135458,138186,3039,11.278,3258,12.091,24256,9381,14875,6.789,17.553,29518,10770,18748,7.794,21.361,-5262,-3.808,35.106,2641,2676,8735
1991,4532,31955,40796,269682,272784,5215,12.754,5400,13.207,53860,24987,28873,9.160,19.745,60018,24074,35944,8.825,22.002,-6158,-2.257,39.489,4054,4224,17024
1991,4533,10902,13039,71720,70479,1984,15.457,1577,12.286,14760,6754,8006,9.583,20.942,12477,4828,7649,6.850,17.703,2283,3.239,35.406,1212,1226,3606
1991,4539,26175,30466,154722,156972,4532,14.900,4432,14.571,35002,16520,18482,10.524,22.298,39642,16585,23057,10.566,25.254,-4640,-2.956,44.597,3206,3314,12018
1991,4541,6459,7837,128759,127725,1161,15.021,945,12.227,23964,7460,16504,5.841,18.762,21965,7701,14264,6.029,17.197,1999,1.565,34.394,705,730,6374
1991,4542,4419,5415,67559,71946,830,15.474,728,13.572,8654,3924,4730,5.454,12.029,17358,8820,8538,12.259,24.127,-8704,-12.098,24.057,489,492,2637
1991,4543,16921,23294,224246,229698,2280,9.691,2748,11.680,34857,12034,22823,5.239,15.175,45762,18542,27220,8.072,19.923,-10905,-4.748,30.350,1724,1825,11192
1991,4811,506,2924,471689,461587,538,19.259,277,9.916,72895,12449,60446,2.697,15.792,52863,13049,39814,2.827,11.452,20032,4.340,22.905,97,97,1193
1991,4812,1161,1295,15528,16602,248,19.840,158,12.640,3177,1769,1408,10.655,19.136,5314,1630,3684,9.818,32.008,-2137,-12.872,38.272,104,104,1432
1991,4831,377,659,37229,34210,89,13.831,58,9.013,10239,3391,6848,9.912,29.930,4033,1656,2377,4.841,11.789,6206,18.141,23.578,27,29,661
1991,4832,328,369,14019,13467,57,15.900,36,10.042,2405,830,1575,6.163,17.859,1318,403,915,2.993,9.787,1087,8.072,19.574,22,23,299
1991,4841,24515,31174,627168,638470,4465,14.125,5338,16.887,98305,31931,66374,5.001,15.397,121533,52777,68756,8.266,19.035,-23228,-3.638,30.794,3837,3903,29440
1991,4842,41961,45439,455668,470975,6701,14.632,7414,16.189,84124,31390,52734,6.665,17.862,115328,44046,71282,9.352,24.487,-31204,-6.625,35.723,5460,5498,30336
1991,4851,421,465,36902,36619,80,17.917,43,9.630,4912,3112,1800,8.498,13.414,4371,692,3679,1.890,11.936,541,1.477,23.873,29,30,141
1991,4852,391,593,15932,16615,141,24.500,106,18.419,3472,1460,2012,8.788,20.897,4898,1763,3135,10.611,29.480,-1426,-8.583,41.795,30,32,729
1991,4853,4851,4950,49746,51486,891,18.015,883,17.853,9980,5212,4768,10.123,19.384,13372,5380,7992,10.449,25.972,-3392,-6.588,38.768,759,760,4229
1991,4854,3199,4023,117863,115951,619,15.862,378,9.686,28125,17483,10642,15.078,24.256,23998,7548,16450,6.510,20.697,4127,3.559,41.394,291,295,4664
1991,4855,859,956,21155,20520,233,26.121,105,11.771,5403,3165,2238,15.424,26.331,4186,1195,2991,5.824,20.400,1217,5.931,40.800,81,81,774
1991,4859,1586,1686,35735,35391,418,26.322,222,13.980,7804,4342,3462,12.269,22.051,7065,2169,4896,6.129,19.963,739,2.088,39.925,184,184,1739
1991,4861,50,410,10077,9801,83,21.756,26,6.815,1982,1330,652,13.570,20.222,1363,851,512,8.683,13.907,619,6.316,27.813,4,4,486
1991,4862,280,1442,52413,52531,94,6.512,97,6.720,6555,2943,3612,5.602,12.478,6792,2722,4070,5.182,12.930,-237,-0.451,24.957,36,36,345
1991,4869,62,325,6527,6487,26,7.580,62,18.076,792,267,525,4.116,12.209,768,407,361,6.274,11.839,24,0.370,23.678,9,9,21
1991,4871,282,290,5200,4972,76,27.338,52,18.705,1816,1189,627,23.914,36.525,1300,353,947,7.100,26.146,516,10.378,52.293,42,42,305
1991,4872,957,979,9761,9745,173,17.965,141,14.642,2545,1044,1501,10.714,26.117,2516,1259,1257,12.920,25.820,29,0.298,51.639,112,112,935
1991,4879,123,129,1474,1429,37,31.356,15,12.712,392,195,197,13.646,27.432,293,53,240,3.709,20.504,99,6.928,41.008,9,9,41
1991,4881,2320,2939,81670,81861,516,17.948,388,13.496,17201,7586,9615,9.267,21.013,17489,7036,10453,8.595,21.364,-288,-0.352,42.025,238,238,3675
1991,4882,463,682,20690,20058,112,17.191,51,7.828,5071,2738,2333,13.650,25.282,3845,725,3120,3.615,19.169,1226,6.112,38.339,27,27,386
1991,4883,2155,2603,83955,85160,283,10.880,279,10.727,14255,4480,9775,5.261,16.739,17255,4766,12489,5.597,20.262,-3000,-3.523,33.478,204,206,2357
1991,4884,4098,4316,31371,31292,717,16.811,615,14.420,7198,3774,3424,12.061,23.003,7017,3014,4003,9.632,22.424,181,0.578,44.849,429,443,2121
1991,4885,8075,10677,114848,115307,1677,16.192,1037,10.013,23567,8129,15438,7.050,20.439,24629,10293,14336,8.927,21.360,-1062,-0.921,40.877,688,726,5801
1991,4889,747,779,7942,8045,154,20.547,95,12.675,1883,798,1085,9.919,23.406,2123,767,1356,9.534,26.389,-240,-2.983,46.812,76,76,510
1991,4921,1533,4281,373903,363385,511,12.004,463,10.876,43173,9635,33538,2.651,11.881,20496,8452,12044,2.326,5.640,22677,6.240,11.281,272,272,2502
1991,4922,3595,3781,60651,63250,653,17.148,707,18.566,11304,4475,6829,7.075,17.872,16876,10068,6808,15.918,26.681,-5572,-8.809,35.744,510,517,3615
1991,4931,6205,10298,435722,436686,1096,10.832,737,7.284,69214,24859,44355,5.693,15.850,71542,18746,52796,4.293,16.383,-2328,-0.533,31.700,334,342,5996
1991,5111,14671,17268,683255,693706,1897,10.962,1973,11.401,50307,14181,36126,2.044,7.252,71080,22265,48815,3.210,10.246,-20773,-2.994,14.504,1567,1579,15984
1991,5112,4339,5106,97897,92877,1074,21.900,670,13.662,22460,8390,14070,9.033,24.183,12625,5867,6758,6.317,13.593,9835,10.589,27.186,468,481,4126
1991,5121,9505,14096,240477,241842,2057,14.633,1980,14.085,43303,17569,25734,7.265,17.906,46562,20340,26222,8.410,19.253,-3259,-1.348,35.811,1138,1186,7283
1991,5122,1845,1871,16420,16607,311,16.019,452,23.281,3275,1458,1817,8.780,19.721,3624,1793,1831,10.797,21.823,-349,-2.102,39.442,373,373,1374
1991,5151,5990,7958,236845,237818,1200,15.386,883,11.321,36370,20493,15877,8.617,15.293,38732,14929,23803,6.277,16.286,-2362,-0.993,30.586,606,619,7950
1991,5152,192,308,11339,11186,62,20.564,49,16.252,2264,1410,854,12.606,20.240,2038,518,1520,4.631,18.220,226,2.020,36.440,30,30,170
1991,5173,5022,27283,1048200,1055168,5931,23.110,2694,10.497,206042,124641,81401,11.812,19.527,221127,45931,175196,4.353,20.957,-15085,-1.430,39.054,667,675,7418
1991,5174,162,303,11936,12743,53,17.236,62,20.163,2098,462,1636,3.626,16.464,3623,3108,515,24.390,28.431,-1525,-11.967,32.928,25,25,221
1991,5179,1094,1987,40397,39825,592,30.890,451,23.532,10733,6286,4447,15.784,26.951,9615,3215,6400,8.073,24.143,1118,2.807,48.287,228,230,1316
1991,5182,5526,7784,284348,289337,1284,16.470,1308,16.778,52446,20491,31955,7.082,18.126,62185,26130,36055,9.031,21.492,-9739,-3.366,36.253,579,586,7658
1991,5191,2586,3019,37736,38352,345,11.343,390,12.823,6839,3438,3401,8.964,17.832,7945,2937,5008,7.658,20.716,-1106,-2.884,35.664,279,293,2637
1991,5211,44,77,24833,24929,5,6.711,0,0.000,630,232,398,0.931,2.527,828,0,828,0.000,3.321,-198,-0.794,5.054,0,0,0
1991,5221,21983,98050,2095367,2125497,17780,19.361,5345,5.820,404563,253604,150959,11.932,19.034,463841,90876,372965,4.276,21.823,-59278,-2.789,38.068,1314,1714,36283
1991,5222,15329,36213,442086,442586,6179,17.459,4535,12.814,118872,75894,42978,17.148,26.859,121444,46556,74888,10.519,27.440,-2572,-0.581,53.717,1946,1974,20162
1991,5223,6745,8624,77290,73978,2581,32.374,1278,16.030,27209,18929,8280,25.588,36.780,20878,7097,13781,9.593,28.222,6331,8.558,56.444,915,922,4784
1991,5231,6465,17616,304145,308077,3619,21.245,2456,14.418,60112,30374,29738,9.859,19.512,69072,22541,46531,7.317,22.420,-8960,-2.908,39.024,1073,1108,7749
1991,5232,74,90,7424,7738,10,11.173,9,10.056,595,411,184,5.312,7.690,1223,49,1174,0.633,15.806,-628,-8.116,15.380,9,9,49
1991,5239,15146,16339,177436,173149,3336,20.863,2638,16.498,46814,27149,19665,15.680,27.037,38482,20295,18187,11.721,22.225,8332,4.812,44.450,1941,1944,14431
1991,5241,8098,41207,1490035,1465834,4697,11.463,4234,10.333,223950,99789,124161,6.808,15.278,176307,50933,125374,3.475,12.028,47643,3.250,24.056,669,680,6739
1991,5242,103976,115272,921576,958003,17104,15.211,11457,10.189,209593,107197,102396,11.190,21.878,285428,90105,195323,9.406,29.794,-75835,-7.916,43.756,8394,8409,53955
1991,5259,928,1122,17994,18676,135,12.312,84,7.661,4340,1499,2841,8.027,23.239,6030,1775,4255,9.504,32.288,-1690,-9.049,46.478,51,51,907
1991,5311,91041,98095,532234,539785,13519,13.830,12831,13.126,117201,60956,56245,11.293,21.713,131103,55214,75889,10.229,24.288,-13902,-2.575,43.425,10309,10336,43420
1991,5312,37847,42101,207937,215135,8050,19.319,7187,17.248,55988,33025,22963,15.351,26.025,70820,29333,41487,13.635,32.919,-14832,-6.894,52.049,5372,5405,20877
1991,5313,27937,30769,331448,341860,5744,19.033,4565,15.126,81945,44176,37769,12.922,23.970,102287,45544,56743,13.322,29.921,-20342,-5.950,47.941,3441,3473,20076
1991,5321,5027,9837,131834,135762,1097,11.011,1348,13.531,20728,9139,11589,6.732,15.268,28205,10501,17704,7.735,20.775,-7477,-5.507,30.536,774,834,6725
1991,5322,21077,28338,208738,202624,5354,19.274,4234,15.242,66141,40252,25889,19.865,32.642,55181,24290,30891,11.988,27.233,10960,5.409,54.466,3044,3225,15749
1991,5323,3933,5944,40355,41947,702,11.876,636,10.760,7592,2766,4826,6.594,18.099,10666,4330,6336,10.323,25.427,-3074,-7.328,36.198,419,433,3056
1991,5324,7571,10118,122154,123327,1415,14.015,1372,13.589,24025,9256,14769,7.505,19.481,26407,11239,15168,9.113,21.412,-2382,-1.931,38.962,913,937,6089
1991,5331,1056,1169,14525,15174,308,28.038,167,15.203,3526,1745,1781,11.500,23.237,4876,2871,2005,18.921,32.134,-1350,-8.897,46.474,130,131,2616
1991,5411,136925,142915,971199,976268,14918,10.497,13332,9.381,135476,51205,84271,5.245,13.877,146408,53511,92897,5.481,14.997,-10932,-1.120,27.754,10307,10379,42922
1991,5412,71608,75776,707757,701006,10119,13.495,8530,11.376,123864,48766,75098,6.957,17.669,110717,44249,66468,6.312,15.794,13147,1.875,31.588,6266,6352,26848
1991,5413,62659,70820,954462,967315,9368,13.289,8721,12.371,159803,51684,108119,5.343,16.520,185457,60800,124657,6.285,19.172,-25654,-2.652,33.041,6120,6201,36029
1991,5414,17680,17968,108504,110092,3259,18.360,2824,15.909,25582,12341,13241,11.210,23.237,28726,12880,15846,11.699,26.093,-3144,-2.856,46.474,2253,2262,9449
1991,5415,26487,30009,419560,419966,6523,22.180,5324,18.103,87382,35898,51484,8.548,20.807,88032,37028,51004,8.817,20.962,-650,-0.155,41.614,3856,3892,20905
1991,5416,37142,39473,344671,354019,8636,22.002,8193,20.873,87778,37639,50139,10.632,24.795,106697,49014,57683,13.845,30.139,-18919,-5.344,49.589,6523,6552,35835
1991,5417,6773,8512,457976,458787,1190,14.218,905,10.813,58086,15513,42573,3.381,12.661,60163,13928,46235,3.036,13.113,-2077,-0.453,25.322,562,571,5211
1991,5418,30706,34492,415247,413616,6211,18.412,4693,13.912,84314,32346,51968,7.820,20.385,80708,35701,45007,8.631,19.513,3606,0.872,39.026,3726,3757,22556
1991,5419,34726,39372,321094,317366,4649,11.977,3537,9.112,63976,25856,38120,8.147,20.158,56918,20373,36545,6.419,17.935,7058,2.224,35.869,2752,2773,15080
1991,5511,28507,54558,3247624,3250365,6869,12.855,4622,8.650,518219,183333,334886,5.640,15.943,522192,108360,413832,3.334,16.066,-3973,-0.122,31.887,1178,1211,13503
1991,5611,11942,13158,257852,253324,2394,18.513,1941,15.010,66345,31495,34850,12.433,26.190,58406,27263,31143,10.762,23.056,7939,3.134,46.112,1414,1432,15464
1991,5612,460,879,76550,76442,183,21.682,113,13.389,11796,5355,6441,7.005,15.431,11386,4614,6772,6.036,14.895,410,0.536,29.790,54,54,782
1991,5613,19711,27603,1499375,1529743,4766,17.477,4101,15.038,426930,161831,265099,10.579,27.909,486888,161063,325825,10.529,31.828,-59958,-3.919,55.817,2697,2793,108961
1991,5614,22395,25591,333184,323944,4356,17.357,3368,13.420,82179,35939,46240,11.094,25.368,62973,22052,40921,6.807,19.440,19206,5.929,38.879,2624,2650,15653
1991,5615,25341,31613,250196,250425,4390,14.046,3675,11.758,53030,25994,27036,10.380,21.176,53374,22256,31118,8.887,21.313,-344,-0.137,42.352,2738,2852,15556
1991,5616,13256,16452,547069,544340,2506,15.447,2049,12.630,110871,39836,71035,7.318,20.368,105465,34312,71153,6.303,19.375,5406,0.993,38.750,1536,1556,20516
1991,5617,92975,97391,1121644,1133340,18025,18.700,16024,16.624,247947,93396,154551,8.241,21.878,271264,97198,174066,8.576,23.935,-23317,-2.057,43.755,12557,12598,72236
1991,5619,15335,16708,225662,221324,3038,18.648,2205,13.535,57894,25340,32554,11.449,26.158,48884,18405,30479,8.316,22.087,9010,4.071,44.174,1690,1694,14617
1991,5621,6177,6416,76819,76203,787,12.378,671,10.554,14186,5082,9104,6.669,18.616,12993,5066,7927,6.648,17.051,1193,1.566,34.101,529,529,3801
1991,5622,1538,2476,78786,75963,404,16.591,322,13.224,16256,5880,10376,7.741,21.400,10794,5399,5395,7.107,14.210,5462,7.190,28.419,185,185,1938
1991,5629,4820,5184,61012,63705,808,15.629,780,15.087,14144,5058,9086,7.940,22.203,19448,5500,13948,8.634,30.528,-5304,-8.326,44.405,578,578,3577
1991,6111,13754,15056,485825,477974,697,4.666,459,3.073,46131,8208,37923,1.717,9.651,30607,5491,25116,1.149,6.403,15524,3.248,12.807,339,342,4350
1991,6112,505,721,59444,59251,43,5.976,40,5.559,6584,1177,5407,1.986,11.112,6109,1610,4499,2.717,10.310,475,0.802,20.621,21,25,1380
1991,6113,2071,2438,1096405,1077258,110,4.541,79,3.261,86355,12084,74271,1.122,8.016,49350,3247,46103,0.301,4.581,37005,3.435,9.162,40,43,1194
1991,6114,3259,3793,51667,53850,671,17.889,587,15.649,9676,3565,6111,6.620,17.969,14145,5879,8266,10.917,26.268,-4469,-8.299,35.937,395,418,3952
1991,6115,4849,5838,74695,77164,748,12.865,700,12.040,13742,5429,8313,7.036,17.809,18552,6866,11686,8.898,24.042,-4810,-6.233,35.618,432,462,4739
1991,6116,15067,15879,130521,129699,2799,17.960,2211,14.187,29346,13096,16250,10.097,22.626,27796,11479,16317,8.851,21.431,1550,1.195,42.862,1730,1740,9416
1991,6117,2138,2209,22070,22376,527,25.300,275,13.202,4433,2041,2392,9.121,19.811,4942,2573,2369,11.499,22.086,-509,-2.275,39.623,211,211,1733
1991,6211,181953,193373,1425282,1409440,13547,7.009,13335,6.900,215744,68777,146967,4.880,15.307,184054,69790,114264,4.952,13.059,31690,2.248,26.117,10883,11034,53539
1991,6212,100551,103558,544592,542277,5296,5.123,4936,4.775,72883,18375,54508,3.388,13.440,67920,19650,48270,3.624,12.525,4963,0.915,25.050,4061,4115,16733
1991,6213,61838,65103,269343,262645,8326,13.052,5704,8.942,60108,24161,35947,9.199,22.886,46920,19961,26959,7.600,17.864,13188,5.021,35.729,4435,4495,16244
1991,6214,7811,12829,248626,240895,1588,12.694,950,7.594,46704,16219,30485,6.733,19.388,31076,12276,18800,5.096,12.900,15628,6.487,25.801,543,569,6839
1991,6215,5967,7713,123423,120855,1036,13.479,982,12.776,23498,7657,15841,6.336,19.443,18560,8255,10305,6.830,15.357,4938,4.086,30.714,640,660,5232
1991,6216,5318,8453,411549,388917,1365,16.605,900,10.948,105434,32591,72843,8.380,27.110,59180,19483,39697,5.010,15.217,46254,11.893,30.433,563,579,10434
1991,6219,5505,6838,130361,128001,1198,18.234,662,10.076,29727,13727,16000,10.724,23.224,25054,8578,16476,6.702,19.573,4673,3.651,39.147,497,499,5552
1991,6221,3436,4930,3952242,3910630,142,2.863,202,4.073,239766,48692,191074,1.245,6.131,154853,72931,81922,1.865,3.960,84913,2.171,7.920,126,134,51061
1991,6222,581,965,337781,337748,58,6.121,23,2.427,14646,5528,9118,1.637,4.336,14810,2989,11821,0.885,4.385,-164,-0.049,8.673,10,10,1907
1991,6223,232,323,108531,110173,29,9.192,14,4.437,11885,4506,7379,4.090,10.788,14851,5040,9811,4.575,13.480,-2966,-2.692,21.575,5,5,306
1991,6231,8523,14330,1277280,1260027,886,6.214,742,5.204,147832,53876,93956,4.276,11.732,113599,45822,67777,3.637,9.016,34233,2.717,18.031,463,484,29554
1991,6232,6905,12541,268905,258323,1887,15.817,665,5.574,51763,23105,28658,8.944,20.038,30851,10287,20564,3.982,11.943,20912,8.095,23.886,422,427,5855
1991,6233,9573,11568,291085,287449,1676,14.705,1335,11.713,46454,18630,27824,6.481,16.161,39721,18668,21053,6.494,13.818,6733,2.342,27.637,906,927,11751
1991,6239,3743,5050,127272,124717,599,12.151,358,7.262,19231,6015,13216,4.823,15.420,14164,6248,7916,5.010,11.357,5067,4.063,22.714,212,216,2750
1991,6241,19829,27016,387415,380407,3229,12.255,1893,7.185,66416,21386,45030,5.622,17.459,52265,16206,36059,4.260,13.739,14151,3.720,27.478,1207,1219,11321
1991,6242,5521,6541,70255,68558,732,11.419,471,7.347,12349,3566,8783,5.201,18.013,8909,3001,5908,4.377,12.995,3440,5.018,25.990,303,303,1878
1991,6243,4981,7788,288408,285817,928,12.259,492,6.499,44469,10643,33826,3.724,15.559,39485,8408,31077,2.942,13.815,4984,1.744,27.630,236,258,4512
1991,6244,36092,44332,438545,429039,6125,14.112,4268,9.833,84136,37486,46650,8.737,19.610,65066,25382,39684,5.916,15.166,19070,4.445,30.331,3318,3391,19546
1991,7111,5532,5588,77840,78788,1016,18.443,858,15.575,17310,5817,11493,7.383,21.970,19081,5687,13394,7.218,24.218,-1771,-2.248,43.941,636,636,4394
1991,7112,2603,2726,72742,71827,484,18.060,392,14.627,14646,4411,10235,6.141,20.391,12894,3900,8994,5.430,17.951,1752,2.439,35.903,296,300,2790
1991,7113,2324,2391,41414,40827,400,17.007,322,13.690,10828,4670,6158,11.439,26.522,9933,3163,6770,7.747,24.330,895,2.192,48.660,246,246,2295
1991,7114,1538,1568,16486,16704,299,19.549,222,14.515,4335,2073,2262,12.411,25.953,4952,2621,2331,15.691,29.646,-617,-3.694,51.905,188,188,2347
1991,7115,7566,7668,60509,61972,1374,16.786,2409,29.430,16607,5254,11353,8.478,26.798,19919,10304,9615,16.627,32.142,-3312,-5.344,53.596,1883,1883,7439
1991,7121,3105,3388,64110,63402,286,8.541,207,6.182,7678,1999,5679,3.153,12.110,6243,2140,4103,3.375,9.847,1435,2.263,19.693,162,163,1919
1991,7131,1617,2494,84474,82557,283,11.264,320,12.736,11720,2245,9475,2.719,14.196,7950,1991,5959,2.412,9.630,3770,4.567,19.259,235,240,1515
1991,7132,912,989,28991,27553,178,18.427,132,13.665,6246,2854,3392,10.358,22.669,3318,1080,2238,3.920,12.042,2928,10.627,24.084,112,112,863
1991,7139,37941,41026,650879,647155,5133,12.550,4880,11.932,114736,45297,69439,6.999,17.729,107128,39897,67231,6.165,16.554,7608,1.176,33.107,3786,3895,29921
1991,7211,30002,36808,1416281,1433255,4303,11.720,4115,11.208,219794,110521,109273,7.711,15.335,253747,98268,155479,6.856,17.704,-33953,-2.369,30.671,2968,3010,65559
1991,7212,3935,4262,27225,27356,521,12.315,458,10.826,5950,2180,3770,7.969,21.751,6210,1759,4451,6.430,22.701,-260,-0.950,43.501,322,335,1258
1991,7213,3520,3623,18899,19195,249,6.768,361,9.812,2916,904,2012,4.710,15.191,3480,1427,2053,7.434,18.130,-564,-2.938,30.383,263,267,1075
1991,7223,12685,20132,361078,367164,3161,15.769,2989,14.911,71763,32184,39579,8.766,19.545,84337,31033,53304,8.452,22.970,-12574,-3.425,39.090,2245,2262,21435
1991,7224,50570,51514,323930,329696,7416,14.280,8256,15.897,81354,43199,38155,13.103,24.675,92227,46853,45374,14.211,27.973,-10873,-3.298,49.351,6790,6810,39640
1991,7225,225430,313914,5796337,5861758,46573,14.937,42337,13.578,1099009,614488,484521,10.483,18.749,1227728,487795,739933,8.322,20.945,-128719,-2.196,37.498,30265,31506,327089
1991,8111,118558,127680,649151,659527,17511,13.806,15825,12.477,128887,63469,65418,9.623,19.542,149006,58475,90531,8.866,22.593,-20119,-3.051,39.085,12215,12316,45743
1991,8112,12431,15106,133893,135808,2334,15.774,1715,11.591,29277,15710,13567,11.568,21.558,33363,12091,21272,8.903,24.566,-4086,-3.009,43.115,1223,1253,8099
1991,8113,21100,22437,174989,176720,2742,12.283,2516,11.270,30650,10858,19792,6.144,17.344,34342,11781,22561,6.666,19.433,-3692,-2.089,34.688,1893,1899,9115
1991,8114,25545,27511,167740,172967,3946,14.293,4140,14.996,27512,11565,15947,6.686,15.906,38030,13270,24760,7.672,21.987,-10518,-6.081,31.812,3119,3158,9976
1991,8121,77022,88036,464963,470018,11948,13.543,12323,13.968,102182,51916,50266,11.046,21.740,111661,45841,65820,9.753,23.757,-9479,-2.017,43.480,9757,9984,35125
1991,8122,17437,21107,130988,132528,1330,6.236,1770,8.299,21391,7206,14185,5.437,16.141,24316,8226,16090,6.207,18.348,-2925,-2.207,32.282,1300,1331,5527
1991,8123,34119,41285,383593,384330,5109,12.390,5009,12.147,65393,27557,37836,7.170,17.015,67296,26412,40884,6.872,17.510,-1903,-0.495,34.030,3829,3946,20435
1991,8129,14396,23757,168365,175138,3741,15.828,3497,14.796,32624,15451,17173,8.822,18.628,46150,16639,29511,9.501,26.351,-13526,-7.723,37.255,2085,2188,8768
1991,8131,134451,134527,1142712,1126620,6435,4.830,3868,2.903,130354,18204,112150,1.616,11.570,98053,11769,86284,1.045,8.703,32301,2.867,17.407,2189,2189,6842
1991,8132,9920,11637,153459,152525,1387,12.286,691,6.121,24677,8882,15795,5.823,16.179,22644,6671,15973,4.374,14.846,2033,1.333,29.692,498,503,5589
1991,8133,8730,10351,113906,111998,1089,10.735,676,6.664,18575,4530,14045,4.045,16.585,14738,4036,10702,3.604,13.159,3837,3.426,26.318,431,435,2907
1991,8134,31110,32843,310050,306468,2219,6.779,1997,6.101,42422,9154,33268,2.987,13.842,35379,7674,27705,2.504,11.544,7043,2.298,23.088,1509,1509,5807
1991,8139,62101,64551,535386,535705,4688,7.277,4437,6.887,80996,21925,59071,4.093,15.120,81721,25164,56557,4.697,15.255,-725,-0.135,30.239,3254,3261,19595
1992,1131,240,258,2819,2784,35,13.436,40,15.355,943,245,698,8.800,33.872,862,292,570,10.489,30.963,81,2.909,61.925,30,30,232
1992,1132,106,122,1607,1570,18,14.694,19,15.510,479,398,81,25.350,30.510,423,118,305,7.516,26.943,56,3.567,53.885,13,13,101
1992,1133,11082,11162,81511,81436,1623,14.540,1623,14.540,19151,6239,12912,7.661,23.517,19019,6626,12393,8.137,23.355,132,0.162,46.709,1222,1223,4928
1992,1141,1031,1035,9831,10064,182,17.808,156,15.264,2701,1010,1691,10.036,26.838,3206,1204,2002,11.963,31.856,-505,-5.018,53.676,115,116,829
1992,1142,179,185,1439,1431,29,15.550,32,17.158,294,156,138,10.905,20.552,279,152,127,10.626,19.504,15,1.049,39.007,26,26,137
1992,1151,4418,4723,61553,58769,621,13.291,520,11.129,17767,5499,12268,9.357,30.232,12232,3948,8284,6.718,20.814,5535,9.418,41.628,353,358,3043
1992,1152,2306,2344,15546,15414,367,15.846,311,13.428,2848,1101,1747,7.143,18.477,2585,846,1739,5.489,16.770,263,1.706,33.541,240,240,687
1992,1153,943,960,12603,12856,161,16.903,146,15.328,2673,797,1876,6.200,20.793,3179,1067,2112,8.300,24.729,-506,-3.936,41.585,110,110,915
1992,2111,6837,8071,115884,117809,779,9.465,1097,13.329,26314,6217,20097,5.277,22.336,29542,10450,19092,8.870,25.076,-3228,-2.740,44.672,620,623,3274
1992,2121,1600,2128,115670,120848,351,15.872,518,23.423,19152,9469,9683,7.835,15.848,29285,12271,17014,10.154,24.233,-10133,-8.385,31.696,358,363,5592
1992,2122,394,576,47093,46537,92,15.876,99,17.084,5442,2583,2859,5.550,11.694,4408,1367,3041,2.937,9.472,1034,2.222,18.944,57,60,451
1992,2123,3393,5009,96866,98908,309,6.092,435,8.576,11464,2783,8681,2.814,11.591,15477,3923,11554,3.966,15.648,-4013,-4.057,23.181,243,251,1601
1992,2131,7862,8866,144833,158798,1079,11.858,1546,16.990,25680,10776,14904,6.786,16.172,53891,17416,36475,10.967,33.937,-28211,-17.765,32.343,1037,1044,7149
1992,2211,1492,6809,633774,634041,454,6.799,191,2.860,64286,30455,33831,4.803,10.139,64957,19060,45897,3.006,10.245,-671,-0.106,20.278,56,56,378
1992,2212,581,2740,108822,108851,361,13.630,178,6.721,14194,9332,4862,8.573,13.040,14158,2899,11259,2.663,13.007,36,0.033,26.014,50,50,283
1992,2213,3711,4078,30099,29921,312,7.683,278,6.846,3812,1518,2294,5.073,12.740,3404,1525,1879,5.097,11.377,408,1.364,22.753,195,195,756
1992,2361,112850,113253,552451,556537,22211,19.599,22356,19.727,172201,70618,101583,12.689,30.942,180876,77017,103859,13.839,32.500,-8675,-1.559,61.883,15659,15669,56434
1992,2362,35799,36453,593281,617175,4286,11.602,5261,14.242,122979,29716,93263,4.815,19.926,170973,37410,133563,6.061,27.703,-47994,-7.776,39.852,3886,3887,25958
1992,2371,13785,14082,308430,312274,1223,8.614,1454,10.241,61090,8364,52726,2.678,19.563,68338,11658,56680,3.733,21.884,-7248,-2.321,39.126,1025,1026,7736
1992,2372,6542,6730,55547,58908,1153,15.777,2309,31.596,14643,6104,8539,10.362,24.858,21398,11142,10256,18.914,36.325,-6755,-11.467,49.715,1813,1820,8803
1992,2373,9340,9708,224680,226923,847,8.656,1002,10.240,45590,7274,38316,3.205,20.091,50104,10125,39979,4.462,22.080,-4514,-1.989,40.181,726,728,5980
1992,2379,4682,4764,70300,71887,622,12.800,813,16.730,15801,3169,12632,4.408,21.980,18931,5624,13307,7.823,26.335,-3130,-4.354,43.961,602,602,3948
1992,2381,75705,76114,640402,648939,10714,14.030,11213,14.684,171937,48108,123829,7.413,26.495,188425,56437,131988,8.697,29.036,-16488,-2.541,52.990,8133,8137,43202
1992,2382,120612,122574,1155587,1177837,13343,10.820,14841,12.034,221442,52778,168664,4.481,18.801,265747,67761,197986,5.753,22.562,-44305,-3.762,37.601,11027,11034,52001
1992,2383,79901,80375,584505,597569,13298,16.453,14201,17.570,155599,50190,105409,8.399,26.039,181598,60403,121195,10.108,30.389,-25999,-4.351,52.077,10341,10349,45751
1992,2389,40393,40673,324617,332974,5207,12.666,6083,14.797,78538,21523,57015,6.464,23.587,95632,29299,66333,8.799,28.721,-17094,-5.134,47.174,4365,4366,20439
1992,3111,1141,1755,48340,48499,85,4.798,118,6.661,4618,1066,3552,2.198,9.522,4899,1129,3770,2.328,10.101,-281,-0.579,19.044,76,76,472
1992,3112,456,805,64795,64981,50,6.238,43,5.365,4905,1420,3485,2.185,7.548,5467,1482,3985,2.281,8.413,-562,-0.865,15.097,24,24,613
1992,3113,1507,1737,84330,83105,188,10.737,216,12.336,10258,2040,8218,2.455,12.343,7943,2122,5821,2.553,9.558,2315,2.786,19.116,129,132,1154
1992,3114,1233,1669,173405,174708,135,8.147,111,6.699,17267,3818,13449,2.185,9.883,19799,3664,16135,2.097,11.333,-2532,-1.449,19.767,72,72,1683
1992,3115,1314,1891,133302,133806,84,4.397,123,6.438,11085,1379,9706,1.031,8.284,12058,4208,7850,3.145,9.012,-973,-0.727,16.569,77,78,1283
1992,3116,3629,4246,391900,393049,238,5.519,370,8.581,30793,4724,26069,1.202,7.834,32929,10795,22134,2.746,8.378,-2136,-0.543,15.669,268,269,4419
1992,3117,667,774,46305,46273,64,8.137,89,11.316,8487,1678,6809,3.626,18.341,8253,2725,5528,5.889,17.836,234,0.506,35.671,61,61,1792
1992,3118,8927,10152,301173,302336,1194,11.671,1351,13.206,35346,9031,26315,2.987,11.691,38003,15298,22705,5.060,12.570,-2657,-0.879,23.382,875,892,6652
1992,3119,2119,2491,132535,133267,231,9.253,242,9.694,15628,5317,10311,3.990,11.727,17231,7011,10220,5.261,12.930,-1603,-1.203,23.454,177,178,2874
1992,3121,1665,2099,131915,134129,158,7.518,163,7.756,10479,2574,7905,1.919,7.813,15041,3603,11438,2.686,11.214,-4562,-3.401,15.625,124,124,1527
1992,3122,76,110,37022,36258,4,3.620,5,4.525,2666,14,2652,0.039,7.353,1261,41,1220,0.113,3.478,1405,3.875,6.956,3,3,5
1992,3131,355,602,97653,97518,25,4.088,44,7.195,7792,1187,6605,1.217,7.990,7459,2659,4800,2.727,7.649,333,0.341,15.298,30,30,663
1992,3132,1621,1965,242548,242681,152,7.722,159,8.077,18615,3290,15325,1.356,7.671,18947,5897,13050,2.430,7.807,-332,-0.137,15.341,110,110,1010
1992,3133,5273,5961,140525,137501,665,11.258,557,9.429,19722,4609,15113,3.352,14.343,13700,3914,9786,2.847,9.964,6022,4.380,19.927,369,382,2728
1992,3141,3032,3321,121390,121038,264,7.664,511,14.835,14543,1995,12548,1.648,12.015,13890,4894,8996,4.043,11.476,653,0.539,22.951,404,408,3086
1992,3149,3893,4009,112168,111028,458,11.373,494,12.267,19209,4735,14474,4.265,17.301,16806,5899,10907,5.313,15.137,2403,2.164,30.274,418,418,5055
1992,3151,1102,1235,119743,118448,141,11.339,158,12.706,15098,3663,11435,3.093,12.747,12471,4677,7794,3.949,10.529,2627,2.218,21.057,129,135,3332
1992,3152,11121,12297,694184,693148,2051,16.507,2307,18.567,115448,41768,73680,6.026,16.656,113864,55077,58787,7.946,16.427,1584,0.229,32.854,1951,1963,39105
1992,3159,1820,1916,59570,59213,229,11.896,247,12.831,9363,2697,6666,4.555,15.813,8668,2820,5848,4.763,14.639,695,1.174,29.278,206,206,2221
1992,3161,298,330,17206,16570,22,6.538,35,10.401,2382,315,2067,1.901,14.376,1161,320,841,1.931,7.007,1221,7.369,14.014,29,29,200
1992,3162,329,425,62265,63052,30,6.904,49,11.277,5945,735,5210,1.166,9.429,7454,3380,4074,5.361,11.822,-1509,-2.393,18.857,25,26,435
1992,3169,1056,1101,31655,32179,123,11.218,114,10.397,4554,1640,2914,5.097,14.152,5544,1677,3867,5.212,17.229,-990,-3.077,28.305,86,86,696
1992,3211,4317,4826,126700,126945,405,8.304,507,10.396,14127,3460,10667,2.726,11.128,14555,5245,9310,4.132,11.466,-428,-0.337,22.257,382,384,3260
1992,3212,1279,1573,91816,89812,107,6.719,146,9.168,12798,2770,10028,3.084,14.250,8895,3191,5704,3.553,9.904,3903,4.346,19.808,106,106,1307
1992,3219,8931,9581,253463,251462,953,9.852,1138,11.764,39103,7778,31325,3.093,15.550,34901,12137,22764,4.827,13.879,4202,1.671,27.758,849,849,7268
1992,3221,210,521,189431,189740,20,3.817,26,4.962,6972,2275,4697,1.199,3.675,7725,2278,5447,1.201,4.071,-753,-0.397,7.349,14,14,167
1992,3222,3500,5126,395434,397353,238,4.615,300,5.817,29687,7045,22642,1.773,7.471,33261,8227,25034,2.070,8.371,-3574,-0.899,14.942,184,188,3712
1992,3231,42035,44047,812066,818945,3666,8.268,4256,9.598,89295,25928,63367,3.166,10.904,103683,33704,69979,4.116,12.661,-14388,-1.757,21.807,3468,3476,21955
1992,3241,1106,2005,112735,112363,106,5.182,187,9.142,9226,2682,6544,2.387,8.211,8426,3955,4471,3.520,7.499,800,0.712,14.998,78,78,615
1992,3251,1113,2275,231750,231372,103,4.464,168,7.281,14259,2934,11325,1.268,6.163,13678,4639,9039,2.005,5.912,581,0.251,11.823,72,73,1098
1992,3252,325,605,131810,132391,33,5.450,34,5.615,6360,1616,4744,1.221,4.804,7431,1394,6037,1.053,5.613,-1071,-0.809,9.608,16,16,91
1992,3253,612,835,41483,41435,46,5.473,57,6.782,3714,1179,2535,2.845,8.964,3527,1018,2509,2.457,8.512,187,0.451,17.024,38,38,301
1992,3254,1059,1347,188728,184644,95,7.024,106,7.837,23596,4667,18929,2.528,12.779,15188,3630,11558,1.966,8.226,8408,4.554,16.451,66,66,1875
1992,3255,1599,2069,72266,73326,117,5.591,164,7.838,6201,1381,4820,1.883,8.457,8350,2590,5760,3.532,11.388,-2149,-2.931,16.914,95,100,742
1992,3256,1994,2235,120843,120959,152,6.718,207,9.149,13419,5061,8358,4.184,11.094,13720,6035,7685,4.989,11.343,-301,-0.249,22.188,154,154,1487
1992,3259,2215,2892,130722,132245,211,7.287,218,7.529,10059,2108,7951,1.594,7.606,13004,3360,9644,2.541,9.833,-2945,-2.227,15.213,127,127,1184
1992,3261,10142,12206,668400,659075,871,7.126,905,7.404,86230,16989,69241,2.578,13.083,67064,19017,48047,2.885,10.175,19166,2.908,20.351,646,650,8896
1992,3262,2247,2734,184490,184781,197,7.232,177,6.498,15645,3976,11669,2.152,8.467,16448,4511,11937,2.441,8.901,-803,-0.435,16.934,102,107,1207
1992,3271,1407,1701,74540,74196,147,8.566,177,10.315,8088,2311,5777,3.115,10.901,7324,1641,5683,2.212,9.871,764,1.030,19.742,130,130,936
1992,3272,1689,1957,132399,131736,181,9.178,211,10.700,11588,2007,9581,1.524,8.796,10036,3036,7000,2.305,7.618,1552,1.178,15.237,155,155,1115
1992,3273,6047,8828,163793,167084,452,5.058,669,7.486,22242,4892,17350,2.928,13.312,28742,8446,20296,5.055,17.202,-6500,-3.890,26.624,360,366,3393
1992,3274,251,352,16903,17117,36,10.213,37,10.496,914,266,648,1.554,5.340,1350,495,855,2.892,7.887,-436,-2.547,10.680,23,23,157
1992,3279,1904,2203,66934,68720,182,8.263,181,8.218,8506,3757,4749,5.467,12.378,12039,5406,6633,7.867,17.519,-3533,-5.141,24.756,130,131,1424
1992,3311,240,318,169388,172713,17,5.152,41,12.424,4992,499,4493,0.289,2.890,11600,2468,9132,1.429,6.716,-6608,-3.826,5.781,29,29,589
1992,3312,515,711,64491,64800,30,4.155,52,7.202,4873,771,4102,1.190,7.520,5431,1619,3812,2.498,8.381,-558,-0.861,15.040,27,27,396
1992,3313,327,471,80235,81466,29,6.164,28,5.951,4936,1176,3760,1.444,6.059,7284,2957,4327,3.630,8.941,-2348,-2.882,12.118,13,13,129
1992,3314,798,964,77114,78428,72,7.430,82,8.462,5278,1818,3460,2.318,6.730,8055,1924,6131,2.453,10.271,-2777,-3.541,13.459,54,54,666
1992,3315,2400,2655,191736,195507,113,4.171,222,8.193,14527,2060,12467,1.054,7.430,21960,5359,16601,2.741,11.232,-7433,-3.802,14.861,161,162,1885
1992,3321,3167,3360,125545,127283,198,5.842,257,7.582,12558,2653,9905,2.084,9.866,15816,4583,11233,3.601,12.426,-3258,-2.560,19.732,187,188,2653
1992,3322,1337,1465,75294,75585,78,5.303,90,6.118,6031,401,5630,0.531,7.979,6591,1451,5140,1.920,8.720,-560,-0.741,15.958,65,65,442
1992,3323,10277,11041,309860,314156,651,5.795,1037,9.231,39404,11107,28297,3.536,12.543,47806,13091,34715,4.167,15.217,-8402,-2.674,25.086,766,774,7524
1992,3324,1576,1898,107133,109071,99,5.183,123,6.440,8907,2081,6826,1.908,8.166,12855,1958,10897,1.795,11.786,-3948,-3.620,16.332,80,80,803
1992,3325,922,1010,65322,64839,68,6.723,71,7.019,5548,649,4899,1.001,8.557,4662,693,3969,1.069,7.190,886,1.366,14.380,49,49,264
1992,3326,1491,1663,65638,64630,94,5.584,135,8.019,7801,1340,6461,2.073,12.070,5744,1428,4316,2.210,8.888,2057,3.183,17.775,112,112,1022
1992,3327,21716,22041,324718,333181,1800,8.141,1940,8.774,35543,8365,27178,2.511,10.668,52497,15568,36929,4.673,15.756,-16954,-5.089,21.336,1426,1432,7915
1992,3328,5321,5710,126879,127818,339,5.877,455,7.888,16080,3421,12659,2.676,12.580,17857,4955,12902,3.877,13.971,-1777,-1.390,25.161,344,348,3616
1992,3329,5728,6235,313101,317701,452,7.192,552,8.783,24999,5844,19155,1.839,7.869,34176,7716,26460,2.429,10.757,-9177,-2.889,15.737,413,414,3414
1992,3331,2741,2993,191069,197219,198,6.556,252,8.344,14560,2793,11767,1.416,7.383,26477,4506,21971,2.285,13.425,-11917,-6.043,14.765,164,166,1552
1992,3332,4031,4280,154368,158389,247,5.718,326,7.547,13577,3225,10352,2.036,8.572,21675,4468,17207,2.821,13.685,-8098,-5.113,17.144,238,240,2237
1992,3333,2431,2554,138846,140978,190,7.422,202,7.891,13243,2213,11030,1.570,9.394,17780,5735,12045,4.068,12.612,-4537,-3.218,18.787,127,127,969
1992,3334,1537,1781,147127,144566,113,6.308,134,7.480,16911,2642,14269,1.828,11.698,11674,3685,7989,2.549,8.075,5237,3.623,16.150,94,95,1208
1992,3335,9255,9585,204295,207194,504,5.220,646,6.690,20138,3912,16226,1.888,9.719,26055,6540,19515,3.156,12.575,-5917,-2.856,19.439,468,472,3736
1992,3336,771,912,119530,120767,56,6.174,46,5.072,6355,1020,5335,0.845,5.262,8835,2376,6459,1.967,7.316,-2480,-2.054,10.524,27,27,449
1992,3339,5345,5956,298050,305123,426,7.142,443,7.427,24576,7338,17238,2.405,8.054,38489,9186,29303,3.011,12.614,-13913,-4.560,16.109,317,317,2948
1992,3341,1656,1763,197268,212747,244,13.872,236,13.417,22229,5118,17111,2.406,10.449,53526,20212,33314,9.500,25.159,-31297,-14.711,20.897,171,172,4658
1992,3342,1753,1947,219216,223610,165,8.436,183,9.356,20258,3865,16393,1.728,9.060,29108,6306,22802,2.820,13.017,-8850,-3.958,18.119,125,125,1913
1992,3343,387,418,31872,32156,45,10.613,57,13.443,3200,460,2740,1.431,9.951,3704,1078,2626,3.352,11.519,-504,-1.567,19.903,46,46,584
1992,3344,4950,5496,467752,479503,522,9.418,615,11.096,46178,14890,31288,3.105,9.630,69636,25541,44095,5.327,14.523,-23458,-4.892,19.261,430,431,7000
1992,3345,4545,5160,571809,595687,365,7.042,412,7.948,29633,6134,23499,1.030,4.975,77161,15114,62047,2.537,12.953,-47528,-7.979,9.949,261,261,3136
1992,3346,700,747,40513,42169,111,14.810,116,15.477,4344,777,3567,1.843,10.302,7596,4307,3289,10.214,18.013,-3252,-7.712,20.603,76,77,1887
1992,3351,1155,1270,70020,70809,98,7.677,111,8.696,5563,1405,4158,1.984,7.856,7103,1585,5518,2.238,10.031,-1540,-2.175,15.713,88,88,923
1992,3352,324,400,99119,97498,36,8.834,51,12.515,9798,1323,8475,1.357,10.049,6384,834,5550,0.855,6.548,3414,3.502,13.096,34,34,289
1992,3353,2200,2620,203058,205752,160,6.082,181,6.881,15915,4529,11386,2.201,7.735,21569,6347,15222,3.085,10.483,-5654,-2.748,15.470,106,106,1314
1992,3359,1872,2251,183163,186994,137,5.980,217,9.472,15726,4550,11176,2.433,8.410,23379,6871,16508,3.674,12.503,-7653,-4.093,16.820,130,132,1411
1992,3361,242,298,213023,204796,35,11.551,45,14.851,26702,927,25775,0.453,13.038,10042,1138,8904,0.556,4.903,16660,8.135,9.807,39,39,414
1992,3362,1721,1901,97081,94795,152,7.839,228,11.759,16703,2902,13801,3.061,17.620,12139,5277,6862,5.567,12.806,4564,4.815,25.611,171,174,2454
1992,3363,4201,5086,633614,619375,329,6.443,370,7.246,73008,12542,60466,2.025,11.787,44899,14244,30655,2.300,7.249,28109,4.538,14.498,255,256,3222
1992,3364,1468,1805,639320,658066,118,6.498,140,7.709,55515,37056,18459,5.631,8.436,92888,37850,55038,5.752,14.115,-37373,-5.679,16.872,99,99,837
1992,3365,165,217,23838,28320,8,3.579,21,9.396,2232,134,2098,0.473,7.881,10517,7498,3019,26.476,37.137,-8285,-29.255,15.763,15,15,521
1992,3366,1333,1420,148866,150417,131,9.219,133,9.360,13321,1333,11988,0.886,8.856,16518,3189,13329,2.120,10.981,-3197,-2.125,17.712,90,90,1195
1992,3369,470,486,30971,31748,57,11.813,50,10.363,3109,592,2517,1.865,9.793,4725,472,4253,1.487,14.883,-1616,-5.090,19.585,40,40,394
1992,3371,13113,13743,348807,350427,1573,11.312,1897,13.643,45326,11596,33730,3.309,12.935,48727,18020,30707,5.142,13.905,-3401,-0.971,25.869,1421,1430,10719
1992,3372,3055,3247,142788,145536,260,7.882,363,11.005,15936,4076,11860,2.801,10.950,21374,5890,15484,4.047,14.686,-5438,-3.737,21.900,281,283,3681
1992,3379,1078,1213,39084,39217,73,5.899,122,9.859,4334,633,3701,1.614,11.051,4636,1657,2979,4.225,11.822,-302,-0.770,22.103,96,96,1000
1992,3391,10580,11142,265771,263877,954,8.586,893,8.037,32056,7088,24968,2.686,12.148,28294,9992,18302,3.787,10.722,3762,1.426,21.445,655,656,4287
1992,3399,15074,15589,387752,385878,1635,10.382,1955,12.413,55361,14490,40871,3.755,14.347,51614,17409,34205,4.512,13.376,3747,0.971,26.751,1566,1567,10913
1992,4231,18771,22604,255722,257891,2163,9.501,2486,10.920,37572,12331,25241,4.781,14.569,41747,14812,26935,5.744,16.188,-4175,-1.619,29.138,1564,1602,7958
1992,4232,8495,9623,112707,113799,1163,12.082,1169,12.144,19263,5754,13509,5.056,16.927,21572,7674,13898,6.743,18.956,-2309,-2.029,33.854,784,809,4875
1992,4233,7567,9949,117388,119074,1015,10.111,1195,11.904,17320,5114,12206,4.295,14.546,20610,7633,12977,6.410,17.309,-3290,-2.763,29.091,766,790,4578
1992,4234,25895,34396,591562,598715,4555,13.331,4102,12.005,101832,35812,66020,5.981,17.008,115928,43474,72454,7.261,19.363,-14096,-2.354,34.017,2092,2255,13763
1992,4235,6858,9253,129631,132341,696,7.453,868,9.294,15511,4496,11015,3.397,11.721,20829,6578,14251,4.971,15.739,-5318,-4.018,23.441,474,493,2717
1992,4236,17542,25034,315220,321950,2577,10.271,2689,10.717,53501,17936,35565,5.571,16.618,66622,22423,44199,6.965,20.693,-13121,-4.075,33.236,1402,1458,8721
1992,4237,10864,15067,160998,162171,1254,8.342,1186,7.889,21512,6722,14790,4.145,13.265,23705,7261,16444,4.477,14.617,-2193,-1.352,26.530,707,757,4053
1992,4238,47282,61382,635861,644328,5054,8.162,6129,9.898,82520,24874,57646,3.860,12.807,99783,33002,66781,5.122,15.486,-17263,-2.679,25.614,3439,3756,17499
1992,4239,25418,27456,282264,280855,3754,13.748,3455,12.653,53026,16720,36306,5.953,18.880,49963,18162,31801,6.467,17.790,3063,1.091,35.579,2541,2567,11745
1992,4241,9601,12594,194486,190807,1053,8.313,1198,9.458,39591,6077,33514,3.185,20.749,32559,15934,16625,8.351,17.064,7032,3.685,34.128,661,688,3499
1992,4242,3498,4641,133592,131228,728,15.930,586,12.823,30993,12593,18400,9.596,23.618,26208,12886,13322,9.820,19.971,4785,3.646,39.943,333,339,2515
1992,4243,9621,10372,130417,126385,1789,17.393,1617,15.720,32161,11429,20732,9.043,25.447,24350,10482,13868,8.294,19.267,7811,6.180,38.533,1247,1263,6400
1992,4244,27566,33820,693787,694719,3673,10.843,3779,11.156,105362,29277,76085,4.214,15.166,106430,37922,68508,5.459,15.320,-1068,-0.154,30.332,2516,2541,16060
1992,4245,6284,9153,80307,80793,533,5.687,972,10.371,12802,3291,9511,4.073,15.846,13753,5150,8603,6.374,17.023,-951,-1.177,31.691,496,525,2958
1992,4246,8447,12362,139460,139458,1271,10.346,1116,9.085,25252,9527,15725,6.831,18.107,25290,10188,15102,7.305,18.134,-38,-0.027,36.214,532,550,2680
1992,4247,8776,11865,132765,135381,774,6.396,1248,10.312,21697,6379,15318,4.712,16.027,26627,8983,17644,6.635,19.668,-4930,-3.642,32.053,573,585,3699
1992,4248,3441,4446,133926,133158,271,6.030,368,8.188,13626,3649,9977,2.740,10.233,12136,4037,8099,3.032,9.114,1490,1.119,18.228,216,217,1844
1992,4249,20321,24755,297700,294710,2999,12.057,3236,13.010,56488,22340,34148,7.580,19.167,51299,21898,29401,7.430,17.407,5189,1.761,34.813,2243,2275,10862
1992,4251,31274,33535,287416,290943,3771,11.299,3451,10.340,47766,16348,31418,5.619,16.418,54972,22325,32647,7.673,18.894,-7206,-2.477,32.835,2148,2169,10993
1992,4411,37365,39490,906863,910151,4138,10.414,4629,11.650,115335,42329,73006,4.651,12.672,121835,53880,67955,5.920,13.386,-6500,-0.714,25.344,3563,3604,42560
1992,4412,10351,11003,75431,75537,1026,9.250,1204,10.855,14340,4288,10052,5.677,18.984,14465,5908,8557,7.821,19.150,-125,-0.165,37.968,883,905,4423
1992,4413,39617,58690,448005,448500,4421,7.475,5323,9.001,69263,23571,45692,5.256,15.443,70048,25488,44560,5.683,15.618,-785,-0.175,30.887,2973,3200,14240
1992,4421,21166,27592,227055,229046,2890,10.365,3469,12.442,39196,14835,24361,6.477,17.113,43307,16877,26430,7.368,18.908,-4111,-1.795,34.226,2153,2295,9888
1992,4422,23744,31166,195182,195747,3645,11.733,3444,11.086,37144,15610,21534,7.975,18.976,38431,12224,26207,6.245,19.633,-1287,-0.657,37.951,2114,2257,7738
1992,4431,29255,45222,333851,331983,5295,11.648,5769,12.691,72002,32806,39196,9.882,21.688,68362,29001,39361,8.736,20.592,3640,1.096,41.184,3173,3441,15057
1992,4441,53574,72019,803495,802677,4851,6.673,6212,8.545,118048,39579,78469,4.931,14.707,117931,42224,75707,5.260,14.692,117,0.015,29.384,3913,4039,20640
1992,4442,17246,21155,166113,167193,1664,7.816,1935,9.089,27877,7686,20191,4.597,16.674,29918,11131,18787,6.658,17.894,-2041,-1.221,33.347,1232,1254,5083
1992,4451,61299,90885,2411307,2423728,9395,10.256,10837,11.830,278608,123845,154763,5.110,11.495,303418,95444,207974,3.938,12.519,-24810,-1.024,22.990,6816,7060,43528
1992,4452,18002,21591,133733,135521,3065,14.027,3584,16.402,29787,13655,16132,10.076,21.980,33243,15685,17558,11.574,24.530,-3456,-2.550,43.959,2305,2389,10158
1992,4453,24499,28832,133637,137109,2644,9.014,3644,12.423,22790,7832,14958,5.712,16.622,29601,13153,16448,9.593,21.589,-6811,-4.968,33.244,2491,2556,8345
1992,4461,46761,77392,755314,757015,7292,9.400,7665,9.880,116165,51869,64296,6.852,15.345,119203,48105,71098,6.355,15.746,-3038,-0.401,30.690,4343,4504,22081
1992,4471,74999,127511,897279,917027,10901,8.441,14153,10.960,153307,61105,92202,6.663,16.718,192243,76218,116025,8.311,20.964,-38936,-4.246,33.436,8098,8576,43362
1992,4481,47866,101499,980941,988094,11548,11.228,14247,13.852,177680,84327,93353,8.534,17.982,191970,75207,116763,7.611,19.428,-14290,-1.446,35.964,7233,8186,32286
1992,4482,8755,34426,182856,188753,2911,8.314,4086,11.670,34136,15615,18521,8.273,18.085,45488,17569,27919,9.308,24.099,-11352,-6.014,36.170,1273,1536,5720
1992,4483,18922,28254,162388,164244,3135,11.020,3522,12.381,30272,13363,16909,8.136,18.431,34036,14163,19873,8.623,20.723,-3764,-2.292,36.862,1932,2122,7281
1992,4511,31517,42840,327107,324945,5337,12.377,5897,13.676,65565,27621,37944,8.500,20.177,61184,25884,35300,7.966,18.829,4381,1.348,37.658,3859,4108,13985
1992,4512,8728,14436,105883,104801,1709,11.935,1475,10.301,21957,7876,14081,7.515,20.951,19663,6005,13658,5.730,18.762,2294,2.189,37.524,983,1007,3838
1992,4522,145,6628,1055240,1072205,199,2.981,295,4.419,78624,28397,50227,2.648,7.333,112794,20908,91886,1.950,10.520,-34170,-3.187,14.666,9,10,439
1992,4523,10372,27340,1012422,1013389,2857,10.374,3258,11.830,125189,67690,57499,6.680,12.353,129327,51516,77811,5.084,12.762,-4138,-0.408,24.707,1444,1533,10511
1992,4531,23433,24819,122642,126341,2687,10.645,3531,13.989,21297,8165,13132,6.463,16.857,28703,10917,17786,8.641,22.719,-7406,-5.862,33.714,2736,2774,8282
1992,4532,30501,39193,257874,259916,5398,13.714,5736,14.572,57235,24901,32334,9.580,22.021,60978,29911,31067,11.508,23.461,-3743,-1.440,44.041,3854,4030,14139
1992,4533,10926,13931,75898,72070,3141,23.540,1966,14.734,24359,14916,9443,20.697,33.799,16127,7588,8539,10.529,22.377,8232,11.422,44.754,1244,1254,3451
1992,4539,23867,28061,142177,141668,4561,16.184,4805,17.049,35850,16244,19606,11.466,25.306,34650,16011,18639,11.302,24.459,1200,0.847,48.917,3313,3426,11526
1992,4541,6141,6982,133289,129991,851,11.791,1322,18.317,28905,7609,21296,5.853,22.236,22072,7142,14930,5.494,16.980,6833,5.257,33.959,629,638,3097
1992,4542,4253,5322,69512,67719,756,14.255,719,13.557,13316,7356,5960,10.863,19.664,9829,3424,6405,5.056,14.514,3487,5.149,29.029,468,470,2123
1992,4543,17336,23771,215031,219936,2276,9.582,2238,9.422,39136,13653,25483,6.208,17.794,48441,14698,33743,6.683,22.025,-9305,-4.231,35.589,1433,1465,8413
1992,4811,507,2808,437729,456783,221,7.769,294,10.336,32314,3635,28679,0.796,7.074,72252,7420,64832,1.624,15.818,-39938,-8.743,14.149,72,74,1649
1992,4812,1224,1403,20709,19977,216,15.601,179,12.929,5087,1240,3847,6.207,25.465,3665,802,2863,4.015,18.347,1422,7.118,36.693,108,109,422
1992,4831,391,698,39743,39935,83,12.046,65,9.434,7069,1910,5159,4.783,17.701,7408,762,6646,1.908,18.550,-339,-0.849,35.403,36,36,520
1992,4832,284,314,12363,12344,36,11.250,48,15.000,1985,542,1443,4.391,16.081,1914,1132,782,9.170,15.506,71,0.575,31.011,31,31,471
1992,4841,24478,31531,655383,644515,4753,15.116,4580,14.565,118172,38262,79910,5.937,18.335,95952,37186,58766,5.770,14.887,22220,3.448,29.775,3373,3416,21703
1992,4842,42734,46235,451550,454020,7019,15.241,6653,14.447,90424,29694,60730,6.540,19.916,94966,37899,57067,8.347,20.917,-4542,-1.000,39.833,4995,5034,24582
1992,4851,394,465,23350,23101,83,18.424,54,11.987,4070,2791,1279,12.082,17.618,3484,1749,1735,7.571,15.082,586,2.537,30.163,40,40,628
1992,4852,307,570,19513,18824,129,23.779,74,13.641,4420,987,3433,5.243,23.481,2967,737,2230,3.915,15.762,1453,7.719,31.524,26,26,437
1992,4853,4950,5057,48986,49750,820,16.201,829,16.379,10555,4729,5826,9.506,21.216,12129,4917,7212,9.884,24.380,-1574,-3.164,42.433,681,683,3749
1992,4854,3235,4129,129847,128103,383,9.277,382,9.253,23880,8000,15880,6.245,18.641,20308,6355,13953,4.961,15.853,3572,2.788,31.706,257,257,2773
1992,4855,1089,1203,24400,23893,155,13.169,103,8.751,5090,1518,3572,6.353,21.304,4061,1161,2900,4.859,16.997,1029,4.307,33.994,74,75,596
1992,4859,1670,1789,33665,32783,328,18.620,273,15.498,8493,2748,5745,8.383,25.907,6844,3747,3097,11.430,20.877,1649,5.030,41.754,207,208,2845
1992,4861,44,382,9315,9532,59,15.547,54,14.229,1093,612,481,6.420,11.467,1563,537,1026,5.634,16.397,-470,-4.931,22.933,D,D,D
1992,4862,150,1303,42603,43895,179,14.012,128,10.020,7147,4853,2294,11.056,16.282,9565,3728,5837,8.493,21.791,-2418,-5.509,32.564,18,18,119
1992,4869,57,386,6409,6456,60,16.484,16,4.396,986,476,510,7.373,15.273,1159,96,1063,1.487,17.952,-173,-2.680,30.545,5,5,35
1992,4871,303,329,6432,6458,60,18.605,47,14.574,1334,255,1079,3.949,20.658,1381,887,494,13.736,21.386,-47,-0.728,41.316,35,35,508
1992,4872,1119,1155,11363,11027,226,20.434,128,11.573,2903,1294,1609,11.735,26.326,2254,872,1382,7.908,20.441,649,5.886,40.881,100,100,727
1992,4879,128,136,1258,1259,23,17.228,18,13.483,293,57,236,4.529,23.282,310,41,269,3.258,24.632,-17,-1.351,46.563,16,16,37
1992,4881,2271,2913,77255,78105,439,15.099,428,14.721,15320,5285,10035,6.767,19.615,17124,5822,11302,7.454,21.924,-1804,-2.310,39.229,260,261,2253
1992,4882,430,677,16368,16518,108,16.314,78,11.782,2965,1002,1963,6.066,17.950,3268,1609,1659,9.741,19.784,-303,-1.834,35.900,47,47,1088
1992,4883,2027,2587,88112,86352,298,11.490,311,11.992,19532,6020,13512,6.972,22.619,16141,4397,11744,5.092,18.692,3391,3.927,37.384,196,201,1880
1992,4884,4190,4410,29650,30659,751,17.288,619,14.250,6628,3338,3290,10.888,21.619,8675,3822,4853,12.466,28.296,-2047,-6.677,43.238,424,436,2863
1992,4885,8379,11156,105401,105653,1801,16.613,1171,10.802,21148,8027,13121,7.598,20.016,21650,9455,12195,8.949,20.492,-502,-0.475,40.033,794,816,5183
1992,4889,775,824,8547,8441,148,18.465,103,12.851,2063,654,1409,7.748,24.442,1846,598,1248,7.085,21.871,217,2.571,43.741,83,83,518
1992,4921,1488,4362,355439,361622,623,14.558,458,10.702,28146,8123,20023,2.246,7.783,42095,9887,32208,2.734,11.641,-13949,-3.857,15.567,243,244,2322
1992,4922,3374,3622,60175,59194,650,18.068,601,16.706,12671,5195,7476,8.776,21.406,10668,3763,6905,6.357,18.022,2003,3.384,36.044,490,491,2797
1992,4931,6152,10331,446642,441789,958,9.303,891,8.653,81192,34167,47025,7.734,18.378,71555,16381,55174,3.708,16.197,9637,2.181,32.393,310,320,3206
1992,5111,14500,17162,672085,730675,1806,10.522,1811,10.551,57826,17579,40247,2.406,7.914,177690,18031,159659,2.468,24.319,-119864,-16.405,15.828,1392,1396,9780
1992,5112,5192,6270,125099,121608,1076,17.734,671,11.059,31023,10556,20467,8.680,25.511,24294,11956,12338,9.832,19.977,6729,5.533,39.955,430,432,4589
1992,5121,9575,14105,212232,226301,2136,15.156,2113,14.993,44894,20651,24243,9.125,19.838,72388,43882,28506,19.391,31.988,-27494,-12.149,39.676,1112,1230,9703
1992,5122,1733,1771,14736,15173,348,19.600,357,20.107,3626,1783,1843,11.751,23.898,4479,1718,2761,11.323,29.520,-853,-5.622,47.795,290,290,1326
1992,5151,5901,7843,222811,226581,829,10.604,779,9.964,28661,12607,16054,5.564,12.649,35874,12830,23044,5.662,15.833,-7213,-3.183,25.299,516,519,5445
1992,5152,202,331,12706,12139,53,16.693,26,8.189,2971,1270,1701,10.462,24.475,1794,455,1339,3.748,14.779,1177,9.696,29.558,11,11,49
1992,5173,5163,27690,1034267,1044794,3234,11.777,2775,10.105,149630,59212,90418,5.667,14.321,169646,67780,101866,6.487,16.237,-20016,-1.916,28.643,578,594,12330
1992,5174,173,264,5773,6862,67,24.815,79,29.259,1176,748,428,10.901,17.138,3466,2814,652,41.008,50.510,-2290,-33.372,34.276,13,13,93
1992,5179,1108,1956,38232,38999,426,21.515,474,23.939,8077,3720,4357,9.539,20.711,9354,5425,3929,13.911,23.986,-1277,-3.274,41.422,185,186,1266
1992,5182,5059,7325,268089,274863,1057,14.330,1159,15.713,55806,20528,35278,7.468,20.303,68368,29776,38592,10.833,24.873,-12562,-4.570,40.606,530,540,17425
1992,5191,2412,2829,38290,37422,242,8.548,246,8.690,6330,1260,5070,3.367,16.915,4579,1530,3049,4.089,12.236,1751,4.679,24.473,180,181,1079
1992,5211,14,44,24095,24187,D,D,10,20.619,624,D,623,D,2.580,803,290,513,1.199,3.320,-179,-0.740,5.160,3,3,10
1992,5221,23067,101346,2041832,2088206,6261,6.208,5280,5.235,304018,87707,216311,4.200,14.559,398842,87200,311642,4.176,19.100,-94824,-4.541,29.118,781,1053,21946
1992,5222,12704,33855,438043,430735,4257,12.636,3928,11.659,97846,34761,63085,8.070,22.716,83549,36590,46959,8.495,19.397,14297,3.319,38.794,1588,1594,9831
1992,5223,7694,9863,81993,77554,2185,23.324,1195,12.756,25896,11405,14491,14.706,33.391,16756,7701,9055,9.930,21.606,9140,11.785,43.211,775,777,3645
1992,5231,6368,18859,320182,316352,2892,15.834,1702,9.319,54504,17873,36631,5.650,17.229,46251,19063,27188,6.026,14.620,8253,2.609,29.240,814,834,5906
1992,5232,21,35,6418,6434,D,D,12,29.630,789,D,782,D,12.263,813,139,674,2.160,12.636,-24,-0.373,24.526,7,7,27
1992,5239,17665,19116,185282,177854,3899,21.206,2439,13.266,46159,18428,27731,10.361,25.953,31318,13875,17443,7.801,17.609,14841,8.345,35.218,1701,1710,7290
1992,5241,3684,37326,1540711,1541476,3466,9.179,4338,11.488,205928,75920,130008,4.925,13.359,206205,66524,139681,4.316,13.377,-277,-0.018,26.718,592,660,8467
1992,5242,105231,115858,700467,714545,11805,10.210,11337,9.805,135976,44620,91356,6.245,19.030,164547,82640,81907,11.565,23.028,-28571,-3.998,38.059,7778,7824,53695
1992,5259,680,711,18012,17405,117,16.318,129,17.992,3003,605,2398,3.476,17.254,1738,817,921,4.694,9.986,1265,7.268,19.972,81,81,409
1992,5311,89175,97050,508045,512360,10943,11.268,11078,11.407,101873,44599,57274,8.705,19.883,109840,46902,62938,9.154,21.438,-7967,-1.555,39.766,8612,8664,32646
1992,5312,38149,42634,207291,207248,6881,16.258,6260,14.791,52471,22383,30088,10.800,25.318,52677,20882,31795,10.076,25.417,-206,-0.099,50.636,4232,4283,13601
1992,5313,29972,32978,356545,352670,4981,15.339,3972,12.232,80867,31963,48904,9.063,22.930,73029,24639,48390,6.986,20.707,7838,2.222,41.415,2730,2785,14411
1992,5321,4823,9620,128553,130096,1063,10.920,1291,13.263,21311,8416,12895,6.469,16.381,24226,8711,15515,6.696,18.622,-2915,-2.241,32.762,652,682,4188
1992,5322,21340,29803,202898,208488,5029,17.063,4369,14.824,51548,27227,24321,13.059,24.725,61937,19749,42188,9.472,29.708,-10389,-4.983,49.449,3031,3285,14146
1992,5323,3852,5907,39141,40417,530,8.855,687,11.478,6714,2376,4338,5.879,16.612,9065,3073,5992,7.603,22.429,-2351,-5.817,33.224,383,441,2032
1992,5324,7120,9623,106175,114119,1083,11.083,1381,14.132,21720,6352,15368,5.566,19.033,36812,23960,12852,20.996,32.258,-15092,-13.225,38.066,849,913,13144
1992,5331,1322,1467,21607,20664,265,18.512,194,13.552,5501,1477,4024,7.148,26.621,3759,1336,2423,6.465,18.191,1742,8.430,36.382,124,124,1001
1992,5411,139700,145970,987378,979797,14303,9.887,11695,8.084,138872,45262,93610,4.620,14.174,123674,38255,85419,3.904,12.622,15198,1.551,25.245,8408,8472,26966
1992,5412,75298,79476,697887,699384,9902,12.642,7600,9.703,131418,45894,85524,6.562,18.791,132587,72173,60414,10.320,18.958,-1169,-0.167,37.581,5335,5385,58961
1992,5413,63898,72211,946967,950229,8979,12.486,8383,11.657,159411,49835,109576,5.245,16.776,165478,47263,118215,4.974,17.415,-6067,-0.638,33.552,5515,5584,23804
1992,5414,17731,17978,102301,103132,3344,18.687,3177,17.754,26630,13549,13081,13.138,25.821,28630,13582,15048,13.170,27.761,-2000,-1.939,51.643,2417,2422,9976
1992,5415,26838,30876,442261,429048,6850,22.783,5231,17.398,104751,40860,63891,9.523,24.415,78427,31211,47216,7.274,18.279,26324,6.135,36.559,3546,3584,15556
1992,5416,39826,42323,338254,332506,9363,22.714,7161,17.372,94912,37187,57725,11.184,28.544,83534,38096,45438,11.457,25.123,11378,3.422,50.245,5232,5262,28040
1992,5417,6657,8654,459377,454620,1365,16.180,930,11.024,68190,23023,45167,5.064,14.999,58345,15900,42445,3.497,12.834,9845,2.166,25.668,531,538,3785
1992,5418,28211,32064,360737,377098,4662,14.450,5059,15.681,70946,26717,44229,7.085,18.814,101852,61003,40849,16.177,27.009,-30906,-8.196,37.627,3872,3897,50387
1992,5419,35509,40159,330427,326646,4135,10.372,3552,8.910,65953,21720,44233,6.649,20.191,57553,21126,36427,6.468,17.619,8400,2.572,35.239,2288,2302,9779
1992,5511,28396,53457,3213472,3231654,4880,9.028,6076,11.240,572092,154983,417109,4.796,17.703,609150,173008,436142,5.354,18.849,-37058,-1.147,35.406,887,922,14297
1992,5611,12774,14146,273407,263338,3037,22.366,1902,14.007,80154,39242,40912,14.902,30.438,59153,25703,33450,9.760,22.463,21001,7.975,44.926,1383,1399,15991
1992,5612,476,913,76717,76030,113,12.591,82,9.136,9671,3343,6328,4.397,12.720,8252,2915,5337,3.834,10.854,1419,1.866,21.707,32,37,364
1992,5613,19232,27424,1663827,1593834,4485,16.380,4398,16.063,544054,188438,355616,11.823,34.135,400890,143695,257195,9.016,25.153,143164,8.982,50.305,2891,2980,84673
1992,5614,22311,25572,346517,341041,4062,16.016,3642,14.360,80727,33504,47223,9.824,23.671,69394,22751,46643,6.671,20.348,11333,3.323,40.695,2724,2743,14571
1992,5615,24380,31032,236246,236829,3911,12.596,3945,12.706,44772,18017,26755,7.608,18.905,45876,18719,27157,7.904,19.371,-1104,-0.466,37.810,2636,2694,12228
1992,5616,13418,16709,530277,538357,2405,14.514,2128,12.842,90183,31501,58682,5.851,16.752,107415,31767,75648,5.901,19.952,-17232,-3.201,33.503,1531,1551,18061
1992,5617,93408,97920,1134060,1127914,17568,18.093,15920,16.396,250143,86088,164055,7.632,22.177,237967,89089,148878,7.899,21.098,12176,1.080,42.196,12299,12318,57316
1992,5619,14869,16294,233712,230782,2748,16.880,2719,16.702,59533,22632,36901,9.807,25.796,53820,21400,32420,9.273,23.321,5713,2.476,46.642,2049,2055,11951
1992,5621,6087,6590,93269,92045,716,10.884,693,10.534,16314,5319,10995,5.779,17.724,13870,5291,8579,5.748,15.069,2444,2.655,30.137,528,529,3162
1992,5622,1557,2369,68366,69148,345,14.612,329,13.935,13072,5087,7985,7.357,18.904,14530,5524,9006,7.989,21.013,-1458,-2.109,37.809,189,191,2075
1992,5629,4820,5169,57825,57929,747,14.457,743,14.380,14035,4713,9322,8.136,24.228,14305,4809,9496,8.302,24.694,-270,-0.466,48.456,550,554,3482
1992,6111,14153,16061,530613,520876,824,5.184,490,3.083,54103,11363,42740,2.182,10.387,34583,7899,26684,1.516,6.639,19520,3.748,13.279,350,351,6026
1992,6112,592,904,74655,72326,67,7.482,50,5.583,10620,2601,8019,3.596,14.684,5874,1223,4651,1.691,8.122,4746,6.562,16.243,25,31,622
1992,6113,2098,2483,1117160,1102912,95,3.831,89,3.589,76331,1077,75254,0.098,6.921,47383,2362,45021,0.214,4.296,28948,2.625,8.592,47,48,1201
1992,6114,3185,3673,47306,46736,664,18.468,509,14.157,10235,3282,6953,7.022,21.900,9056,3779,5277,8.086,19.377,1179,2.523,38.754,353,358,2579
1992,6115,4714,5595,64241,64400,654,11.686,657,11.739,12635,3647,8988,5.663,19.620,12924,4313,8611,6.697,20.068,-289,-0.449,39.239,402,435,2839
1992,6116,14888,15817,122965,119714,2759,17.750,2212,14.231,31926,12540,19386,10.475,26.669,25329,12156,13173,10.154,21.158,6597,5.511,42.316,1731,1739,9839
1992,6117,2270,2354,18669,18410,488,21.361,349,15.277,4318,1804,2514,9.799,23.455,3722,1920,1802,10.429,20.218,596,3.237,40.436,240,241,896
1992,6211,181672,193886,1502948,1461332,14005,7.240,13110,6.777,257410,79558,177852,5.444,17.615,173979,60091,113888,4.112,11.906,83431,5.709,23.811,9942,10092,40173
1992,6212,101296,104228,561515,552618,5188,4.994,4520,4.351,80585,18431,62154,3.335,14.582,62831,16414,46417,2.970,11.370,17754,3.213,22.739,3240,3295,11853
1992,6213,64768,68589,291363,280018,8249,12.295,5252,7.828,69726,28735,40991,10.262,24.901,46936,16954,29982,6.055,16.762,22790,8.139,33.524,3746,3820,12115
1992,6214,8442,13891,266445,257322,1771,13.115,996,7.376,49938,15094,34844,5.866,19.407,31523,10809,20714,4.201,12.250,18415,7.156,24.501,464,474,4759
1992,6215,5600,7762,125958,125142,1192,15.685,867,11.409,25190,9334,15856,7.459,20.129,23707,8261,15446,6.601,18.944,1483,1.185,37.888,613,618,4675
1992,6216,5586,9367,515367,482872,1581,17.707,704,7.885,126757,32778,93979,6.788,26.251,61604,16309,45295,3.378,12.758,65153,13.493,25.516,379,389,7075
1992,6219,5520,6970,132474,126873,1055,15.575,662,9.773,30665,10600,20065,8.355,24.170,19507,8732,10775,6.883,15.375,11158,8.795,30.751,444,447,5150
1992,6221,3144,4654,4130552,4038695,156,3.339,191,4.089,382772,110645,272127,2.740,9.478,201779,56393,145386,1.396,4.996,180993,4.481,9.992,104,107,36111
1992,6222,572,980,320914,339471,63,6.452,56,5.735,33695,15157,18538,4.465,9.926,69694,6403,63291,1.886,20.530,-35999,-10.604,19.851,25,25,2605
1992,6223,226,326,122203,117876,36,11.303,21,6.593,17814,7513,10301,6.374,15.112,9582,2936,6646,2.491,8.129,8232,6.984,16.258,13,13,2266
1992,6231,8195,14314,1339571,1309276,1060,7.512,654,4.635,160936,64876,96060,4.955,12.292,101121,39089,62032,2.986,7.723,59815,4.569,15.447,395,413,24021
1992,6232,6466,13121,282559,272603,1689,13.418,622,4.941,53257,20923,32334,7.675,19.536,33356,10545,22811,3.868,12.236,19901,7.300,24.472,437,460,7851
1992,6233,10172,12320,307183,301215,1627,13.432,1212,10.006,47227,18396,28831,6.107,15.679,35023,15368,19655,5.102,11.627,12204,4.052,23.254,771,789,9677
1992,6239,3912,5322,128912,126331,571,10.950,356,6.827,19949,6829,13120,5.406,15.791,14861,5166,9695,4.089,11.764,5088,4.028,23.527,213,213,2601
1992,6241,20871,28460,420953,407903,3087,11.088,1850,6.645,73947,18547,55400,4.547,18.129,48307,11789,36518,2.890,11.843,25640,6.286,23.686,1099,1115,6045
1992,6242,5635,6738,71106,69356,616,9.260,445,6.689,12780,3138,9642,4.525,18.427,9416,3183,6233,4.589,13.576,3364,4.850,27.153,264,264,1109
1992,6243,5224,8197,297888,293572,784,9.731,504,6.255,47893,8197,39696,2.792,16.314,38947,5609,33338,1.911,13.267,8946,3.047,26.533,214,227,2571
1992,6244,38629,47215,464205,453507,6032,13.057,3994,8.646,87798,34943,52855,7.705,19.360,66178,22693,43485,5.004,14.592,21620,4.767,29.185,2946,3016,16608
1992,7111,5908,5978,84681,82218,1052,18.015,775,13.272,22095,6175,15920,7.511,26.874,17048,4258,12790,5.179,20.735,5047,6.139,41.470,529,529,2836
1992,7112,2594,2703,77990,74783,506,18.867,464,17.301,17920,4843,13077,6.476,23.963,11845,4089,7756,5.468,15.839,6075,8.124,31.678,338,340,2548
1992,7113,2404,2479,47181,45799,451,18.556,354,14.565,13108,6201,6907,13.540,28.621,10089,2349,7740,5.129,22.029,3019,6.592,44.058,258,258,1743
1992,7114,1561,1594,14314,15045,246,15.496,233,14.677,3599,1353,2246,8.993,23.922,5052,1815,3237,12.064,33.579,-1453,-9.658,47.843,173,174,1507
1992,7115,7153,7256,45006,51915,1461,19.883,1645,22.387,15506,6014,9492,11.584,29.868,29009,20246,8763,38.999,55.878,-13503,-26.010,59.737,1173,1173,5644
1992,7121,3023,3319,66879,65789,253,7.710,178,5.424,8754,1466,7288,2.228,13.306,6478,1287,5191,1.956,9.847,2276,3.460,19.693,109,109,621
1992,7131,1617,2508,92983,89698,314,12.621,274,11.013,15458,3411,12047,3.803,17.233,8409,1910,6499,2.129,9.375,7049,7.859,18.750,182,185,1203
1992,7132,977,1085,40204,34501,212,20.355,125,12.002,15258,5553,9705,16.095,44.225,3640,1836,1804,5.322,10.551,11618,33.675,21.101,83,83,1515
1992,7139,38715,41799,673192,660612,5190,12.532,4423,10.680,126229,46884,79345,7.097,19.108,101511,35968,65543,5.445,15.366,24718,3.742,30.732,3280,3324,25962
1992,7211,29515,36317,1424566,1432404,4018,11.060,4043,11.129,208510,94446,114064,6.594,14.557,224213,101172,123041,7.063,15.653,-15703,-1.096,29.113,2501,2556,58355
1992,7212,4340,4656,30077,29443,525,11.381,439,9.517,6958,1873,5085,6.361,23.632,5716,1770,3946,6.012,19.414,1242,4.218,38.828,232,233,938
1992,7213,3224,3316,15768,16093,284,8.478,352,10.507,2535,928,1607,5.767,15.753,3166,1627,1539,10.110,19.674,-631,-3.921,31.505,255,255,1167
1992,7223,12683,20750,388370,377383,3436,16.716,3047,14.823,100357,37450,62907,9.924,26.593,79577,36414,43163,9.649,21.087,20780,5.506,42.173,2038,2047,18918
1992,7224,48851,49397,306515,306108,6992,14.002,8073,16.166,81546,43783,37763,14.303,26.640,80789,42053,38736,13.738,26.392,757,0.247,52.785,6295,6311,32628
1992,7225,232351,322515,5962212,5895964,47408,14.827,41844,13.087,1204714,616938,587776,10.464,20.433,1075281,462740,612541,7.848,18.238,129433,2.195,36.475,27856,28740,274542
1992,8111,122043,132198,661804,664854,16860,12.812,15658,11.898,130653,59140,71513,8.895,19.651,136796,53087,83709,7.985,20.575,-6143,-0.924,39.303,11527,11613,39451
1992,8112,12751,15698,139089,139114,2290,14.764,1915,12.346,28736,13475,15261,9.686,20.656,28847,10991,17856,7.901,20.736,-111,-0.080,41.313,1202,1216,4288
1992,8113,21518,22999,169476,171879,2549,11.075,2584,11.227,28966,9986,18980,5.810,16.853,33564,11471,22093,6.674,19.528,-4598,-2.675,33.705,1888,1892,7447
1992,8114,25972,27956,169643,170269,4018,14.367,4040,14.446,30314,11770,18544,6.913,17.804,31480,12492,18988,7.337,18.488,-1166,-0.685,35.607,3043,3056,9021
1992,8121,75642,87121,454103,456117,11411,13.074,11725,13.434,92315,44812,47503,9.825,20.239,96782,42806,53976,9.385,21.219,-4467,-0.979,40.479,9009,9153,32864
1992,8122,16562,20360,129489,128746,1161,5.643,1586,7.709,21503,5197,16306,4.037,16.702,20024,7002,13022,5.439,15.553,1479,1.149,31.106,1040,1057,4929
1992,8123,34180,41178,372849,377627,4974,12.049,5180,12.548,60776,23279,37497,6.165,16.094,69877,28346,41531,7.506,18.504,-9101,-2.410,32.188,3500,3673,17753
1992,8129,14156,23450,165073,166055,3634,15.395,3943,16.704,36314,16979,19335,10.225,21.869,38063,16652,21411,10.028,22.922,-1749,-1.053,43.737,1828,1870,8372
1992,8131,137833,137928,1195642,1171354,7321,5.372,4033,2.959,150791,20690,130101,1.766,12.873,102662,12728,89934,1.087,8.764,48129,4.109,17.529,2332,2332,7092
1992,8132,10463,12250,148633,147804,1166,9.681,754,6.260,27055,6911,20144,4.676,18.305,26080,4892,21188,3.310,17.645,975,0.660,35.290,444,450,3180
1992,8133,9168,10864,115100,112574,1035,9.665,724,6.761,19967,4557,15410,4.048,17.737,14804,4116,10688,3.656,13.151,5163,4.586,26.301,393,395,2180
1992,8134,31654,33425,317160,317330,2154,6.482,1763,5.306,45121,8265,36856,2.605,14.219,44551,6520,38031,2.055,14.039,570,0.180,28.079,1237,1239,4586
1992,8139,64048,66403,539788,538056,4498,6.802,3953,5.978,86296,20717,65579,3.850,16.038,82599,28566,54033,5.309,15.351,3697,0.687,30.703,2691,2710,22249
1993,1131,230,248,2462,2633,29,11.531,36,14.314,563,85,478,3.229,21.387,912,225,687,8.547,34.644,-349,-13.257,42.773,21,21,90
1993,1132,106,122,1359,1478,14,11.475,14,11.475,397,104,293,7.039,26.870,641,180,461,12.183,43.384,-244,-16.514,53.739,12,12,106
1993,1133,11477,11561,83238,82946,1766,15.440,1519,13.281,18950,6860,12090,8.270,22.846,18534,5625,12909,6.782,22.345,416,0.502,44.690,1116,1116,4133
1993,1141,1154,1165,10047,10052,162,13.864,169,14.463,2955,1241,1714,12.346,29.399,2961,1510,1451,15.023,29.458,-6,-0.060,58.797,119,120,1181
1993,1142,196,202,1515,1493,30,15.267,19,9.669,318,81,237,5.427,21.307,267,123,144,8.241,17.889,51,3.417,35.779,17,17,116
1993,1151,4324,4614,60929,60759,541,11.668,586,12.639,15919,5025,10894,8.270,26.200,15392,5383,10009,8.860,25.333,527,0.867,50.666,387,388,3515
1993,1152,2260,2296,15018,15026,360,15.748,340,14.873,2818,951,1867,6.329,18.754,2847,1151,1696,7.660,18.947,-29,-0.193,37.508,261,261,802
1993,1153,1001,1020,11225,11591,139,13.803,113,11.221,2933,669,2264,5.772,25.305,3613,959,2654,8.274,31.172,-680,-5.867,50.610,74,74,679
1993,2111,6892,8089,100146,109360,768,9.429,880,10.804,16069,6435,9634,5.884,14.694,34629,5644,28985,5.161,31.665,-18560,-16.972,29.387,563,564,1928
1993,2121,1438,1955,105843,110671,272,13.350,437,21.448,14921,6395,8526,5.778,13.482,24662,11932,12730,10.782,22.284,-9741,-8.802,26.965,308,313,5393
1993,2122,362,530,45096,45880,68,12.297,114,20.615,3468,872,2596,1.901,7.559,5035,1551,3484,3.381,10.974,-1567,-3.415,15.118,53,55,252
1993,2123,3364,4980,95412,96607,295,5.869,388,7.719,11211,2531,8680,2.620,11.605,13773,3200,10573,3.312,14.257,-2562,-2.652,23.209,220,229,1451
1993,2131,7423,8391,134358,136160,1192,14.062,1364,16.091,35322,13292,22030,9.762,25.942,38768,15006,23762,11.021,28.472,-3446,-2.531,51.883,918,920,6355
1993,2211,1511,6919,617910,625548,332,4.834,230,3.349,46412,12431,33981,1.987,7.419,62002,8041,53961,1.285,9.912,-15590,-2.492,14.839,47,51,713
1993,2212,613,2793,109329,108935,214,7.748,152,5.503,9021,3543,5478,3.252,8.281,8192,1509,6683,1.385,7.520,829,0.761,15.040,32,32,110
1993,2213,3976,4360,31892,31358,348,8.123,196,4.575,3980,1266,2714,4.037,12.692,2908,876,2032,2.794,9.274,1072,3.419,18.547,138,138,516
1993,2361,113494,113909,573006,559302,22444,19.886,20354,18.034,186320,72633,113687,12.986,33.313,158862,67152,91710,12.006,28.404,27458,4.909,56.807,14409,14412,49709
1993,2362,35090,35736,580759,583537,4698,13.194,4441,12.472,125083,28656,96427,4.911,21.435,130374,29396,100978,5.038,22.342,-5291,-0.907,42.871,3277,3277,21172
1993,2371,13933,14234,306843,309138,1298,9.122,1290,9.065,60669,9087,51582,2.939,19.625,65719,10294,55425,3.330,21.259,-5050,-1.634,39.250,948,949,7650
1993,2372,6824,7022,54532,55657,1601,22.950,1509,21.631,14213,6391,7822,11.483,25.537,16293,7571,8722,13.603,29.274,-2080,-3.737,51.074,1215,1215,4621
1993,2373,9489,9889,220488,223220,961,9.754,887,9.003,43647,6993,36654,3.133,19.553,49571,8475,41096,3.797,22.207,-5924,-2.654,39.107,640,641,5333
1993,2379,4714,4788,66366,68818,630,13.049,710,14.706,14595,4035,10560,5.863,21.208,19605,6449,13156,9.371,28.488,-5010,-7.280,42.416,537,539,2644
1993,2381,77549,77959,661762,650873,12164,15.817,10059,13.080,191093,55195,135898,8.480,29.359,169637,52593,117044,8.080,26.063,21456,3.296,52.126,7558,7562,41892
1993,2382,121029,122981,1168696,1158417,14618,11.966,12990,10.633,240191,55342,184849,4.777,20.734,219605,57814,161791,4.991,18.957,20586,1.777,37.915,9796,9803,45417
1993,2383,81498,81950,586275,584232,14959,18.491,12856,15.892,165879,53484,112395,9.155,28.393,161798,54588,107210,9.344,27.694,4081,0.699,55.388,9479,9483,42664
1993,2389,40621,40888,332207,329760,5675,13.950,5261,12.932,87622,22495,65127,6.822,26.571,82558,24997,57561,7.580,25.036,5064,1.536,50.072,3937,3938,19719
1993,3111,1169,1781,48099,48404,94,5.299,80,4.510,4265,947,3318,1.956,8.811,4851,1016,3835,2.099,10.022,-586,-1.211,17.623,46,46,302
1993,3112,464,811,64328,64526,47,5.813,42,5.195,3743,883,2860,1.368,5.801,4021,1135,2886,1.759,6.232,-278,-0.431,11.602,21,22,212
1993,3113,1533,1744,85789,85331,164,9.425,156,8.966,9484,1042,8442,1.221,11.114,8318,1470,6848,1.723,9.748,1166,1.366,19.496,98,101,759
1993,3114,1249,1695,176611,174965,140,8.316,117,6.950,20102,3311,16791,1.892,11.489,16995,4788,12207,2.737,9.713,3107,1.776,19.427,85,85,1678
1993,3115,1270,1847,131836,132441,68,3.639,111,5.941,10012,1368,8644,1.033,7.560,11110,2246,8864,1.696,8.389,-1098,-0.829,15.119,76,78,1176
1993,3116,3568,4165,406555,399475,253,6.028,317,7.553,39783,9074,30709,2.271,9.959,25467,9664,15803,2.419,6.375,14316,3.584,12.750,233,236,3457
1993,3117,641,755,45384,46527,57,7.403,87,11.299,7408,1920,5488,4.127,15.922,9682,2553,7129,5.487,20.809,-2274,-4.887,31.844,66,66,2114
1993,3118,9079,10206,302371,301889,1186,11.651,1133,11.130,33221,10073,23148,3.337,11.004,32077,10869,21208,3.600,10.625,1144,0.379,21.251,817,856,5706
1993,3119,2161,2543,133520,132653,235,9.338,182,7.232,14588,4357,10231,3.285,10.997,12986,3648,9338,2.750,9.789,1602,1.208,19.579,145,145,1942
1993,3121,1672,2104,131322,131880,147,7.000,139,6.619,12320,1477,10843,1.120,9.342,13322,2546,10776,1.931,10.102,-1002,-0.760,18.684,98,98,982
1993,3122,69,103,35372,36195,6,5.634,13,12.207,1460,342,1118,0.945,4.034,3043,286,2757,0.790,8.407,-1583,-4.374,8.067,6,6,105
1993,3131,353,597,91440,94551,33,5.505,38,6.339,6615,1140,5475,1.206,6.996,12650,6490,6160,6.864,13.379,-6035,-6.383,13.992,19,19,216
1993,3132,1616,1958,240657,241611,172,8.784,172,8.784,17322,4624,12698,1.914,7.169,19127,4517,14610,1.870,7.916,-1805,-0.747,14.339,135,138,1127
1993,3133,5379,6062,140144,139687,608,10.082,545,9.037,18002,4967,13035,3.556,12.887,17030,4829,12201,3.457,12.192,972,0.696,24.383,416,420,3183
1993,3141,2944,3232,121614,121035,297,9.063,387,11.810,13529,3506,10023,2.897,11.178,12399,4104,8295,3.391,10.244,1130,0.934,20.488,299,300,1963
1993,3149,3969,4088,110897,111486,517,12.736,460,11.331,17514,5299,12215,4.753,15.710,18669,7319,11350,6.565,16.746,-1155,-1.036,31.419,380,380,4921
1993,3151,1121,1255,120524,120242,132,10.547,125,9.988,13405,3737,9668,3.108,11.148,12871,3091,9780,2.571,10.704,534,0.444,21.408,97,97,1704
1993,3152,11033,12165,672364,682241,2202,18.017,2315,18.942,104030,39919,64111,5.851,15.248,123336,56615,66721,8.298,18.078,-19306,-2.830,30.497,1942,1959,41509
1993,3159,1816,1920,58973,58977,263,13.727,255,13.309,8362,2107,6255,3.573,14.178,8264,3094,5170,5.246,14.012,98,0.166,28.024,220,221,2151
1993,3161,304,338,17308,17176,34,10.210,24,7.207,2391,470,1921,2.736,13.921,2171,390,1781,2.271,12.640,220,1.281,25.280,18,18,129
1993,3162,334,425,62987,62698,34,7.981,36,8.451,7851,3354,4497,5.349,12.522,7520,2365,5155,3.772,11.994,331,0.528,23.988,21,21,538
1993,3169,1052,1095,32367,31738,117,10.709,112,10.252,5523,1298,4225,4.090,17.402,4307,1386,2921,4.367,13.571,1216,3.831,27.141,90,90,745
1993,3211,4351,4845,129128,127862,458,9.459,452,9.335,15544,4013,11531,3.139,12.157,13037,4087,8950,3.196,10.196,2507,1.961,20.392,342,343,2194
1993,3212,1305,1605,95799,93895,123,7.716,101,6.336,10447,1857,8590,1.978,11.126,6669,2120,4549,2.258,7.103,3778,4.024,14.205,69,69,820
1993,3219,9118,9797,269169,262331,1093,11.209,1001,10.266,45478,11668,33810,4.448,17.336,31747,10549,21198,4.021,12.102,13731,5.234,24.204,789,797,7612
1993,3221,214,519,185076,186911,20,3.868,16,3.095,7176,3302,3874,1.767,3.839,10661,4547,6114,2.433,5.704,-3485,-1.865,7.679,3,3,18
1993,3222,3519,5151,399459,397185,263,5.115,245,4.765,29643,4693,24950,1.182,7.463,25310,6117,19193,1.540,6.372,4333,1.091,12.745,166,170,2711
1993,3231,41641,43650,814434,813935,3573,8.150,3951,9.013,93033,23191,69842,2.849,11.430,92295,28254,64041,3.471,11.339,738,0.091,22.679,3280,3290,18856
1993,3241,1116,2059,112897,112938,153,7.515,107,5.255,8637,2296,6341,2.033,7.648,8774,2005,6769,1.775,7.769,-137,-0.121,15.295,57,58,623
1993,3251,1152,2349,217205,219648,182,7.847,123,5.303,11316,3442,7874,1.567,5.152,16079,3629,12450,1.652,7.320,-4763,-2.168,10.304,46,48,751
1993,3252,358,645,132589,132460,53,8.399,25,3.962,8814,2367,6447,1.787,6.654,8291,1074,7217,0.811,6.259,523,0.395,12.519,7,8,272
1993,3253,640,860,39992,40778,59,6.884,53,6.184,2742,334,2408,0.819,6.724,4292,889,3403,2.180,10.525,-1550,-3.801,13.448,25,27,205
1993,3254,1127,1429,189007,189339,119,8.488,65,4.636,16437,2730,13707,1.442,8.681,17302,2688,14614,1.420,9.138,-865,-0.457,17.363,45,45,539
1993,3255,1572,2028,71817,72269,107,5.236,138,6.753,6375,1548,4827,2.142,8.821,7225,1641,5584,2.271,9.997,-850,-1.176,17.642,83,83,456
1993,3256,2049,2284,125330,123323,190,8.370,162,7.137,14125,2073,12052,1.681,11.454,10189,3488,6701,2.828,8.262,3936,3.192,16.524,118,118,1091
1993,3259,2252,2931,132198,131608,197,6.756,167,5.727,12243,2592,9651,1.969,9.303,10832,1978,8854,1.503,8.231,1411,1.072,16.461,121,122,996
1993,3261,10230,12313,692821,679545,889,7.248,795,6.481,87766,17327,70439,2.550,12.915,61314,17498,43816,2.575,9.023,26452,3.893,18.046,569,574,7064
1993,3262,2234,2742,189979,187369,186,6.793,178,6.501,16327,3215,13112,1.716,8.714,11080,2301,8779,1.228,5.913,5247,2.800,11.827,130,131,1103
1993,3271,1464,1746,75410,74659,163,9.408,136,7.850,8867,1725,7142,2.311,11.877,7420,1765,5655,2.364,9.939,1447,1.938,19.877,99,100,567
1993,3272,1720,1976,132004,132088,204,10.398,176,8.970,9562,1851,7711,1.401,7.239,9597,2696,6901,2.041,7.266,-35,-0.026,14.478,127,127,552
1993,3273,5950,8735,164375,164077,497,5.658,596,6.785,22659,5412,17247,3.298,13.810,22174,5752,16422,3.506,13.514,485,0.296,27.029,352,359,2989
1993,3274,240,342,16836,16808,18,5.180,29,8.345,1027,205,822,1.220,6.110,952,360,592,2.142,5.664,75,0.446,11.328,23,23,151
1993,3279,1924,2212,66813,66992,183,8.269,185,8.360,6320,1627,4693,2.429,9.434,6665,1819,4846,2.715,9.949,-345,-0.515,18.868,131,132,1096
1993,3311,251,328,159682,164660,32,9.816,28,8.589,4933,2105,2828,1.278,2.996,14962,1176,13786,0.714,9.087,-10029,-6.091,5.992,21,21,345
1993,3312,525,724,65450,65369,42,5.785,46,6.336,4857,722,4135,1.104,7.430,4832,677,4155,1.036,7.392,25,0.038,14.784,30,30,397
1993,3313,331,475,80741,80472,21,4.426,20,4.215,4484,236,4248,0.293,5.572,3865,1045,2820,1.299,4.803,619,0.769,9.606,10,10,125
1993,3314,786,948,74765,75180,60,6.293,71,7.446,5662,944,4718,1.256,7.531,6475,1836,4639,2.442,8.613,-813,-1.081,15.063,48,48,855
1993,3315,2381,2640,193017,192437,132,4.980,153,5.772,17808,3172,14636,1.648,9.254,16767,2667,14100,1.386,8.713,1041,0.541,17.426,109,109,1346
1993,3321,3128,3319,128315,127272,161,4.818,206,6.165,14514,3339,11175,2.624,11.404,12472,4346,8126,3.415,9.800,2042,1.604,19.599,152,152,1214
1993,3322,1332,1466,74648,74961,86,5.870,84,5.734,4932,535,4397,0.714,6.579,5609,997,4612,1.330,7.483,-677,-0.903,13.159,68,68,592
1993,3323,10292,11036,309979,309827,800,7.240,828,7.493,41934,8639,33295,2.788,13.535,41553,11919,29634,3.847,13.412,381,0.123,26.823,652,657,6275
1993,3324,1551,1873,105271,107276,93,4.926,123,6.515,9365,1645,7720,1.533,8.730,13498,3315,10183,3.090,12.582,-4133,-3.853,17.460,76,77,1021
1993,3325,903,991,65842,65400,58,5.800,76,7.600,5399,1099,4300,1.680,8.255,4587,935,3652,1.430,7.014,812,1.242,14.028,61,61,640
1993,3326,1523,1695,68185,66937,101,6.008,73,4.343,7049,1114,5935,1.664,10.531,4628,1190,3438,1.778,6.914,2421,3.617,13.828,52,57,879
1993,3327,22254,22579,332978,329191,2087,9.337,1633,7.306,46093,10970,35123,3.332,14.002,38551,10180,28371,3.092,11.711,7542,2.291,23.422,1222,1226,6706
1993,3328,5330,5724,129700,128378,361,6.310,355,6.205,16754,3008,13746,2.343,13.051,14192,3610,10582,2.812,11.055,2562,1.996,22.110,270,272,2158
1993,3329,5713,6216,309255,311620,496,7.974,504,8.103,27828,4519,23309,1.450,8.930,32758,9341,23417,2.998,10.512,-4930,-1.582,17.860,372,373,3244
1993,3331,2730,2973,185367,188224,192,6.424,224,7.494,15353,1870,13483,0.993,8.157,21212,6263,14949,3.327,11.270,-5859,-3.113,16.314,154,154,1330
1993,3332,4056,4298,150891,152515,302,7.036,290,6.757,16126,3281,12845,2.151,10.573,19226,4455,14771,2.921,12.606,-3100,-2.033,21.147,212,214,1559
1993,3333,2434,2553,137017,138320,197,7.704,205,8.017,12128,1384,10744,1.001,8.768,14653,3123,11530,2.258,10.594,-2525,-1.825,17.536,153,155,1390
1993,3334,1548,1792,147431,147268,125,6.991,117,6.544,14049,1484,12565,1.008,9.540,13745,3589,10156,2.437,9.333,304,0.206,18.667,79,80,835
1993,3335,9319,9639,205714,204743,608,6.325,556,5.784,25091,5584,19507,2.727,12.255,23106,8557,14549,4.179,11.285,1985,0.970,22.571,420,420,2897
1993,3336,765,919,119589,119611,51,5.562,47,5.125,9399,2157,7242,1.803,7.858,9377,3101,6276,2.593,7.840,22,0.018,15.679,31,32,743
1993,3339,5450,6054,300489,299675,437,7.259,369,6.130,29996,7177,22819,2.395,10.010,28504,7733,20771,2.580,9.512,1492,0.498,19.023,259,260,2628
1993,3341,1692,1791,190321,193875,247,13.861,229,12.851,18853,3205,15648,1.653,9.724,25631,6352,19279,3.276,13.220,-6778,-3.496,19.449,172,173,2389
1993,3342,1780,1969,219003,220307,169,8.618,153,7.802,22627,6601,16026,2.996,10.271,25632,7801,17831,3.541,11.635,-3005,-1.364,20.541,95,95,1282
1993,3343,406,441,34287,33287,53,12.311,32,7.433,3839,1257,2582,3.776,11.533,1831,629,1202,1.890,5.501,2008,6.032,11.001,22,22,489
1993,3344,4994,5538,469377,469110,543,9.849,493,8.942,49708,9234,40474,1.968,10.596,48701,13430,35271,2.863,10.382,1007,0.215,20.763,375,375,5103
1993,3345,4543,5154,538618,556599,338,6.553,346,6.708,30215,5875,24340,1.056,5.429,65839,5965,59874,1.072,11.829,-35624,-6.400,10.857,234,237,2060
1993,3346,742,792,44164,42536,116,15.026,76,9.845,7832,1872,5960,4.401,18.413,4654,1189,3465,2.795,10.941,3178,7.471,21.883,57,57,360
1993,3351,1120,1233,70047,70005,80,6.410,110,8.814,6353,730,5623,1.043,9.075,6288,1951,4337,2.787,8.982,65,0.093,17.965,83,84,1511
1993,3352,322,394,100447,99815,25,6.274,34,8.532,9317,1545,7772,1.548,9.334,7646,1383,6263,1.386,7.660,1671,1.674,15.320,22,23,365
1993,3353,2193,2602,199123,200905,162,6.208,177,6.783,16437,3265,13172,1.625,8.181,20042,4970,15072,2.474,9.976,-3605,-1.794,16.363,114,114,1237
1993,3359,1848,2224,184521,183736,133,5.953,153,6.849,17909,3402,14507,1.852,9.747,16223,3961,12262,2.156,8.830,1686,0.918,17.659,106,107,1044
1993,3361,264,321,212522,210242,49,15.781,28,9.018,30553,11922,18631,5.671,14.532,26829,18226,8603,8.669,12.761,3724,1.771,25.522,23,23,435
1993,3362,1694,1856,107889,102338,164,8.742,204,10.874,19095,2424,16671,2.369,18.659,8113,3649,4464,3.566,7.928,10982,10.731,15.855,144,146,1698
1993,3363,4272,5162,663338,650842,405,7.905,328,6.402,69884,12972,56912,1.993,10.737,45722,14815,30907,2.276,7.025,24162,3.712,14.050,225,226,4406
1993,3364,1424,1742,591410,627730,106,5.995,158,8.937,21095,8545,12550,1.361,3.361,93371,4664,88707,0.743,14.874,-72276,-11.514,6.721,117,118,1306
1993,3365,170,218,26453,25084,12,5.505,12,5.505,4619,707,3912,2.819,18.414,1860,149,1711,0.594,7.415,2759,10.999,14.830,6,6,107
1993,3366,1364,1458,139459,144069,159,11.000,134,9.270,11721,2805,8916,1.947,8.136,21055,2848,18207,1.977,14.615,-9334,-6.479,16.271,97,97,1386
1993,3369,513,531,32929,32004,77,15.098,35,6.863,4556,590,3966,1.844,14.236,2593,465,2128,1.453,8.102,1963,6.134,16.204,24,24,246
1993,3371,13429,14017,360400,354672,1753,12.529,1703,12.171,52457,13089,39368,3.690,14.790,40926,16608,24318,4.683,11.539,11531,3.251,23.078,1277,1291,10744
1993,3372,3163,3355,145960,145021,343,10.336,270,8.136,17828,3447,14381,2.377,12.293,15983,4517,11466,3.115,11.021,1845,1.272,22.042,200,202,2482
1993,3379,1079,1215,38886,38953,99,8.165,94,7.753,4908,699,4209,1.794,12.600,5115,1385,3730,3.556,13.131,-207,-0.531,25.200,74,74,557
1993,3391,10701,11273,281246,273676,967,8.633,823,7.348,39891,13020,26871,4.757,14.576,24261,5918,18343,2.162,8.865,15630,5.711,17.730,625,626,3148
1993,3399,15498,16017,398698,393523,1928,12.184,1543,9.751,56861,14125,42736,3.589,14.449,46526,11560,34966,2.938,11.823,10335,2.626,23.646,1227,1232,7105
1993,4231,18551,22363,256344,256062,2038,9.068,2259,10.052,35587,10115,25472,3.950,13.898,35210,13109,22101,5.119,13.751,377,0.147,27.501,1603,1654,7589
1993,4232,8619,9707,117310,114960,1147,11.860,1075,11.116,21830,6439,15391,5.601,18.989,17116,5337,11779,4.642,14.889,4714,4.101,29.777,782,798,3504
1993,4233,7765,10239,120778,119104,1147,11.314,945,9.321,19017,5921,13096,4.971,15.967,15823,5714,10109,4.797,13.285,3194,2.682,26.570,660,668,3482
1993,4234,26689,35023,596036,592105,4379,12.621,3727,10.742,97639,29623,68016,5.003,16.490,89844,32858,56986,5.549,15.174,7795,1.316,30.347,2300,2366,15204
1993,4235,6826,9184,128764,128713,723,7.848,779,8.456,16398,3939,12459,3.060,12.740,16255,5186,11069,4.029,12.629,143,0.111,25.258,491,503,2709
1993,4236,17819,25725,321366,317942,3076,12.120,2387,9.405,60151,18029,42122,5.671,18.919,53375,17218,36157,5.415,16.788,6776,2.131,33.575,1476,1553,8784
1993,4237,10864,15126,163806,162212,1160,7.683,1104,7.312,23142,6362,16780,3.922,14.267,19849,5888,13961,3.630,12.236,3293,2.030,24.473,728,748,3508
1993,4238,47393,61336,639797,637326,4986,8.122,5097,8.302,87694,23077,64617,3.621,13.760,82655,28638,54017,4.493,12.969,5039,0.791,25.938,3275,3370,15514
1993,4239,25946,28029,295247,288999,3768,13.580,3203,11.544,56929,16148,40781,5.588,19.699,44189,16202,27987,5.606,15.290,12740,4.408,30.581,2481,2498,10897
1993,4241,9693,12570,193103,193321,1066,8.478,1074,8.541,22472,5893,16579,3.048,11.624,22709,7614,15095,3.939,11.747,-237,-0.123,23.248,700,725,4056
1993,4242,3654,4818,145513,139616,705,14.941,506,10.724,29459,12231,17228,8.760,21.100,17806,4691,13115,3.360,12.754,11653,8.346,25.507,338,340,2210
1993,4243,10122,10845,131969,130491,1944,18.320,1477,13.919,28429,11143,17286,8.539,21.786,25328,9108,16220,6.980,19.410,3101,2.376,38.820,1172,1184,6612
1993,4244,27773,33871,701936,697284,3566,10.530,3556,10.500,101797,28206,73591,4.045,14.599,92282,32007,60275,4.590,13.235,9515,1.365,26.469,2686,2736,18057
1993,4245,6253,9084,79970,80528,500,5.455,663,7.234,11325,2577,8748,3.200,14.064,12463,3712,8751,4.610,15.477,-1138,-1.413,28.127,428,439,2502
1993,4246,8616,12405,142710,141103,1224,9.887,1175,9.491,23948,7923,16025,5.615,16.972,20607,8381,12226,5.940,14.604,3341,2.368,29.209,565,574,2920
1993,4247,8601,11763,129667,130589,741,6.276,829,7.021,19492,5171,14321,3.960,14.926,21287,5812,15475,4.451,16.301,-1795,-1.375,29.853,524,533,3698
1993,4248,3410,4407,136286,135002,232,5.244,267,6.035,12587,2848,9739,2.110,9.324,10120,2994,7126,2.218,7.496,2467,1.827,14.992,183,187,1617
1993,4249,20987,25184,302406,300089,3166,12.650,2855,11.407,51607,16944,34663,5.646,17.197,46822,17577,29245,5.857,15.603,4785,1.595,31.205,1969,2005,10446
1993,4251,31990,34238,290362,289031,3662,10.805,2967,8.755,46600,14536,32064,5.029,16.123,44027,13929,30098,4.819,15.233,2573,0.890,30.465,2050,2057,8765
1993,4411,37907,40178,940996,923932,4292,10.776,3597,9.031,123816,38532,85284,4.170,13.401,89705,35085,54620,3.797,9.709,34111,3.692,19.418,2916,2934,29263
1993,4412,10378,11068,77091,76273,1044,9.470,957,8.681,13960,4390,9570,5.756,18.303,12284,4638,7646,6.081,16.105,1676,2.197,32.211,742,753,3471
1993,4413,39430,58231,450911,449224,4119,7.048,4545,7.777,66618,21590,45028,4.806,14.830,63535,21627,41908,4.814,14.143,3083,0.686,28.287,2826,3049,12911
1993,4421,21281,27571,236477,232156,2679,9.686,2854,10.319,43575,13950,29625,6.009,18.770,34889,14077,20812,6.064,15.028,8686,3.741,30.057,1868,2012,9138
1993,4422,23823,31376,205255,200301,3186,10.178,3039,9.708,42880,14458,28422,7.218,21.408,33078,11054,22024,5.519,16.514,9802,4.894,33.028,2056,2143,7246
1993,4431,29569,45394,341352,337057,5108,11.275,4931,10.884,67990,29286,38704,8.689,20.172,59550,23581,35969,6.996,17.668,8440,2.504,35.335,3116,3316,14964
1993,4441,53222,71730,822255,812278,4700,6.532,5144,7.149,118755,39298,79457,4.838,14.620,99396,30202,69194,3.718,12.237,19359,2.383,24.473,3649,3782,17414
1993,4442,17360,21277,165417,165880,1637,7.694,1636,7.689,25316,6876,18440,4.145,15.262,26217,7577,18640,4.568,15.805,-901,-0.543,30.523,1148,1164,4301
1993,4451,61591,90507,2445273,2428601,9623,10.611,9985,11.010,300335,137249,163086,5.651,12.367,268210,92899,175311,3.825,11.044,32125,1.323,22.088,6359,6530,40943
1993,4452,17869,21968,133586,133798,3225,14.801,2868,13.162,29841,13489,16352,10.082,22.303,30332,12749,17583,9.529,22.670,-491,-0.367,44.606,2108,2178,9385
1993,4453,24286,28519,137997,138061,2544,8.873,2847,9.930,25400,11176,14224,8.095,18.398,25526,8631,16895,6.252,18.489,-126,-0.091,36.795,2046,2073,6084
1993,4461,46405,77224,758821,757017,6558,8.485,6696,8.663,107457,44623,62834,5.895,14.195,105262,40374,64888,5.333,13.905,2195,0.290,27.810,4036,4243,20947
1993,4471,74092,125190,890766,893882,9958,7.885,12146,9.618,158318,56472,101846,6.318,17.711,164910,69230,95680,7.745,18.449,-6592,-0.737,35.423,6825,7181,36092
1993,4481,46638,99101,1007340,994203,10512,10.484,12847,12.813,207469,75594,131875,7.603,20.868,181187,70801,110386,7.121,18.224,26282,2.644,36.449,6461,7118,28165
1993,4482,8494,33593,181617,182164,2754,8.101,3559,10.469,35831,13915,21916,7.639,19.670,35998,14728,21270,8.085,19.761,-167,-0.092,39.339,1028,1163,4266
1993,4483,19104,27878,160619,161400,2697,9.616,3035,10.821,29177,10347,18830,6.411,18.077,31092,12070,19022,7.478,19.264,-1915,-1.186,36.155,1583,1699,5174
1993,4511,31723,42829,335525,331194,5196,12.129,5214,12.171,67824,29061,38763,8.775,20.479,58876,25258,33618,7.626,17.777,8948,2.702,35.554,3437,3608,12656
1993,4512,8965,14690,109945,108006,1578,10.837,1321,9.072,24282,9432,14850,8.733,22.482,20405,6018,14387,5.572,18.892,3877,3.590,37.785,839,871,3773
1993,4522,138,6426,1061776,1050479,281,4.397,211,3.302,102026,34958,67068,3.328,9.712,78211,17790,60421,1.694,7.445,23815,2.267,14.891,5,7,619
1993,4523,10360,28096,1126337,1077178,2783,9.994,2287,8.212,190079,95846,94233,8.898,17.646,95789,29208,66581,2.712,8.893,94290,8.753,17.785,1141,1233,6401
1993,4531,23361,24695,120824,121849,2654,10.713,2811,11.347,21431,8025,13406,6.586,17.588,23541,8150,15391,6.689,19.320,-2110,-1.732,35.176,2265,2294,6564
1993,4532,30870,39646,269494,263774,5301,13.442,4881,12.377,62699,30128,32571,11.422,23.770,51459,19972,31487,7.572,19.509,11240,4.261,39.017,3480,3610,13226
1993,4533,11546,14573,84014,79929,2198,15.416,1568,10.997,18701,6649,12052,8.319,23.397,10444,4347,6097,5.439,13.067,8257,10.330,26.133,1251,1257,3261
1993,4539,24729,28917,152988,147661,4757,16.684,3946,13.840,40661,19127,21534,12.953,27.537,29821,13119,16702,8.885,20.196,10840,7.341,40.391,2817,2962,9769
1993,4541,6252,6934,134291,133050,949,13.670,965,13.901,25478,7358,18120,5.530,19.149,23053,9792,13261,7.360,17.327,2425,1.823,34.653,644,653,3835
1993,4542,4379,5291,65848,67638,691,13.016,727,13.694,9155,3194,5961,4.722,13.535,12707,6026,6681,8.909,18.787,-3552,-5.251,27.071,418,422,2227
1993,4543,17534,23893,217019,216185,2221,9.323,2081,8.735,37161,11000,26161,5.088,17.189,35196,10561,24635,4.885,16.281,1965,0.909,32.561,1399,1420,6730
1993,4811,562,2839,437553,437953,310,10.993,272,9.645,37460,6142,31318,1.402,8.553,37637,7021,30616,1.603,8.594,-177,-0.040,17.107,52,55,1445
1993,4812,1198,1377,21473,20491,171,12.324,192,13.838,5137,1185,3952,5.783,25.070,2996,1053,1943,5.139,14.621,2141,10.449,29.243,131,131,628
1993,4831,406,721,37382,38345,87,12.262,64,9.020,5799,1427,4372,3.721,15.123,7447,1371,6076,3.575,19.421,-1648,-4.298,30.246,35,35,588
1993,4832,290,319,11141,11754,50,15.823,44,13.924,1307,468,839,3.982,11.120,2505,1240,1265,10.550,21.313,-1198,-10.193,22.240,33,33,478
1993,4841,25537,32578,669784,663014,5301,16.530,4282,13.353,109068,32653,76415,4.925,16.450,96155,35711,60444,5.386,14.503,12913,1.948,29.005,3164,3210,22544
1993,4842,44137,47651,461944,457136,7565,16.084,6331,13.460,96868,33266,63602,7.277,21.190,86970,35344,51626,7.732,19.025,9898,2.165,38.050,4850,4883,24729
1993,4851,401,484,25257,24382,68,14.301,51,10.726,4900,2510,2390,10.295,20.097,3141,695,2446,2.851,12.883,1759,7.214,25.765,41,41,430
1993,4852,298,570,19666,19605,42,7.362,43,7.537,2845,392,2453,1.999,14.512,2695,826,1869,4.213,13.746,150,0.765,27.493,30,31,357
1993,4853,5125,5243,50305,49627,900,17.469,718,13.936,11513,4821,6692,9.714,23.199,10056,4416,5640,8.898,20.263,1457,2.936,40.526,599,600,3696
1993,4854,3275,4179,132464,131080,349,8.405,296,7.128,18028,6191,11837,4.723,13.753,15259,5436,9823,4.147,11.641,2769,2.112,23.282,206,221,3263
1993,4855,1110,1225,25276,24915,127,10.435,111,9.121,4138,850,3288,3.412,16.608,3329,919,2410,3.689,13.361,809,3.247,26.723,87,87,783
1993,4859,1756,1889,34157,33914,353,19.211,250,13.605,7620,3086,4534,9.099,22.469,7058,3372,3686,9.943,20.811,562,1.657,41.623,205,206,2364
1993,4861,49,392,8647,8991,36,9.243,31,7.959,1146,229,917,2.547,12.746,1884,379,1505,4.215,20.954,-738,-8.208,25.492,0,0,0
1993,4862,151,1302,39971,41217,91,6.981,94,7.211,3089,1511,1578,3.666,7.494,5643,1061,4582,2.574,13.691,-2554,-6.196,14.989,20,22,152
1993,4869,59,363,5771,6079,44,11.860,60,16.173,981,605,376,9.953,16.139,1515,829,686,13.638,24.924,-534,-8.785,32.278,6,9,189
1993,4871,330,357,6982,6742,59,17.101,35,10.145,1307,333,974,4.939,19.386,805,244,561,3.619,11.940,502,7.446,23.880,26,26,174
1993,4872,1174,1207,11705,11588,184,15.449,152,12.762,2886,694,2192,5.989,24.906,2733,896,1837,7.732,23.586,153,1.320,47.172,108,109,630
1993,4879,123,130,1235,1249,11,8.240,18,13.483,198,22,176,1.761,15.853,219,60,159,4.804,17.534,-21,-1.681,31.705,11,11,34
1993,4881,2420,3054,85033,81640,476,15.883,362,12.079,17173,5639,11534,6.907,21.035,10710,3544,7166,4.341,13.119,6463,7.917,26.237,219,220,1019
1993,4882,467,732,17400,16906,99,13.846,65,9.091,3616,1246,2370,7.370,21.389,2593,1408,1185,8.329,15.338,1023,6.051,30.676,35,35,613
1993,4883,2044,2612,83371,85690,267,10.257,249,9.566,15223,3385,11838,3.950,17.765,19546,5339,14207,6.231,22.810,-4323,-5.045,35.531,172,173,1485
1993,4884,4328,4541,31472,30705,681,15.187,567,12.645,7678,3363,4315,10.953,25.006,6122,2746,3376,8.943,19.938,1556,5.068,39.876,423,425,1847
1993,4885,8860,11620,108901,107605,1628,14.275,1197,10.496,20511,7370,13141,6.849,19.061,17833,6268,11565,5.825,16.573,2678,2.489,33.145,798,831,3921
1993,4889,813,865,9445,9014,136,15.981,108,12.691,2435,1019,1416,11.305,27.014,1589,489,1100,5.425,17.628,846,9.385,35.256,84,85,421
1993,4921,1637,4588,377256,366916,520,11.608,303,6.764,40579,4654,35925,1.268,11.059,18376,4015,14361,1.094,5.008,22203,6.051,10.016,178,178,1926
1993,4922,3570,3829,64687,62290,657,17.647,445,11.953,13520,3482,10038,5.590,21.705,8778,3452,5326,5.542,14.092,4742,7.613,28.184,372,373,2761
1993,4931,6197,10294,426003,436575,818,7.913,905,8.755,63620,14812,48808,3.393,14.573,85384,23229,62155,5.321,19.558,-21764,-4.985,29.145,272,279,3082
1993,5111,14711,17506,674257,672383,1880,10.841,1552,8.949,68845,26494,42351,3.940,10.239,65469,23276,42193,3.462,9.737,3376,0.502,19.474,1208,1211,9421
1993,5112,5566,6678,138178,131784,1113,17.214,688,10.641,29844,8309,21535,6.305,22.646,17144,6320,10824,4.796,13.009,12700,9.637,26.018,432,434,3557
1993,5121,9869,14388,230446,230411,2058,14.444,1778,12.479,47571,14111,33460,6.124,20.646,47857,17935,29922,7.784,20.770,-286,-0.124,41.292,1089,1118,13130
1993,5122,1784,1824,15507,15372,346,19.164,309,17.114,3750,1406,2344,9.147,24.395,3463,1691,1772,11.001,22.528,287,1.867,45.056,243,243,1312
1993,5151,6074,7970,225029,224137,801,10.123,687,8.682,29828,11275,18553,5.030,13.308,28160,10529,17631,4.698,12.564,1668,0.744,25.128,475,500,5411
1993,5152,210,347,13820,13310,63,18.448,52,15.227,2695,827,1868,6.214,20.249,1752,778,974,5.845,13.164,943,7.085,26.327,19,20,144
1993,5173,5562,27748,1018459,1026953,3219,11.615,3151,11.370,152346,55427,96919,5.397,14.835,167840,54425,113415,5.300,16.343,-15494,-1.509,29.670,526,551,5054
1993,5174,219,283,5285,5595,55,19.749,46,16.517,1065,272,793,4.861,19.035,1629,974,655,17.408,29.115,-564,-10.080,38.070,14,14,81
1993,5179,1271,1995,36153,37629,445,22.520,407,20.597,6549,2635,3914,7.003,17.404,9594,3536,6058,9.397,25.496,-3045,-8.092,34.808,125,125,863
1993,5182,5073,7191,276954,272828,856,11.790,995,13.704,51641,13768,37873,5.046,18.928,43136,13584,29552,4.979,15.811,8505,3.117,31.621,507,513,5347
1993,5191,2516,2911,37914,38108,304,10.532,255,8.834,7594,4989,2605,13.092,19.928,7979,5156,2823,13.530,20.938,-385,-1.010,39.855,135,204,4467
1993,5211,17,48,23944,24021,5,10.753,D,D,443,23,420,0.096,1.844,613,D,545,D,2.552,-170,-0.708,3.689,D,D,D
1993,5221,22238,96239,1921464,1976697,4432,4.491,9329,9.453,282642,77530,205112,3.922,14.299,398013,183305,214708,9.273,20.135,-115371,-5.837,28.597,771,1157,14423
1993,5222,13721,34924,452083,443470,5119,14.860,4167,12.096,113121,36842,76279,8.308,25.508,95577,45922,49655,10.355,21.552,17544,3.956,43.104,1220,1362,9479
1993,5223,8112,10569,97647,91391,2023,19.798,1321,12.928,27657,10233,17424,11.197,30.262,14880,6361,8519,6.960,16.282,12777,13.981,32.563,880,927,4106
1993,5231,6923,19240,325337,321137,3185,16.703,2842,14.904,62952,23605,39347,7.350,19.603,55919,24308,31611,7.569,17.413,7033,2.190,34.826,647,667,5156
1993,5232,37,51,6437,6458,7,14.583,D,D,267,41,226,0.635,4.135,313,D,312,D,4.847,-46,-0.712,8.269,D,D,D
1993,5239,18910,20488,167335,167303,3603,17.883,2922,14.503,39778,17798,21980,10.638,23.776,39731,19573,20158,11.699,23.748,47,0.028,47.496,2076,2086,8673
1993,5241,3948,36352,1527432,1536584,3192,8.650,4290,11.626,200994,53388,147606,3.474,13.081,219393,65556,153837,4.266,14.278,-18399,-1.197,26.161,174,230,2709
1993,5242,108072,118474,724859,716736,12895,10.998,10450,8.912,140940,54859,86081,7.654,19.664,123882,51005,72877,7.116,17.284,17058,2.380,34.568,7249,7369,29619
1993,5259,633,670,18279,17879,51,7.375,94,13.594,3386,719,2667,4.021,18.938,2538,1286,1252,7.193,14.195,848,4.743,28.391,69,69,364
1993,5311,90355,98122,518199,514637,11428,11.701,10522,10.773,106072,45158,60914,8.775,20.611,98499,42724,55775,8.302,19.140,7573,1.472,38.279,8055,8148,30421
1993,5312,39887,44613,210368,208491,7403,16.954,5508,12.614,52132,23785,28347,11.408,25.004,48645,18356,30289,8.804,23.332,3487,1.672,46.664,3809,3853,11991
1993,5313,31715,34818,368440,362299,5033,14.825,3298,9.714,77599,27976,49623,7.722,21.418,65611,18167,47444,5.014,18.110,11988,3.309,36.219,2332,2378,11236
1993,5321,4775,9410,135179,131919,841,8.835,1058,11.115,26926,5022,21904,3.807,20.411,20312,8096,12216,6.137,15.397,6614,5.014,30.795,578,624,3879
1993,5322,21250,29927,214564,208880,4018,13.448,3919,13.117,55173,21372,33801,10.232,26.414,44494,18440,26054,8.828,21.301,10679,5.113,42.602,2823,2913,12280
1993,5323,3838,5971,38356,39204,543,9.125,502,8.436,6854,2160,4694,5.510,17.483,8481,4000,4481,10.203,21.633,-1627,-4.150,34.966,313,318,1449
1993,5324,7187,9670,108740,107597,1101,11.336,1185,12.201,24054,6672,17382,6.201,22.356,21199,8345,12854,7.756,19.702,2855,2.653,39.405,721,732,4108
1993,5331,1419,1562,18169,19340,277,18.248,189,12.451,4385,1441,2944,7.451,22.673,6649,3861,2788,19.964,34.380,-2264,-11.706,45.346,132,132,1352
1993,5411,143834,150281,1004184,995693,15377,10.382,11052,7.462,137160,46659,90501,4.686,13.775,120051,32732,87319,3.287,12.057,17109,1.718,24.114,8220,8286,24681
1993,5412,77435,81741,764328,752541,9773,12.124,7513,9.320,129514,43415,86099,5.769,17.210,107347,32496,74851,4.318,14.265,22167,2.946,28.529,5443,5496,21627
1993,5413,65961,74238,953562,949020,9682,13.203,7866,10.727,161934,48711,113223,5.133,17.063,152576,39253,113323,4.136,16.077,9358,0.986,32.154,5365,5419,21303
1993,5414,18466,18712,105741,104480,3516,19.116,2877,15.642,27245,12590,14655,12.050,26.077,24793,10750,14043,10.289,23.730,2452,2.347,47.460,2255,2261,8578
1993,5415,29751,33940,472260,459965,7874,24.295,4814,14.853,113953,44341,69612,9.640,24.774,89635,30577,59058,6.648,19.487,24318,5.287,38.975,3171,3205,13709
1993,5416,41639,44172,372812,355848,8816,20.358,7082,16.354,109898,44510,65388,12.508,30.883,75816,33467,42349,9.405,21.306,34082,9.578,42.611,5358,5379,23972
1993,5417,7031,8925,457199,461963,1196,13.586,952,10.814,61946,16763,45183,3.629,13.409,72507,21608,50899,4.677,15.695,-10561,-2.286,26.819,506,514,2775
1993,5418,29038,31651,377333,370034,4817,15.117,5244,16.457,90491,36552,53939,9.878,24.455,74704,26734,47970,7.225,20.188,15787,4.266,40.377,3078,4440,21307
1993,5419,36118,41046,346912,337168,4336,10.726,3095,7.656,68999,19587,49412,5.809,20.464,49452,14070,35382,4.173,14.667,19547,5.797,29.334,2156,2338,9346
1993,5511,28308,51481,3161463,3191561,4487,8.557,6401,12.207,529770,131911,397859,4.133,16.599,590957,158958,431999,4.981,18.516,-61187,-1.917,33.198,853,895,11920
1993,5611,14360,15567,294480,285404,3310,22.156,2055,13.755,76733,37285,39448,13.064,26.886,58295,25462,32833,8.921,20.425,18438,6.460,40.851,1449,1459,14683
1993,5612,553,968,74539,71534,184,19.420,143,15.092,14038,6408,7630,8.958,19.624,7942,2957,4985,4.134,11.102,6096,8.522,22.205,31,31,610
1993,5613,19673,28084,1895589,1777770,4601,16.578,3941,14.200,643005,186849,456156,10.510,36.169,405477,140462,265015,7.901,22.808,237528,13.361,45.616,2484,2609,88661
1993,5614,23189,26536,378101,363045,4160,15.952,3246,12.447,91408,30850,60558,8.498,25.178,61171,19403,41768,5.345,16.849,30237,8.329,33.699,2498,2523,13783
1993,5615,24756,31380,245473,241242,3894,12.476,3560,11.406,50198,18525,31673,7.679,20.808,42139,16851,25288,6.985,17.468,8059,3.341,34.935,2279,2482,10837
1993,5616,13858,17107,555810,543291,2479,14.639,2134,12.601,109899,32982,76917,6.071,20.228,84511,29073,55438,5.351,15.555,25388,4.673,31.111,1476,1501,16957
1993,5617,96881,101253,1181358,1157773,17904,18.008,14239,14.322,282920,83373,199547,7.201,24.437,236263,80023,156240,6.912,20.407,46657,4.030,40.813,11030,11061,54599
1993,5619,15909,17325,260853,246920,3365,20.017,2337,13.902,70490,20749,49741,8.403,28.548,43424,14988,28436,6.070,17.586,27066,10.961,35.173,1877,1887,11668
1993,5621,6284,6783,98555,95790,804,12.024,611,9.138,17613,4565,13048,4.766,18.387,12083,5090,6993,5.314,12.614,5530,5.773,25.228,496,498,3463
1993,5622,1618,2469,85443,82162,306,12.606,223,9.186,16457,5102,11355,6.210,20.030,9972,3240,6732,3.943,12.137,6485,7.893,24.274,133,134,1265
1993,5629,4942,5319,63109,60231,757,14.444,601,11.467,17645,5498,12147,9.128,29.296,11878,3637,8241,6.038,19.721,5767,9.575,39.441,452,453,2322
1993,6111,14225,16131,549510,537387,703,4.372,597,3.713,60117,11216,48901,2.087,11.187,35808,6643,29165,1.236,6.663,24309,4.524,13.327,366,381,4624
1993,6112,584,871,72031,71633,45,5.062,81,9.111,8155,2071,6084,2.891,11.384,7174,1994,5180,2.784,10.015,981,1.369,20.030,24,32,971
1993,6113,2096,2507,1131948,1112480,115,4.623,76,3.055,91051,15047,76004,1.353,8.185,51767,2381,49386,0.214,4.653,39284,3.531,9.307,45,45,1457
1993,6114,3474,3911,47209,47043,747,19.676,518,13.644,10246,3015,7231,6.409,21.780,9872,4087,5785,8.688,20.985,374,0.795,41.970,335,358,2941
1993,6115,4844,5692,62585,62873,662,11.756,540,9.590,11089,3054,8035,4.857,17.637,11785,4759,7026,7.569,18.744,-696,-1.107,35.274,365,366,2552
1993,6116,15875,16909,134800,129238,3059,18.681,1990,12.153,35947,15091,20856,11.677,27.815,24827,10582,14245,8.188,19.210,11120,8.604,38.421,1526,1546,8407
1993,6117,2400,2495,20873,19752,496,20.475,351,14.489,5296,2429,2867,12.298,26.813,3169,1703,1466,8.622,16.044,2127,10.769,32.089,265,265,1334
1993,6211,180942,193695,1550061,1525868,13138,6.780,13273,6.850,246824,72375,174449,4.743,16.176,199289,61105,138184,4.005,13.061,47535,3.115,26.121,10727,10923,45739
1993,6212,102231,105176,577202,569224,4887,4.667,3941,3.764,78746,19253,59493,3.382,13.834,62811,13410,49401,2.356,11.035,15935,2.799,22.069,3134,3179,10686
1993,6213,67508,71353,311268,301454,8151,11.650,5381,7.691,67263,25681,41582,8.519,22.313,47888,16503,31385,5.474,15.886,19375,6.427,31.771,4011,4109,12609
1993,6214,8700,14365,293365,281214,1648,11.659,1189,8.411,60809,20850,39959,7.414,21.624,36435,12853,23582,4.571,12.956,24374,8.667,25.913,596,629,6186
1993,6215,5489,7770,133931,130395,1060,13.651,1050,13.522,28569,9533,19036,7.311,21.910,21497,9507,11990,7.291,16.486,7072,5.424,32.972,704,718,4728
1993,6216,6136,10612,593013,555690,2217,22.192,973,9.740,159800,57538,102262,10.354,28.757,86050,33373,52677,6.006,15.485,73750,13.272,30.971,500,516,11803
1993,6219,5573,7063,149576,141902,798,11.377,700,9.980,36742,14294,22448,10.073,25.893,21550,8213,13337,5.788,15.187,15192,10.706,30.373,484,493,4209
1993,6221,3105,4652,4185667,4160688,119,2.555,131,2.812,243683,30840,212843,0.741,5.857,195549,58552,136997,1.407,4.700,48134,1.157,9.400,55,55,19031
1993,6222,580,958,307288,314154,47,4.850,69,7.121,17176,2241,14935,0.713,5.467,30863,15574,15289,4.957,9.824,-13687,-4.357,10.935,19,20,4069
1993,6223,223,336,127385,125152,20,5.997,15,4.498,10085,1543,8542,1.233,8.058,5708,1345,4363,1.075,4.561,4377,3.497,9.122,9,9,811
1993,6231,8256,14340,1380494,1360086,767,5.354,738,5.152,145609,44580,101029,3.278,10.706,105132,42996,62136,3.161,7.730,40477,2.976,15.460,390,411,20768
1993,6232,6853,14243,302405,291990,1562,11.416,441,3.223,57926,19974,37952,6.841,19.838,36979,8045,28934,2.755,12.664,20947,7.174,25.329,214,220,3816
1993,6233,10424,12498,315179,310687,1557,12.553,1368,11.029,44685,14752,29933,4.748,14.383,35704,17021,18683,5.479,11.492,8981,2.891,22.984,798,809,8625
1993,6239,3943,5469,135534,131962,534,9.911,372,6.904,21474,6338,15136,4.803,16.273,14454,4536,9918,3.437,10.953,7020,5.320,21.906,187,188,2314
1993,6241,22179,30173,451222,435124,3517,11.997,1803,6.150,85701,25498,60203,5.860,19.696,53431,12560,40871,2.887,12.280,32270,7.416,24.559,1009,1030,6625
1993,6242,6001,7179,73973,72510,847,12.165,414,5.946,14485,5888,8597,8.120,19.977,11477,2086,9391,2.877,15.828,3008,4.148,31.656,238,240,985
1993,6243,5376,8323,300906,299268,744,9.008,617,7.470,49071,7392,41679,2.470,16.397,46092,5794,40298,1.936,15.402,2979,0.995,30.803,250,267,2147
1993,6244,40284,49140,508273,486319,6334,13.150,4385,9.104,107198,36247,70951,7.453,22.043,62920,24784,38136,5.096,12.938,44278,9.105,25.876,3255,3321,18043
1993,7111,6073,6152,90880,87764,1049,17.295,876,14.442,23866,7308,16558,8.327,27.193,17794,4747,13047,5.409,20.275,6072,6.919,40.550,650,651,2937
1993,7112,2669,2788,77943,78123,482,17.508,412,14.965,15367,4747,10620,6.076,19.670,15346,3146,12200,4.027,19.643,21,0.027,39.287,331,332,2305
1993,7113,2511,2591,52848,50175,414,16.296,313,12.320,13949,3367,10582,6.711,27.801,8674,2747,5927,5.475,17.287,5275,10.513,34.575,238,239,2075
1993,7114,1638,1681,14825,14559,287,17.527,200,12.214,4142,1656,2486,11.375,28.451,3575,1444,2131,9.919,24.556,567,3.895,49.112,142,142,940
1993,7115,7122,7201,43966,44419,1289,17.851,1329,18.405,14049,4113,9936,9.260,31.629,14810,5507,9303,12.398,33.342,-761,-1.713,63.257,859,860,3218
1993,7121,3214,3520,72138,69510,356,10.406,158,4.619,11065,1722,9343,2.477,15.919,5706,724,4982,1.042,8.209,5359,7.710,16.418,101,101,413
1993,7131,1630,2519,93766,93469,294,11.701,281,11.184,10434,3199,7235,3.423,11.163,9647,1479,8168,1.582,10.321,787,0.842,20.642,202,202,1010
1993,7132,1134,1267,50326,43428,274,23.270,95,8.068,17842,11407,6435,26.267,41.085,4039,775,3264,1.785,9.301,13803,31.784,18.601,73,74,660
1993,7139,40133,43281,706542,691271,5397,12.675,3998,9.389,130795,48082,82713,6.956,18.921,100162,31555,68607,4.565,14.490,30633,4.431,28.979,3036,3089,22822
1993,7211,30131,36762,1421583,1419856,3868,10.589,3402,9.313,196522,82074,114448,5.780,13.841,192320,83038,109282,5.848,13.545,4202,0.296,27.090,2256,2327,44092
1993,7212,4452,4766,31237,30604,519,11.025,402,8.540,6978,1991,4987,6.506,22.801,5684,1560,4124,5.097,18.573,1294,4.228,37.145,267,267,912
1993,7213,3177,3267,15606,15769,241,7.330,283,8.607,2517,690,1827,4.376,15.962,2872,886,1986,5.619,18.213,-355,-2.251,31.923,199,202,619
1993,7223,12403,21081,401398,394776,3141,15.015,2817,13.466,91125,42334,48791,10.724,23.083,79394,29035,50359,7.355,20.111,11731,2.972,40.222,2005,2022,18106
1993,7224,49753,50285,318809,312992,7377,14.796,6523,13.083,85726,46501,39225,14.857,27.389,74539,32575,41964,10.408,23.815,11187,3.574,47.630,5393,5408,27534
1993,7225,239687,327264,6043666,6001615,44347,13.650,39588,12.185,1164230,565142,599088,9.416,19.399,1077582,428650,648932,7.142,17.955,86648,1.444,35.910,26323,27338,254666
1993,8111,124764,134814,683822,673137,16762,12.551,14230,10.655,138546,56359,82187,8.373,20.582,117038,46379,70659,6.890,17.387,21508,3.195,34.774,10643,10778,35664
1993,8112,13037,15835,136726,138227,1957,12.402,1846,11.699,22128,7885,14243,5.704,16.008,25160,9529,15631,6.894,18.202,-3032,-2.193,32.017,1197,1205,4702
1993,8113,21716,23167,171815,170620,2465,10.642,2457,10.607,31198,9778,21420,5.731,18.285,28939,8922,20017,5.229,16.961,2259,1.324,33.922,1819,1825,6113
1993,8114,26020,27932,168573,169384,3687,13.175,3794,13.557,29235,11638,17597,6.871,17.260,30664,10274,20390,6.066,18.103,-1429,-0.844,34.519,2905,2932,7720
1993,8121,76116,87320,456509,455193,10847,12.438,10631,12.190,96089,40613,55476,8.922,21.110,94541,37759,56782,8.295,20.769,1548,0.340,41.539,8222,8402,27338
1993,8122,16593,20191,128792,129151,1111,5.478,1291,6.366,19962,4445,15517,3.442,15.456,20731,7390,13341,5.722,16.052,-769,-0.595,30.913,713,786,3419
1993,8123,34577,41539,386694,380433,4481,10.835,4118,9.957,63661,20476,43185,5.382,16.734,51410,18059,33351,4.747,13.514,12251,3.220,27.027,3068,3174,13613
1993,8129,14623,23992,170163,167465,3641,15.376,3015,12.733,37986,15302,22684,9.137,22.683,32373,15539,16834,9.279,19.331,5613,3.352,38.663,1503,1629,7166
1993,8131,140266,140371,1243106,1219377,7409,5.324,4976,3.576,150340,20256,130084,1.661,12.329,102871,13280,89591,1.089,8.436,47469,3.893,16.873,3346,3346,9208
1993,8132,10401,12145,149144,146843,935,7.757,751,6.231,23844,4057,19787,2.763,16.238,19442,3567,15875,2.429,13.240,4402,2.998,26.480,453,456,1867
1993,8133,9396,11085,120127,117632,954,8.691,737,6.714,22167,4186,17981,3.559,18.844,17091,3874,13217,3.293,14.529,5076,4.315,29.058,421,430,2138
1993,8134,31508,33277,324254,320041,1700,5.099,1832,5.494,45385,7605,37780,2.376,14.181,36966,6672,30294,2.085,11.550,8419,2.631,23.101,1310,1310,4626
1993,8139,63976,66251,524953,526797,4172,6.292,4282,6.458,74769,17411,57358,3.305,14.193,78477,20396,58081,3.872,14.897,-3708,-0.704,28.386,3059,3087,14610
1994,1131,239,271,2957,2703,47,18.077,25,9.615,844,535,309,19.793,31.225,357,105,252,3.885,13.208,487,18.017,26.415,21,21,89
1994,1132,114,129,1256,1292,25,20.080,16,12.851,226,105,121,8.130,17.499,308,81,227,6.272,23.848,-82,-6.349,34.998,12,12,75
1994,1133,11948,12035,84787,84024,1980,16.768,1527,12.931,19591,7617,11974,9.065,23.316,17821,5930,11891,7.058,21.210,1770,2.107,42.419,1161,1161,4381
1994,1141,1140,1150,10240,9923,184,16.162,161,14.141,4037,703,3334,7.085,40.685,3329,779,2550,7.851,33.550,708,7.135,67.100,119,119,685
1994,1142,201,206,1564,1535,33,16.377,24,11.911,227,87,140,5.670,14.793,176,81,95,5.279,11.470,51,3.324,22.939,19,19,66
1994,1151,4356,4648,59799,60335,551,11.921,499,10.796,13342,4136,9206,6.855,22.113,14258,4657,9601,7.719,23.631,-916,-1.518,44.226,341,341,2676
1994,1152,2364,2393,15334,14904,394,16.795,300,12.788,3377,1245,2132,8.354,22.659,2548,1034,1514,6.938,17.097,829,5.562,34.193,233,233,714
1994,1153,1043,1071,12995,12720,173,16.563,120,11.489,3071,867,2204,6.816,24.144,2544,842,1702,6.620,20.001,527,4.143,40.002,80,80,694
1994,2111,6732,8013,100470,100611,797,9.877,909,11.265,18144,7439,10705,7.394,18.034,18668,6964,11704,6.922,18.555,-524,-0.521,36.068,603,611,2465
1994,2121,1355,1872,102214,104120,268,13.966,362,18.864,16881,7927,8954,7.613,16.213,20623,9314,11309,8.945,19.807,-3742,-3.594,32.426,237,240,4011
1994,2122,356,514,42836,44170,64,12.296,77,14.793,3176,721,2455,1.632,7.190,5877,930,4947,2.106,13.305,-2701,-6.115,14.381,43,43,151
1994,2123,3320,4966,96612,96519,313,6.273,361,7.234,12119,2893,9226,2.997,12.556,12052,3497,8555,3.623,12.487,67,0.069,24.973,226,229,1657
1994,2131,7418,8429,146501,141851,1088,12.873,1133,13.406,37393,10479,26914,7.387,26.361,27819,8894,18925,6.270,19.611,9574,6.749,39.223,779,782,5122
1994,2211,1525,7059,601443,610745,332,4.746,204,2.916,31865,11721,20144,1.919,5.217,50441,5540,44901,0.907,8.259,-18576,-3.042,10.435,49,51,402
1994,2212,598,2764,107573,108226,166,5.988,182,6.566,8743,3672,5071,3.393,8.079,9872,1743,8129,1.611,9.122,-1129,-1.043,16.157,47,60,497
1994,2213,3952,4347,31953,31671,342,7.967,233,5.428,3529,1246,2283,3.934,11.143,3001,877,2124,2.769,9.476,528,1.667,18.951,170,170,551
1994,2361,117645,118142,600851,585891,24085,20.815,19217,16.608,190239,78946,111293,13.475,32.470,160209,64361,95848,10.985,27.345,30030,5.126,54.689,13733,13739,48709
1994,2362,35609,36265,598261,589269,4865,13.555,4118,11.473,137320,27620,109700,4.687,23.303,119551,27063,92488,4.593,20.288,17769,3.015,40.576,3032,3033,19413
1994,2371,14055,14354,313606,310493,1393,9.757,1240,8.685,64423,11052,53371,3.560,20.749,58899,11416,47483,3.677,18.970,5524,1.779,37.939,942,942,8062
1994,2372,7462,7660,57537,56130,1941,26.406,1322,17.985,17428,8372,9056,14.916,31.050,14706,6680,8026,11.901,26.200,2722,4.849,52.400,991,997,4603
1994,2373,9657,10074,222323,221962,998,9.976,858,8.577,43930,7325,36605,3.300,19.792,43147,8296,34851,3.738,19.439,783,0.353,38.878,619,627,5636
1994,2379,4676,4748,69262,67371,662,13.927,673,14.158,19414,4575,14839,6.791,28.817,15446,4035,11411,5.989,22.927,3968,5.890,45.854,514,515,2938
1994,2381,80346,80745,689534,678009,12476,15.695,9965,12.536,198558,56010,142548,8.261,29.285,175364,54409,120955,8.025,25.865,23194,3.421,51.729,7494,7499,43857
1994,2382,125006,126932,1248319,1210468,15653,12.516,11923,9.533,271682,62070,209612,5.128,22.444,195930,55606,140324,4.594,16.186,75752,6.258,32.373,8965,8968,41379
1994,2383,84314,84778,619993,603667,15426,18.495,12682,15.205,181506,57024,124482,9.446,30.067,149180,52693,96487,8.729,24.712,32326,5.355,49.425,9504,9509,42349
1994,2389,42222,42478,334970,333331,6196,14.822,4848,11.597,86427,22976,63451,6.893,25.928,83027,24279,58748,7.284,24.908,3400,1.020,49.817,3613,3614,17373
1994,3111,1148,1775,49038,48518,83,4.658,97,5.443,4748,1213,3535,2.500,9.786,3756,1223,2533,2.521,7.742,992,2.045,15.483,63,63,736
1994,3112,457,809,63356,64150,40,4.929,45,5.545,4165,1925,2240,3.001,6.493,5863,921,4942,1.436,9.140,-1698,-2.647,12.985,27,27,185
1994,3113,1540,1748,84372,85151,182,10.430,176,10.086,6991,1272,5719,1.494,8.210,8522,1794,6728,2.107,10.008,-1531,-1.798,16.420,125,127,817
1994,3114,1256,1696,174854,176865,109,6.412,117,6.882,16591,2074,14517,1.173,9.381,20522,5375,15147,3.039,11.603,-3931,-2.223,18.761,77,77,1486
1994,3115,1274,1830,132728,132777,100,5.426,126,6.837,10397,2167,8230,1.632,7.830,10594,2877,7717,2.167,7.979,-197,-0.148,15.661,78,78,716
1994,3116,3503,4110,419248,414597,263,6.357,317,7.663,36640,7050,29590,1.700,8.837,27147,6981,20166,1.684,6.548,9493,2.290,13.096,233,234,4319
1994,3117,627,735,44353,45198,60,7.984,93,12.375,6688,1763,4925,3.901,14.797,8220,2331,5889,5.157,18.187,-1532,-3.390,29.595,64,66,1319
1994,3118,9241,10343,308600,305805,1268,12.305,1192,11.567,37093,12412,24681,4.059,12.130,31508,10382,21126,3.395,10.303,5585,1.826,20.607,867,892,6128
1994,3119,2200,2568,135414,136091,237,9.238,232,9.043,16783,5236,11547,3.847,12.332,18200,7789,10411,5.723,13.373,-1417,-1.041,24.664,165,165,2206
1994,3121,1691,2113,127226,128802,175,8.327,152,7.233,10950,2826,8124,2.194,8.501,14006,2964,11042,2.301,10.874,-3056,-2.373,17.003,107,107,1212
1994,3122,75,109,33290,34573,11,10.329,6,5.634,1611,135,1476,0.390,4.660,4200,272,3928,0.787,12.148,-2589,-7.489,9.319,3,3,8
1994,3131,362,604,91621,91837,40,6.650,35,5.819,7572,1494,6078,1.627,8.245,8072,3624,4448,3.946,8.789,-500,-0.544,16.490,16,16,870
1994,3132,1664,2005,242929,243072,173,8.689,145,7.283,18242,3262,14980,1.342,7.505,18476,3174,15302,1.306,7.601,-234,-0.096,15.010,117,120,1805
1994,3133,5418,6086,145554,145127,573,9.387,609,9.977,18306,5190,13116,3.576,12.614,17441,6035,11406,4.158,12.018,865,0.596,24.035,449,455,4260
1994,3141,2925,3213,127223,124661,327,10.116,366,11.323,14840,2041,12799,1.637,11.904,9779,3230,6549,2.591,7.844,5061,4.060,15.689,289,293,1688
1994,3149,4075,4201,114969,113254,563,13.586,449,10.835,21394,7725,13669,6.821,18.890,17904,6289,11615,5.553,15.809,3490,3.082,31.617,364,364,4688
1994,3151,1127,1267,119766,120878,150,11.909,135,10.719,14508,4517,9991,3.737,12.002,16521,4326,12195,3.579,13.667,-2013,-1.665,24.004,117,118,2590
1994,3152,11038,12116,632992,654816,2282,18.749,2393,19.661,94785,40918,53867,6.249,14.475,138630,59988,78642,9.161,21.171,-43845,-6.696,28.950,2024,2037,43304
1994,3159,1852,1961,58170,58937,251,12.898,221,11.357,7268,2590,4678,4.395,12.332,8893,2521,6372,4.277,15.089,-1625,-2.757,24.664,181,181,1718
1994,3161,315,348,16740,16796,33,9.579,26,7.547,1583,705,878,4.197,9.425,1691,727,964,4.328,10.068,-108,-0.643,18.850,18,18,166
1994,3162,331,415,59894,61617,31,7.346,45,10.664,4692,527,4165,0.855,7.615,8262,3016,5246,4.895,13.409,-3570,-5.794,15.230,29,29,2088
1994,3169,1000,1041,32124,32188,95,8.908,146,13.690,4711,552,4159,1.715,14.636,4900,1797,3103,5.583,15.223,-189,-0.587,29.272,116,116,1101
1994,3211,4371,4879,135359,133295,436,8.951,420,8.622,17072,4369,12703,3.278,12.808,12882,3783,9099,2.838,9.664,4190,3.143,19.329,346,346,2398
1994,3212,1331,1638,103166,99986,119,7.325,92,5.663,12376,2273,10103,2.273,12.378,5951,1879,4072,1.879,5.952,6425,6.426,11.904,60,69,1235
1994,3219,9287,9999,287418,279164,1106,11.156,936,9.441,46317,12257,34060,4.391,16.591,29674,10400,19274,3.725,10.630,16643,5.962,21.259,740,741,7227
1994,3221,227,541,182954,184629,20,3.717,14,2.602,4681,774,3907,0.419,2.535,8064,1349,6715,0.731,4.368,-3383,-1.832,5.071,6,6,77
1994,3222,3562,5207,403177,402598,292,5.625,261,5.027,31961,8146,23815,2.023,7.939,30891,9082,21809,2.256,7.673,1070,0.266,15.346,168,173,3385
1994,3231,41034,43020,819962,819569,3309,7.633,3976,9.171,96092,25904,70188,3.161,11.725,94712,32604,62108,3.978,11.556,1380,0.168,23.113,3285,3295,21236
1994,3241,1090,2008,111437,111890,108,5.345,133,6.583,7436,1917,5519,1.713,6.646,8544,2869,5675,2.564,7.636,-1108,-0.990,13.292,59,60,912
1994,3251,1165,2363,206388,211920,136,5.780,116,4.930,11356,4822,6534,2.275,5.359,22087,8802,13285,4.153,10.422,-10731,-5.064,10.717,42,42,833
1994,3252,375,655,135811,134473,51,7.858,39,6.009,18987,14844,4143,11.039,14.120,16389,9260,7129,6.886,12.188,2598,1.932,24.375,20,20,138
1994,3253,636,886,38451,39030,71,8.064,60,6.814,2712,894,1818,2.291,6.949,3876,856,3020,2.193,9.931,-1164,-2.982,13.897,42,42,350
1994,3254,1138,1437,193585,190452,125,8.862,72,5.105,18717,2712,16005,1.424,9.828,12843,1729,11114,0.908,6.743,5874,3.084,13.487,41,41,727
1994,3255,1560,2020,72213,72029,116,5.721,131,6.461,6298,1187,5111,1.648,8.744,5985,1501,4484,2.084,8.309,313,0.435,16.618,89,91,557
1994,3256,2064,2292,123614,125138,194,8.498,176,7.709,11429,3107,8322,2.483,9.133,14465,4794,9671,3.831,11.559,-3036,-2.426,18.266,130,131,1546
1994,3259,2230,2936,130461,131261,189,6.451,177,6.041,9523,1494,8029,1.138,7.255,11259,2340,8919,1.783,8.578,-1736,-1.323,14.510,125,125,1246
1994,3261,10426,12617,730853,715010,994,7.949,768,6.142,93857,18729,75128,2.619,13.127,62300,19479,42821,2.724,8.713,31557,4.414,17.426,558,563,9573
1994,3262,2258,2762,194627,192545,187,6.778,181,6.560,16877,3787,13090,1.967,8.765,12767,3359,9408,1.745,6.631,4110,2.135,13.261,129,129,1249
1994,3271,1489,1763,77989,77238,193,10.991,179,10.194,8636,2254,6382,2.918,11.181,7052,2284,4768,2.957,9.130,1584,2.051,18.261,132,133,1246
1994,3272,1726,1984,133625,133443,187,9.440,181,9.137,10420,2267,8153,1.699,7.809,9933,3740,6193,2.803,7.444,487,0.365,14.887,135,135,1092
1994,3273,5879,8759,170114,167423,501,5.718,508,5.797,27273,6175,21098,3.688,16.290,21748,6095,15653,3.640,12.990,5525,3.300,25.980,278,290,2970
1994,3274,253,352,16917,16951,30,8.621,22,6.322,1101,154,947,0.909,6.495,1155,225,930,1.327,6.814,-54,-0.319,12.991,16,16,120
1994,3279,1953,2262,69291,68253,194,8.647,157,6.998,8129,2683,5446,3.931,11.910,6070,1759,4311,2.577,8.893,2059,3.017,17.787,109,110,843
1994,3311,270,348,156844,158798,42,12.463,20,5.935,4305,757,3548,0.477,2.711,8330,770,7560,0.485,5.246,-4025,-2.535,5.422,10,10,49
1994,3312,533,732,68607,68139,41,5.593,43,5.866,5421,1152,4269,1.691,7.956,4555,970,3585,1.424,6.685,866,1.271,13.370,28,28,216
1994,3313,328,482,78250,79358,28,5.858,20,4.184,4394,883,3511,1.113,5.537,6831,1067,5764,1.345,8.608,-2437,-3.071,11.074,10,10,161
1994,3314,766,929,73834,74036,56,5.954,79,8.400,5223,1214,4009,1.640,7.055,5662,1446,4216,1.953,7.648,-439,-0.593,14.109,56,56,534
1994,3315,2409,2671,202196,197964,152,5.693,150,5.618,22243,4406,17837,2.226,11.236,13869,4563,9306,2.305,7.006,8374,4.230,14.012,103,103,1689
1994,3321,3132,3327,135131,132976,164,4.913,186,5.572,16219,2840,13379,2.136,12.197,11771,2917,8854,2.194,8.852,4448,3.345,17.704,134,134,1268
1994,3322,1350,1485,76840,76047,99,6.698,85,5.751,6748,1620,5128,2.130,8.874,5141,998,4143,1.312,6.760,1607,2.113,13.521,58,58,527
1994,3323,10382,11137,325524,319452,825,7.413,810,7.278,47014,8801,38213,2.755,14.717,35003,10048,24955,3.145,10.957,12011,3.760,21.914,614,619,6045
1994,3324,1573,1897,107969,107547,123,6.494,117,6.177,11476,3276,8200,3.046,10.671,10687,2596,8091,2.414,9.937,789,0.734,19.874,65,67,805
1994,3325,923,1005,66629,66300,64,6.387,58,5.788,6261,1303,4958,1.965,9.443,5698,2302,3396,3.472,8.594,563,0.849,17.189,37,39,599
1994,3326,1546,1722,71971,70370,111,6.489,88,5.145,8340,1245,7095,1.769,11.852,5105,1480,3625,2.103,7.255,3235,4.597,14.509,66,66,458
1994,3327,22470,22817,348513,341139,1854,8.170,1608,7.086,50598,11410,39188,3.345,14.832,36074,11605,24469,3.402,10.575,14524,4.258,21.149,1286,1289,8115
1994,3328,5391,5802,136448,133516,390,6.746,349,6.036,18238,4158,14080,3.114,13.660,12497,3525,8972,2.640,9.360,5741,4.300,18.720,278,280,2345
1994,3329,5741,6244,302594,304052,460,7.369,456,7.305,27253,4674,22579,1.537,8.963,30122,7823,22299,2.573,9.907,-2869,-0.944,17.927,320,321,2955
1994,3331,2777,3028,195282,191753,237,7.857,214,7.094,21096,2772,18324,1.446,11.002,14232,4575,9657,2.386,7.422,6864,3.580,14.844,151,152,1640
1994,3332,4054,4301,158204,156125,298,6.908,324,7.510,19722,4752,14970,3.044,12.632,15649,5368,10281,3.438,10.023,4073,2.609,20.047,246,247,3316
1994,3333,2453,2581,132534,134617,199,7.730,186,7.225,13944,2957,10987,2.197,10.358,17784,2060,15724,1.530,13.211,-3840,-2.853,20.717,141,142,1016
1994,3334,1565,1814,156058,152506,132,7.289,126,6.957,18417,3099,15318,2.032,12.076,11346,2392,8954,1.568,7.440,7071,4.637,14.879,91,92,1307
1994,3335,9425,9752,214506,210468,652,6.711,579,5.960,27081,6906,20175,3.281,12.867,19083,5806,13277,2.759,9.067,7998,3.800,18.134,449,450,3206
1994,3336,761,914,120129,120231,40,4.357,48,5.229,9305,1104,8201,0.918,7.739,9225,618,8607,0.514,7.673,80,0.067,15.346,34,34,313
1994,3339,5518,6136,308028,305585,443,7.250,391,6.399,31848,4933,26915,1.614,10.422,26969,9039,17930,2.958,8.825,4879,1.597,17.651,268,269,2618
1994,3341,1668,1760,188998,189911,253,14.449,235,13.421,24467,5271,19196,2.776,12.883,26740,9156,17584,4.821,14.080,-2273,-1.197,25.767,179,181,3482
1994,3342,1783,1990,212892,215293,174,8.790,153,7.729,21581,2965,18616,1.377,10.024,26027,10318,15709,4.793,12.089,-4446,-2.065,20.048,117,117,1586
1994,3343,431,464,34337,34453,64,14.097,44,9.692,3439,647,2792,1.878,9.982,3625,1222,2403,3.547,10.522,-186,-0.540,19.964,32,33,673
1994,3344,5115,5651,478164,474986,576,10.282,478,8.533,58557,15307,43250,3.223,12.328,52563,14548,38015,3.063,11.066,5994,1.262,22.132,344,345,4833
1994,3345,4598,5204,511249,526910,350,6.721,357,6.855,35401,9298,26103,1.765,6.719,66058,15107,50951,2.867,12.537,-30657,-5.818,13.437,209,209,2466
1994,3346,741,795,45236,44464,110,13.986,93,11.825,6298,2141,4157,4.815,14.164,4699,1434,3265,3.225,10.568,1599,3.596,21.136,64,64,701
1994,3351,1150,1269,72580,71718,122,9.702,99,7.873,7464,1778,5686,2.479,10.408,5792,1630,4162,2.273,8.076,1672,2.331,16.152,71,71,883
1994,3352,316,387,104540,102889,21,5.364,30,7.663,9689,476,9213,0.463,9.417,6577,1774,4803,1.724,6.392,3112,3.025,12.785,20,20,1448
1994,3353,2239,2649,203126,201076,197,7.502,151,5.750,18268,3104,15164,1.544,9.085,14032,3126,10906,1.555,6.978,4236,2.107,13.957,101,102,983
1994,3359,1859,2228,190669,187412,129,5.782,135,6.051,20604,3846,16758,2.052,10.994,13967,4475,9492,2.388,7.453,6637,3.541,14.905,85,85,1303
1994,3361,279,336,222260,217417,48,14.590,34,10.334,22209,4248,17961,1.954,10.215,13087,1689,11398,0.777,6.019,9122,4.196,12.039,27,27,169
1994,3362,1712,1880,119543,114282,190,10.131,181,9.651,20988,3151,17837,2.757,18.365,10741,5183,5558,4.535,9.399,10247,8.966,18.797,143,145,3352
1994,3363,4357,5280,707330,686490,429,8.197,336,6.420,83058,16168,66890,2.355,12.099,42556,15070,27486,2.195,6.199,40502,5.900,12.398,247,247,3551
1994,3364,1366,1674,527103,567234,112,6.614,151,8.916,31292,16370,14922,2.886,5.517,111079,25289,85790,4.458,19.583,-79787,-14.066,11.033,96,96,779
1994,3365,172,222,27714,27141,13,5.909,9,4.091,2992,501,2491,1.846,11.024,1901,620,1281,2.284,7.004,1091,4.020,14.009,6,6,75
1994,3366,1387,1485,138963,139594,150,10.149,136,9.202,13243,1948,11295,1.395,9.487,14861,2075,12786,1.486,10.646,-1618,-1.159,18.974,103,103,1698
1994,3369,537,557,33016,33077,79,14.429,60,10.959,3934,960,2974,2.902,11.893,4085,546,3539,1.651,12.350,-151,-0.457,23.787,50,50,470
1994,3371,13395,13978,373944,368414,1706,12.173,1779,12.694,53014,15935,37079,4.325,14.390,42214,15362,26852,4.170,11.458,10800,2.931,22.917,1361,1372,10352
1994,3372,3254,3452,160678,154205,341,9.984,268,7.847,27247,10402,16845,6.746,17.669,14655,4436,10219,2.877,9.504,12592,8.166,19.007,205,206,3264
1994,3379,1066,1199,39471,39213,92,7.622,108,8.948,4866,1210,3656,3.086,12.409,4298,1387,2911,3.537,10.961,568,1.448,21.921,84,85,820
1994,3391,10749,11318,277116,279046,913,8.083,867,7.676,25987,5445,20542,1.951,9.313,30007,7111,22896,2.548,10.753,-4020,-1.441,18.626,642,644,3654
1994,3399,15789,16331,404983,402841,1936,11.970,1622,10.028,55250,14876,40374,3.693,13.715,50585,18902,31683,4.692,12.557,4665,1.158,25.114,1288,1291,10307
1994,4231,18526,22396,266678,262244,2140,9.551,2161,9.645,41197,12656,28541,4.826,15.709,32480,12968,19512,4.945,12.385,8717,3.324,24.771,1558,1591,7000
1994,4232,8650,9726,121150,120266,1078,11.073,1096,11.258,20005,4753,15252,3.952,16.634,18293,7584,10709,6.306,15.211,1712,1.424,30.421,817,835,5147
1994,4233,7939,10516,130493,127020,1122,10.771,924,8.870,21574,5696,15878,4.484,16.985,14576,4936,9640,3.886,11.475,6998,5.509,22.951,661,677,3585
1994,4234,27816,35987,592276,596129,4816,13.513,4124,11.571,98226,28496,69730,4.780,16.477,106031,37349,68682,6.265,17.787,-7805,-1.309,32.955,2566,2720,16850
1994,4235,6900,9260,135908,133278,763,8.250,740,8.001,18319,4402,13917,3.303,13.745,12955,4060,8895,3.046,9.720,5364,4.025,19.441,464,488,2236
1994,4236,18264,26498,338597,331246,3075,11.757,2389,9.134,62517,20921,41596,6.316,18.873,47666,15278,32388,4.612,14.390,14851,4.483,28.780,1426,1480,7276
1994,4237,10928,15406,172335,168948,1266,8.271,1068,6.977,25185,7727,17458,4.574,14.907,18422,6221,12201,3.682,10.904,6763,4.003,21.808,739,771,4613
1994,4238,47638,61685,655730,649463,5024,8.155,4864,7.895,89011,24371,64640,3.752,13.705,76470,25599,50871,3.942,11.774,12541,1.931,23.549,3193,3303,15151
1994,4239,26508,28588,294471,296401,3830,13.506,3371,11.887,56067,17646,38421,5.953,18.916,60285,19383,40902,6.539,20.339,-4218,-1.423,37.832,2611,2654,12597
1994,4241,9776,12747,200491,197281,1166,9.189,1049,8.267,26877,6946,19931,3.521,13.624,20372,6649,13723,3.370,10.326,6505,3.297,20.653,705,722,3594
1994,4242,3903,5102,142593,144610,784,15.733,546,10.957,21032,6854,14178,4.740,14.544,25192,7012,18180,4.849,17.421,-4160,-2.877,29.088,374,379,3322
1994,4243,10403,11180,135335,134279,1962,17.810,1634,14.833,28829,11035,17794,8.218,21.469,26560,9445,17115,7.034,19.780,2269,1.690,39.559,1329,1340,6709
1994,4244,27924,33971,725624,716665,3650,10.735,3713,10.920,103710,30210,73500,4.215,14.471,85400,34070,51330,4.754,11.916,18310,2.555,23.833,2711,2732,17224
1994,4245,6059,8949,78717,79782,524,5.790,725,8.011,10280,2786,7494,3.492,12.885,12447,4077,8370,5.110,15.601,-2167,-2.716,25.770,436,488,2524
1994,4246,8799,12666,144920,144532,1231,9.796,1031,8.205,23153,6922,16231,4.789,16.019,22438,8129,14309,5.624,15.525,715,0.495,31.049,583,592,3436
1994,4247,8357,11624,131881,131023,713,6.091,877,7.492,19032,5697,13335,4.348,14.526,17371,4937,12434,3.768,13.258,1661,1.268,26.516,510,533,2754
1994,4248,3399,4386,140646,139500,213,4.823,274,6.204,14709,3181,11528,2.280,10.544,12226,4913,7313,3.522,8.764,2483,1.780,17.528,179,194,2631
1994,4249,21297,25573,316078,311532,3235,12.725,2934,11.541,52433,15778,36655,5.065,16.831,43279,15979,27300,5.129,13.892,9154,2.938,27.785,2187,2211,10557
1994,4251,32855,35125,294358,293742,3765,10.841,2976,8.569,46147,14314,31833,4.873,15.710,44961,15769,29192,5.368,15.306,1186,0.404,30.613,2053,2072,10203
1994,4411,38859,41300,1010270,980042,4385,10.738,3460,8.473,137034,39311,97723,4.011,13.982,76703,29614,47089,3.022,7.827,60331,6.156,15.653,2728,2757,22684
1994,4412,10619,11350,83735,80799,1111,9.881,899,7.995,16305,4973,11332,6.155,20.180,10398,3459,6939,4.281,12.869,5907,7.311,25.738,671,676,2584
1994,4413,39282,58802,475319,464642,4696,8.009,4361,7.438,77832,28023,49809,6.031,16.751,55987,22059,33928,4.748,12.049,21845,4.701,24.099,2771,2936,12545
1994,4421,21343,27910,247842,243023,2952,10.612,2766,9.944,43373,16575,26798,6.820,17.847,34145,12822,21323,5.276,14.050,9228,3.797,28.100,1924,2058,8602
1994,4422,24067,32160,215533,210927,3703,11.641,3005,9.446,43596,18261,25335,8.657,20.669,34485,11190,23295,5.305,16.349,9111,4.320,32.699,2060,2141,6850
1994,4431,30431,46854,370894,356918,5932,12.839,4632,10.025,85535,40036,45499,11.217,23.965,56910,23279,33631,6.522,15.945,28625,8.020,31.890,3183,3319,15333
1994,4441,53366,72306,868017,847425,5296,7.337,5040,6.983,139408,56259,83149,6.639,16.451,98678,38199,60479,4.508,11.644,40730,4.806,23.289,3533,3652,17438
1994,4442,17443,21385,170306,168908,1611,7.534,1606,7.511,26197,6876,19321,4.071,15.510,23404,6712,16692,3.974,13.856,2793,1.654,27.712,1167,1183,4294
1994,4451,61506,90215,2517747,2485975,9177,10.150,9581,10.596,319046,146163,172883,5.880,12.834,255958,91266,164692,3.671,10.296,63088,2.538,20.592,6510,6657,41741
1994,4452,17686,22042,133583,133578,2933,13.302,2949,13.374,28707,12766,15941,9.557,21.491,28682,12125,16557,9.077,21.472,25,0.019,42.944,2192,2229,8845
1994,4453,23824,27964,134885,135359,2312,8.189,2848,10.088,23202,7659,15543,5.658,17.141,24298,9335,14963,6.896,17.951,-1096,-0.810,34.282,2118,2144,6377
1994,4461,45988,78013,775796,768537,7025,9.037,6464,8.316,118901,47715,71186,6.209,15.471,104074,44716,59358,5.818,13.542,14827,1.929,27.084,3971,4358,23409
1994,4471,73176,124064,916801,905395,9623,7.713,11011,8.826,169652,58685,110967,6.482,18.738,145468,59188,86280,6.537,16.067,24184,2.671,32.134,6728,6986,33611
1994,4481,45290,98417,1000162,1006978,10743,10.863,11701,11.832,170987,83677,87310,8.310,16.980,184429,58764,125665,5.836,18.315,-13442,-1.335,33.960,6557,7208,27199
1994,4482,8131,32497,179455,180309,2724,8.244,3812,11.537,35120,16374,18746,9.081,19.478,36126,15589,20537,8.646,20.036,-1006,-0.558,38.955,1044,1354,4754
1994,4483,19004,27622,154233,157676,2626,9.456,2921,10.519,26257,11616,14641,7.367,16.653,33759,11306,22453,7.170,21.410,-7502,-4.758,33.305,1739,1897,5975
1994,4511,31946,42969,343076,340687,5320,12.393,5235,12.195,66023,31961,34062,9.381,19.379,61293,24311,36982,7.136,17.991,4730,1.388,35.982,3501,3697,13857
1994,4512,9068,14680,113263,111817,1532,10.411,1601,10.880,22649,8086,14563,7.231,20.256,19862,7478,12384,6.688,17.763,2787,2.492,35.526,943,976,3267
1994,4522,126,6345,1057317,1053850,245,3.887,161,2.554,96528,29296,67232,2.780,9.160,90926,16363,74563,1.553,8.628,5602,0.532,17.256,3,4,68
1994,4523,10362,28478,1191911,1165101,2896,10.205,2697,9.504,173490,89882,83608,7.715,14.891,121871,41458,80413,3.558,10.460,51619,4.430,20.920,1252,1359,5783
1994,4531,23132,24493,120428,120854,2554,10.377,2793,11.348,21656,7892,13764,6.530,17.919,22638,7914,14724,6.548,18.732,-982,-0.813,35.838,2247,2282,6416
1994,4532,30464,40081,286194,279519,4763,11.869,4860,12.111,60094,24696,35398,8.835,21.499,46757,17999,28758,6.439,16.728,13337,4.771,33.455,3696,3811,12859
1994,4533,11951,15019,88858,86676,2155,14.560,1718,11.608,17442,7275,10167,8.393,20.123,13038,4262,8776,4.917,15.042,4404,5.081,30.084,1334,1344,2994
1994,4539,25896,30466,167843,161017,5126,17.224,3714,12.480,45486,22049,23437,13.694,28.249,31528,12818,18710,7.961,19.581,13958,8.669,39.161,2704,2784,9449
1994,4541,5492,6153,144845,140161,944,14.442,1711,26.176,32172,8489,23683,6.057,22.954,22394,9991,12403,7.128,15.977,9778,6.976,31.955,1448,1454,6988
1994,4542,4609,5468,69852,69701,748,13.843,619,11.456,9563,2633,6930,3.778,13.720,9152,3589,5563,5.149,13.130,411,0.590,26.261,408,409,1890
1994,4543,17830,24072,219705,217949,2442,10.197,2194,9.162,36901,13295,23606,6.100,16.931,33480,12629,20851,5.794,15.361,3421,1.570,30.723,1463,1483,7881
1994,4811,615,3047,444770,441338,427,14.433,250,8.450,29137,6295,22842,1.426,6.602,22242,3303,18939,0.748,5.040,6895,1.562,10.079,49,60,989
1994,4812,1241,1425,24958,23204,194,13.852,145,10.353,6096,1237,4859,5.331,26.271,2567,667,1900,2.875,11.063,3529,15.209,22.125,98,98,367
1994,4831,433,748,36526,36979,93,12.792,51,7.015,5104,1125,3979,3.042,13.802,6306,1566,4740,4.235,17.053,-1202,-3.250,27.605,30,30,237
1994,4832,305,335,12171,11856,53,16.134,40,12.177,2162,870,1292,7.338,18.235,1524,339,1185,2.859,12.854,638,5.381,25.709,26,26,123
1994,4841,26479,33872,714171,692457,5879,17.689,4607,13.861,132994,40379,92615,5.831,19.206,88791,37659,51132,5.438,12.823,44203,6.384,25.645,3442,3506,19852
1994,4842,45540,49086,467584,465527,7834,16.175,6529,13.480,95149,31243,63906,6.711,20.439,90916,37798,53118,8.119,19.530,4233,0.909,39.059,5055,5117,24337
1994,4851,409,491,26809,26363,67,13.772,58,11.922,3400,855,2545,3.243,12.897,2427,868,1559,3.293,9.206,973,3.691,18.413,49,49,516
1994,4852,288,503,20039,19689,82,15.385,142,26.642,4461,514,3947,2.611,22.657,3736,3001,735,15.242,18.975,725,3.682,37.950,21,21,65
1994,4853,5292,5428,54130,52354,948,17.730,786,14.700,12992,5336,7656,10.192,24.816,9491,4310,5181,8.232,18.129,3501,6.687,36.257,646,652,3496
1994,4854,3309,4279,137712,135253,407,9.615,315,7.442,18745,8084,10661,5.977,13.859,14345,5767,8578,4.264,10.606,4400,3.253,21.212,230,241,3292
1994,4855,1149,1263,26545,26034,165,13.237,132,10.590,5163,1519,3644,5.835,19.832,4168,1588,2580,6.100,16.010,995,3.822,32.020,100,103,1217
1994,4859,1820,1972,37596,35958,347,17.951,269,13.916,8457,2912,5545,8.098,23.519,5213,2550,2663,7.092,14.497,3244,9.022,28.995,230,230,1795
1994,4861,49,372,9567,9655,35,9.223,50,13.175,1403,823,580,8.524,14.531,1578,147,1431,1.523,16.344,-175,-1.813,29.063,3,3,9
1994,4862,151,1435,38268,39060,173,12.384,97,6.943,3744,1607,2137,4.114,9.585,5310,1437,3873,3.679,13.594,-1566,-4.009,19.171,16,16,110
1994,4869,58,421,6235,6143,92,23.291,40,10.127,1691,1522,169,24.776,27.527,1502,807,695,13.137,24.451,189,3.077,48.901,5,5,21
1994,4871,334,365,6954,6978,63,17.403,57,15.746,1195,370,825,5.303,17.126,1217,328,889,4.701,17.442,-22,-0.315,34.253,49,49,279
1994,4872,1205,1242,11684,11683,194,15.869,155,12.679,3044,880,2164,7.532,26.055,2980,840,2140,7.190,25.507,64,0.548,51.014,120,120,641
1994,4879,126,130,1138,1198,26,19.847,28,21.374,352,176,176,14.697,29.395,500,394,106,32.902,41.754,-148,-12.359,58.789,19,19,335
1994,4881,2574,3237,89565,87626,512,16.179,367,11.597,19232,6616,12616,7.550,21.948,15337,4165,11172,4.753,17.503,3895,4.445,35.006,233,235,1586
1994,4882,449,709,18486,17852,77,10.860,77,10.860,3589,1228,2361,6.879,20.104,2347,1003,1344,5.618,13.147,1242,6.957,26.294,44,49,555
1994,4883,2063,2630,82625,82910,270,10.301,252,9.615,14131,3397,10734,4.097,17.044,14555,4199,10356,5.065,17.555,-424,-0.511,34.088,180,181,2332
1994,4884,4571,4777,32844,31942,807,17.319,572,12.276,7627,3175,4452,9.940,23.878,5760,2721,3039,8.519,18.033,1867,5.845,36.066,439,446,1883
1994,4885,9249,12246,114950,112001,1818,15.211,1230,10.291,23630,9116,14514,8.139,21.098,17783,6512,11271,5.814,15.878,5847,5.220,31.755,871,928,4467
1994,4889,792,848,9956,9751,116,13.559,131,15.313,2164,820,1344,8.410,22.194,1778,869,909,8.912,18.235,386,3.959,36.470,111,111,782
1994,4921,1730,4567,379307,378247,464,10.139,483,10.554,28516,4991,23525,1.320,7.539,27879,4133,23746,1.093,7.371,637,0.168,14.741,225,230,1845
1994,4922,3727,4012,68783,66803,690,17.557,526,13.384,12417,3608,8809,5.401,18.588,8611,3521,5090,5.271,12.890,3806,5.697,25.780,433,436,2631
1994,4931,6338,10460,436459,432945,1004,9.647,898,8.629,71959,25642,46317,5.923,16.621,64851,21512,43339,4.969,14.979,7108,1.642,29.958,292,303,3471
1994,5111,15254,18008,678578,678873,2079,11.688,1639,9.214,63875,19386,44489,2.856,9.409,63689,21753,41936,3.204,9.382,186,0.027,18.763,1244,1249,7833
1994,5112,5774,6996,148996,144054,1165,17.051,838,12.265,31954,8182,23772,5.680,22.182,21782,9984,11798,6.931,15.121,10172,7.061,30.241,536,545,4386
1994,5121,10384,14751,216290,217116,2137,14.615,1878,12.844,47329,14554,32775,6.703,21.799,48811,19955,28856,9.191,22.482,-1482,-0.683,43.598,1066,1131,13338
1994,5122,1913,1951,14227,14811,392,20.686,280,14.776,3392,1569,1823,10.594,22.903,4520,2284,2236,15.421,30.519,-1128,-7.616,45.805,212,213,1176
1994,5151,6224,8124,244737,236592,909,11.288,767,9.524,45397,12750,32647,5.389,19.188,29989,11220,18769,4.742,12.675,15408,6.512,25.351,549,583,6791
1994,5152,219,379,14880,14348,70,19.204,41,11.248,2620,819,1801,5.708,18.260,1465,393,1072,2.739,10.210,1155,8.050,20.421,23,23,112
1994,5173,6053,28768,1018598,1019545,3825,13.532,2823,9.987,166153,62391,103762,6.119,16.297,169618,59352,110266,5.821,16.637,-3465,-0.340,32.594,630,683,5730
1994,5174,239,299,6010,5734,59,20.451,38,13.172,1792,989,803,17.248,31.252,1180,476,704,8.301,20.579,612,10.673,41.158,20,21,269
1994,5179,1484,2236,36969,36737,625,29.558,382,18.066,9027,3834,5193,10.436,24.572,8652,3929,4723,10.695,23.552,375,1.021,47.103,165,168,1008
1994,5182,4984,7105,284971,282982,852,11.905,955,13.345,49503,18594,30909,6.571,17.493,45963,18982,26981,6.708,16.242,3540,1.251,32.485,546,549,4218
1994,5191,2544,2984,40141,38950,271,9.197,196,6.652,5390,2109,3281,5.415,13.838,3018,948,2070,2.434,7.748,2372,6.090,15.497,144,144,677
1994,5211,15,45,22982,23797,D,D,D,D,339,D,293,D,1.425,1929,D,1925,D,8.106,-1590,-6.682,2.849,D,D,D
1994,5221,21398,98132,1961314,1940725,8340,8.584,6388,6.575,358983,185547,173436,9.561,18.497,314809,114689,200120,5.910,16.221,44174,2.276,32.442,735,1044,15360
1994,5222,15239,37374,491412,473591,6722,18.563,4396,12.140,126482,53057,73425,11.203,26.707,91527,44174,47353,9.327,19.326,34955,7.381,38.652,1233,1301,6209
1994,5223,8994,11767,113660,105884,2421,21.672,1229,11.002,37552,13878,23674,13.107,35.465,21991,10469,11522,9.887,20.769,15561,14.696,41.538,835,886,3786
1994,5231,7779,22631,381923,354171,6133,29.284,2757,13.164,95278,38786,56492,10.951,26.902,38811,19771,19040,5.582,10.958,56467,15.943,21.917,653,665,3514
1994,5232,34,48,6439,6438,8,16.495,9,18.557,300,140,160,2.175,4.660,298,50,248,0.777,4.629,2,0.031,9.258,5,5,12
1994,5239,17857,19679,171493,165618,3809,19.686,3149,16.275,43570,20212,23358,12.204,26.308,31793,16771,15022,10.126,19.197,11777,7.111,38.393,2354,2369,11812
1994,5241,4132,36916,1507057,1517681,4409,12.038,3831,10.459,217392,78364,139028,5.163,14.324,236339,89296,147043,5.884,15.572,-18947,-1.248,28.648,264,283,5272
1994,5242,105918,116645,683296,693298,11658,9.986,11851,10.151,111316,39079,72237,5.637,16.056,130625,63761,66864,9.197,18.841,-19309,-2.785,32.112,8832,8985,48099
1994,5259,613,655,19738,19008,60,9.036,78,11.747,3053,256,2797,1.347,16.062,1568,468,1100,2.462,8.249,1485,7.813,16.498,55,56,281
1994,5311,89464,97332,510960,513076,10288,10.542,10813,11.080,96631,43341,53290,8.447,18.834,101128,44334,56794,8.641,19.710,-4497,-0.876,37.667,8325,8455,31261
1994,5312,42331,47272,208672,208855,7900,17.149,5488,11.913,48795,21910,26885,10.491,23.363,49661,20785,28876,9.952,23.778,-866,-0.415,46.726,3904,3982,13271
1994,5313,34008,37646,392234,381073,6172,16.969,3625,9.966,84853,38474,46379,10.096,22.267,62937,21546,41391,5.654,16.516,21916,5.751,33.032,2593,2682,14501
1994,5321,4849,9690,129093,132659,1423,14.855,1201,12.538,20620,6388,14232,4.815,15.544,28308,7073,21235,5.332,21.339,-7688,-5.795,31.087,507,551,2824
1994,5322,20795,30114,231661,223649,4126,13.729,4004,13.323,58615,22557,36058,10.086,26.209,43440,18591,24849,8.313,19.423,15175,6.785,38.847,2923,3070,12698
1994,5323,3847,6167,40006,39374,624,10.276,435,7.163,7232,2522,4710,6.405,18.367,5885,2537,3348,6.443,14.946,1347,3.421,29.893,303,312,1875
1994,5324,7229,9832,112184,111637,1210,12.385,1085,11.106,23356,8900,14456,7.972,20.921,22172,10136,12036,9.079,19.861,1184,1.061,39.722,699,731,5835
1994,5331,1552,1698,18518,18256,350,21.413,223,13.643,4600,2417,2183,13.240,25.198,4063,2083,1980,11.410,22.256,537,2.942,44.513,145,149,671
1994,5411,147332,154065,1014781,1012098,15425,10.129,11860,7.788,131133,43801,87332,4.328,12.957,125721,36896,88825,3.645,12.422,5412,0.535,24.844,8792,8891,27618
1994,5412,79069,83518,752595,736408,9639,11.659,7946,9.612,151275,67863,83412,9.215,20.542,117247,37880,79367,5.144,15.921,34028,4.621,31.843,5707,5764,24124
1994,5413,68114,76682,976452,968380,10037,13.296,7648,10.131,166237,43900,122337,4.533,17.167,151191,43046,108145,4.445,15.613,15046,1.554,31.226,5306,5375,21952
1994,5414,19205,19450,104398,105106,3557,18.633,2837,14.861,26163,11953,14210,11.372,24.892,27402,14405,12997,13.705,26.071,-1239,-1.179,49.784,2196,2200,9410
1994,5415,33074,37467,495000,481751,8899,24.968,5248,14.724,120624,43618,77006,9.054,25.039,94270,38696,55574,8.032,19.568,26354,5.470,39.136,3489,3535,19634
1994,5416,44112,46799,424190,408022,9604,21.053,7243,15.877,111275,39638,71637,9.715,27.272,78355,31724,46631,7.775,19.204,32920,8.068,38.407,5462,5503,22693
1994,5417,7432,9343,458079,459076,1341,14.641,973,10.623,48682,10918,37764,2.378,10.604,50073,14490,35583,3.156,10.907,-1391,-0.303,21.209,568,577,2759
1994,5418,29884,32587,384319,381000,4807,14.967,3866,12.037,69116,23482,45634,6.163,18.141,62829,23028,39801,6.044,16.491,6287,1.650,32.981,3018,3052,15404
1994,5419,36983,42341,361686,355369,4380,10.503,3102,7.438,66030,22252,43778,6.262,18.581,53333,14374,38959,4.045,15.008,12697,3.573,30.016,2203,2231,10161
1994,5511,28436,51403,3152945,3168244,4773,9.270,4947,9.608,474538,144592,329946,4.564,14.978,506228,149745,356483,4.726,15.978,-31690,-1.000,29.956,951,1004,12657
1994,5611,15717,17117,318462,306469,3597,21.910,2197,13.382,86179,38030,48149,12.409,28.120,62290,29085,33205,9.490,20.325,23889,7.795,40.650,1684,1699,21480
1994,5612,616,1073,73562,74371,215,21.089,108,10.593,12958,4788,8170,6.438,17.424,14806,3386,11420,4.553,19.908,-1848,-2.485,34.847,34,40,506
1994,5613,20153,29465,2206813,2055405,5029,17.448,3744,12.990,731678,196864,534814,9.578,35.598,429045,147859,281186,7.194,20.874,302633,14.724,41.748,2483,2630,104647
1994,5614,24330,27805,408215,394537,4400,16.182,3173,11.669,95466,35802,59664,9.074,24.197,68086,24035,44051,6.092,17.257,27380,6.940,34.514,2469,2487,13664
1994,5615,25319,31905,261978,254382,3788,11.961,3315,10.468,53997,18834,35163,7.404,21.227,38685,17724,20961,6.967,15.207,15312,6.019,30.415,2184,2253,8809
1994,5616,14209,17492,567912,563315,2574,14.906,2126,12.312,97960,31789,66171,5.643,17.390,89005,35158,53847,6.241,15.800,8955,1.590,31.600,1560,1589,18489
1994,5617,100361,104996,1193544,1189187,18613,18.062,14723,14.287,270051,98515,171536,8.284,22.709,261488,90836,170652,7.638,21.989,8563,0.720,43.978,11713,11761,56925
1994,5619,17310,18873,282070,272297,3723,20.460,2370,13.024,72800,23787,49013,8.736,26.736,53339,22586,30753,8.295,19.589,19461,7.147,39.177,1838,1848,14025
1994,5621,6457,7005,105534,101494,855,12.405,630,9.140,19659,5806,13853,5.721,19.370,11561,4516,7045,4.450,11.391,8098,7.979,22.782,511,512,3192
1994,5622,1674,2585,93797,93273,324,12.738,241,9.475,13792,3801,9991,4.075,14.787,12891,4668,8223,5.005,13.821,901,0.966,27.642,139,142,2529
1994,5629,4956,5335,69408,66033,703,13.240,652,12.280,19512,4229,15283,6.404,29.549,12764,4285,8479,6.489,19.330,6748,10.219,38.660,499,501,2558
1994,6111,14444,16483,566614,554075,775,4.746,471,2.884,59901,10038,49863,1.812,10.811,34913,6594,28319,1.190,6.301,24988,4.510,12.602,322,322,4644
1994,6112,569,847,73624,72769,35,4.075,59,6.868,7704,509,7195,0.699,10.587,6073,1357,4716,1.865,8.346,1631,2.241,16.691,23,38,837
1994,6113,2113,2542,1165181,1156821,111,4.386,88,3.478,71697,2874,68823,0.248,6.198,55028,4802,50226,0.415,4.757,16669,1.441,9.514,53,53,4456
1994,6114,3871,4294,49001,48324,928,22.604,551,13.421,10812,3813,6999,7.890,22.374,9475,4457,5018,9.223,19.607,1337,2.767,39.214,379,417,2970
1994,6115,5008,5842,62587,62729,732,12.693,582,10.092,10812,3379,7433,5.387,17.236,11167,4044,7123,6.447,17.802,-355,-0.566,34.472,391,407,2174
1994,6116,16826,17871,140423,137528,3169,18.227,2199,12.648,32440,13603,18837,9.891,23.588,26614,9794,16820,7.121,19.352,5826,4.236,38.704,1704,1769,8133
1994,6117,2609,2717,23119,22578,582,22.269,375,14.349,5372,2449,2923,10.847,23.793,4309,1178,3131,5.217,19.085,1063,4.708,38.170,286,290,898
1994,6211,178243,192016,1566623,1553562,12849,6.657,14826,7.682,231116,74563,156553,4.799,14.877,205188,76402,128786,4.918,13.208,25928,1.669,26.415,11908,12120,55057
1994,6212,102997,106045,590572,584291,4937,4.672,4169,3.946,78449,18949,59500,3.243,13.426,65824,16457,49367,2.817,11.266,12625,2.161,22.531,3278,3334,13428
1994,6213,69354,73310,319405,316004,8078,11.165,6165,8.521,66610,26121,40489,8.266,21.079,60027,23811,36216,7.535,18.996,6583,2.083,37.991,4633,4781,15720
1994,6214,8815,15095,320300,307099,1806,12.245,1114,7.553,60726,24882,35844,8.102,19.774,33799,9962,23837,3.244,11.006,26927,8.768,22.012,693,746,6645
1994,6215,5419,8103,142116,139503,1269,15.966,959,12.066,26763,11720,15043,8.401,19.185,21361,9922,11439,7.112,15.312,5402,3.872,30.625,644,681,5097
1994,6216,6810,12130,679886,637246,2378,20.863,914,8.019,164453,58790,105663,9.226,25.807,80903,23004,57899,3.610,12.696,83550,13.111,25.391,530,577,10596
1994,6219,5497,7150,156418,154115,783,11.017,698,9.821,27513,8681,18832,5.633,17.852,23007,7957,15050,5.163,14.928,4506,2.924,29.857,516,531,4995
1994,6221,3012,4630,4164746,4172002,131,2.830,130,2.808,162693,24533,138160,0.588,3.900,175003,43724,131279,1.048,4.195,-12310,-0.295,7.799,83,85,28754
1994,6222,604,942,302614,304776,44,4.656,50,5.291,8783,1455,7328,0.477,2.882,13409,3560,9849,1.168,4.400,-4626,-1.518,5.764,5,6,274
1994,6223,248,370,129367,128550,40,11.315,7,1.980,7289,1485,5804,1.155,5.670,5647,270,5377,0.210,4.393,1642,1.277,8.786,4,4,186
1994,6231,8237,14471,1413929,1399754,825,5.710,779,5.392,152942,56789,96153,4.057,10.926,123916,50790,73126,3.628,8.853,29026,2.074,17.705,446,487,28600
1994,6232,7152,15681,322618,312764,1880,12.557,462,3.086,53280,20832,32448,6.661,17.035,33941,7518,26423,2.404,10.852,19339,6.183,21.704,267,277,4324
1994,6233,10747,12872,323164,319756,1734,13.651,1394,10.975,43542,15253,28289,4.770,13.617,36803,16631,20172,5.201,11.510,6739,2.108,23.019,900,963,11071
1994,6239,3984,5710,143618,139944,548,9.784,330,5.892,20296,4899,15397,3.501,14.503,12959,3742,9217,2.674,9.260,7337,5.243,18.520,225,231,2489
1994,6241,23389,32169,486492,472700,3720,11.895,1929,6.168,79789,26170,53619,5.536,16.879,52393,12024,40369,2.544,11.084,27396,5.796,22.168,1256,1281,6212
1994,6242,6272,7639,79976,77553,792,10.619,430,5.766,13824,4348,9476,5.607,17.825,8989,2219,6770,2.861,11.591,4835,6.234,23.182,308,309,1503
1994,6243,5442,8501,312997,310002,649,7.667,577,6.816,47042,7649,39393,2.467,15.175,41138,5967,35171,1.925,13.270,5904,1.905,26.541,304,319,2830
1994,6244,41905,51432,537143,524562,6544,12.999,4362,8.665,99829,38008,61821,7.246,19.031,74235,31231,43004,5.954,14.152,25594,4.879,28.304,3346,3433,17565
1994,7111,6355,6434,95432,93559,1166,18.523,888,14.106,22708,7444,15264,7.956,24.271,18933,5652,13281,6.041,20.236,3775,4.035,40.473,655,657,3917
1994,7112,2798,2909,79000,78945,542,18.984,434,15.201,13412,3807,9605,4.822,16.989,13471,4388,9083,5.558,17.064,-59,-0.075,33.978,308,316,2230
1994,7113,2612,2695,53145,52834,459,17.380,351,13.290,12336,4928,7408,9.327,23.349,11886,3757,8129,7.111,22.497,450,0.852,44.994,264,265,1689
1994,7114,1756,1799,14416,14629,316,18.171,196,11.271,2982,1144,1838,7.820,20.385,3432,1652,1780,11.293,23.461,-450,-3.076,40.770,143,143,1327
1994,7115,7197,7258,42698,43515,1348,18.634,1300,17.971,12515,4076,8439,9.367,28.761,14210,6338,7872,14.565,32.656,-1695,-3.895,57.521,848,853,3861
1994,7121,3396,3722,74160,73577,346,9.540,156,4.301,8078,1362,6716,1.851,10.979,7017,924,6093,1.256,9.537,1061,1.442,19.074,99,99,451
1994,7131,1627,2598,101105,96249,337,13.169,259,10.121,16735,4518,12217,4.694,17.387,7447,2176,5271,2.261,7.737,9288,9.650,15.475,198,201,1830
1994,7132,1260,1449,75622,63155,293,21.512,119,8.737,31048,14331,16717,22.692,49.162,5494,1861,3633,2.947,8.699,25554,40.462,17.398,84,84,1077
1994,7139,41412,44689,732861,721571,5631,12.795,4271,9.705,132250,51963,80287,7.201,18.328,109489,35479,74010,4.917,15.174,22761,3.154,30.347,3330,3417,28524
1994,7211,30794,37509,1472301,1455401,4132,11.104,3538,9.508,228192,100404,127788,6.899,15.679,192241,87019,105222,5.979,13.209,35951,2.470,26.418,2447,2506,52159
1994,7212,4594,4974,31979,31872,586,12.023,386,7.920,6514,2251,4263,7.063,20.438,6375,1455,4920,4.565,20.002,139,0.436,40.004,260,260,1027
1994,7213,3146,3239,15600,15559,246,7.566,271,8.335,2463,915,1548,5.881,15.831,2393,769,1624,4.943,15.381,70,0.450,30.761,196,196,602
1994,7223,11984,21356,415272,409580,2950,13.893,2704,12.735,85914,42800,43114,10.450,20.976,75244,26991,48253,6.590,18.371,10670,2.605,36.742,2118,2134,19409
1994,7224,49670,50182,321710,320826,7016,13.947,7264,14.440,84000,45193,38807,14.086,26.182,82275,37139,45136,11.576,25.645,1725,0.538,51.289,5967,5991,31571
1994,7225,244839,334773,6280808,6172418,46560,14.050,39796,12.009,1248587,675676,572911,10.947,20.228,1031577,421643,609934,6.831,16.713,217010,3.516,33.425,28779,29888,277756
1994,8111,127685,138081,721120,704003,17025,12.466,14009,10.258,148404,58423,89981,8.299,21.080,113868,45423,68445,6.452,16.174,34536,4.906,32.349,10786,10932,36022
1994,8112,13274,15929,132236,134136,1974,12.433,1871,11.784,23862,9183,14679,6.846,17.789,27780,10872,16908,8.105,20.710,-3918,-2.921,35.579,1240,1285,3836
1994,8113,21675,22906,177435,175169,2372,10.347,2411,10.517,31492,8644,22848,4.935,17.978,27052,10042,17010,5.733,15.443,4440,2.535,30.887,1840,1845,6865
1994,8114,25664,27343,163829,165859,3431,12.457,3830,13.906,28871,9021,19850,5.439,17.407,32874,13783,19091,8.310,19.820,-4003,-2.413,34.814,2966,2979,9484
1994,8121,75812,86695,448381,453667,10958,12.583,11740,13.481,87648,44507,43141,9.811,19.320,98028,42523,55505,9.373,21.608,-10380,-2.288,38.640,8755,9007,30261
1994,8122,16574,20763,138519,134019,1657,8.081,1140,5.560,28208,12511,15697,9.335,21.048,18930,5625,13305,4.197,14.125,9278,6.923,28.250,685,728,3408
1994,8123,34718,41699,379276,382674,4475,10.738,4429,10.627,56965,20975,35990,5.481,14.886,63218,23464,39754,6.132,16.520,-6253,-1.634,29.772,3243,3421,17153
1994,8129,14918,23788,174553,172708,3240,13.556,3465,14.498,38320,15599,22721,9.032,22.188,34065,14887,19178,8.620,19.724,4255,2.464,39.448,1666,1725,6903
1994,8131,143229,143343,1271560,1258218,7728,5.448,4754,3.351,152060,22888,129172,1.819,12.085,125826,15579,110247,1.238,10.000,26234,2.085,20.001,2983,2983,9790
1994,8132,10888,12662,154552,152635,930,7.418,680,5.424,20431,3482,16949,2.281,13.386,16469,3537,12932,2.317,10.790,3962,2.596,21.580,455,458,2028
1994,8133,9602,11327,123070,121869,942,8.397,725,6.463,18513,4117,14396,3.378,15.191,16081,3276,12805,2.688,13.195,2432,1.996,26.391,455,455,1945
1994,8134,31362,33193,324550,325124,1651,4.965,1772,5.329,39348,6941,32407,2.135,12.102,40234,7626,32608,2.346,12.375,-886,-0.273,24.205,1274,1276,4650
1994,8139,65037,67309,523064,523982,4846,7.252,3883,5.810,77119,22798,54321,4.351,14.718,78598,18989,59609,3.624,15.000,-1479,-0.282,29.436,2789,2811,13274
1995,1131,238,278,2796,2701,40,14.679,29,10.642,725,432,293,15.997,26.847,546,105,441,3.888,20.218,179,6.628,40.437,20,20,73
1995,1132,113,137,1407,1334,25,18.727,18,13.483,318,173,145,12.973,23.847,174,56,118,4.199,13.048,144,10.799,26.097,12,12,48
1995,1133,12131,12208,84894,84738,1789,14.766,1604,13.239,18771,6881,11890,8.120,22.152,18428,7909,10519,9.334,21.747,343,0.405,43.494,1187,1187,5501
1995,1141,1193,1203,8742,9388,227,19.295,174,14.790,2897,1713,1184,18.247,30.859,4168,1002,3166,10.673,44.397,-1271,-13.539,61.717,124,124,685
1995,1142,218,223,1768,1669,35,16.279,19,8.837,319,115,204,6.890,19.113,129,33,96,1.977,7.729,190,11.384,15.458,16,16,30
1995,1151,4444,4746,59120,59545,588,12.504,501,10.654,11753,3334,8419,5.599,19.738,12615,3940,8675,6.617,21.186,-862,-1.448,39.476,381,384,3330
1995,1152,2465,2501,15488,15152,431,17.599,327,13.352,3057,1272,1785,8.395,20.176,2387,919,1468,6.065,15.754,670,4.422,31.507,243,243,611
1995,1153,1132,1165,14025,13519,232,20.770,136,12.175,3081,905,2176,6.694,22.790,2106,502,1604,3.713,15.578,975,7.212,31.156,100,100,408
1995,2111,6495,7694,99688,99522,602,7.667,918,11.691,16576,6745,9831,6.777,16.656,15813,5161,10652,5.186,15.889,763,0.767,31.778,618,627,2192
1995,2121,1249,1740,95977,99082,232,12.835,367,20.304,15172,4936,10236,4.982,15.313,21559,9509,12050,9.597,21.759,-6387,-6.446,30.625,249,250,4203
1995,2122,337,491,43205,42868,48,9.562,70,13.944,3999,585,3414,1.365,9.329,3347,501,2846,1.169,7.808,652,1.521,15.615,46,46,329
1995,2123,3347,5032,99868,98119,369,7.383,301,6.022,14270,4034,10236,4.111,14.544,10741,2197,8544,2.239,10.947,3529,3.597,21.894,171,171,1241
1995,2131,7368,8372,145689,145915,1063,12.659,1113,13.255,31643,8431,23212,5.778,21.686,32542,12816,19726,8.783,22.302,-899,-0.616,43.372,747,750,5358
1995,2211,1545,7319,581636,592094,472,6.566,210,2.922,30106,9232,20874,1.559,5.085,51312,3537,47775,0.597,8.666,-21206,-3.582,10.169,41,42,604
1995,2212,602,2756,106535,107036,164,5.944,170,6.162,7798,3491,4307,3.262,7.285,8862,1398,7464,1.306,8.279,-1064,-0.994,14.571,26,26,135
1995,2213,4068,4477,33174,32713,347,7.864,218,4.941,3913,1374,2539,4.200,11.962,3024,1093,1931,3.341,9.244,889,2.718,18.488,167,167,509
1995,2361,122396,122990,641938,621338,24306,20.155,19518,16.185,194805,79818,114987,12.846,31.353,153582,63102,90480,10.156,24.718,41223,6.635,49.436,14156,14157,48768
1995,2362,37195,37887,638606,617236,5551,14.970,3940,10.625,149858,35284,114574,5.716,24.279,107175,30621,76554,4.961,17.364,42683,6.915,34.727,2979,2989,22627
1995,2371,14369,14664,333079,323075,1468,10.124,1140,7.862,67848,11576,56272,3.583,21.001,47665,9566,38099,2.961,14.754,20183,6.247,29.507,855,861,7022
1995,2372,8055,8246,62731,60305,1853,23.254,1298,16.289,18016,7363,10653,12.210,29.875,13234,5791,7443,9.603,21.945,4782,7.930,43.891,985,989,4430
1995,2373,9810,10222,232301,227228,1012,9.977,854,8.420,45965,7471,38494,3.288,20.229,35697,7678,28019,3.379,15.710,10268,4.519,31.420,635,641,5602
1995,2379,4682,4754,68153,67692,650,13.706,627,13.221,15487,3721,11766,5.497,22.879,14585,4545,10040,6.714,21.546,902,1.333,43.093,481,482,2859
1995,2381,83726,84116,738485,714541,13383,16.241,9958,12.084,203054,59026,144028,8.261,28.417,154856,48451,106405,6.781,21.672,48198,6.745,43.344,7631,7634,38691
1995,2382,130087,132030,1344559,1296445,16812,12.982,11748,9.072,291065,66368,224697,5.119,22.451,194583,54317,140266,4.190,15.009,96482,7.442,30.018,8913,8937,41702
1995,2383,88032,88523,664640,642234,16472,19.019,12646,14.601,187783,60509,127274,9.422,29.239,143179,51186,91993,7.970,22.294,44604,6.945,44.588,9719,9721,41646
1995,2389,44216,44486,354945,345257,6864,15.793,4817,11.083,91725,27281,64444,7.902,26.567,72586,23612,48974,6.839,21.024,19139,5.543,42.048,3657,3659,18164
1995,3111,1129,1763,47551,48035,91,5.163,90,5.106,3743,961,2782,2.001,7.792,4731,1343,3388,2.796,9.849,-988,-2.057,15.585,68,68,355
1995,3112,457,816,64083,63813,57,7.046,43,5.315,4723,950,3773,1.489,7.401,4273,1313,2960,2.058,6.696,450,0.705,13.392,22,22,171
1995,3113,1508,1696,84483,84405,142,8.261,188,10.937,9048,2675,6373,3.169,10.720,8563,2342,6221,2.775,10.145,485,0.575,20.290,128,131,860
1995,3114,1265,1692,177901,176669,109,6.429,116,6.842,17865,2343,15522,1.326,10.112,15270,2338,12932,1.323,8.643,2595,1.469,17.287,79,81,968
1995,3115,1260,1789,133447,133126,84,4.660,111,6.158,10206,1936,8270,1.454,7.666,9716,3032,6684,2.278,7.298,490,0.368,14.597,68,68,716
1995,3116,3442,4056,440352,430614,255,6.258,293,7.190,38747,4403,34344,1.022,8.998,19010,4776,14234,1.109,4.415,19737,4.583,8.829,231,231,3041
1995,3117,645,758,43289,43821,78,10.484,50,6.720,6268,1829,4439,4.174,14.304,7484,1388,6096,3.167,17.079,-1216,-2.775,28.608,36,36,532
1995,3118,9394,10433,312588,310323,1289,12.411,1195,11.506,38341,10940,27401,3.525,12.355,33917,12988,20929,4.185,10.930,4424,1.426,21.859,874,883,6917
1995,3119,2210,2584,136710,135989,226,8.782,205,7.966,14691,3449,11242,2.536,10.803,13324,3652,9672,2.686,9.798,1367,1.005,19.596,148,150,1815
1995,3121,1770,2174,130543,128419,211,9.878,135,6.320,14619,2251,12368,1.753,11.384,10401,3677,6724,2.863,8.099,4218,3.285,16.199,91,91,827
1995,3122,70,101,29004,31113,5,4.762,13,12.381,874,118,756,0.379,2.809,5079,617,4462,1.983,16.324,-4205,-13.515,5.618,9,9,31
1995,3131,374,617,89653,90580,39,6.383,27,4.419,5747,1223,4524,1.350,6.345,7571,1337,6234,1.476,8.358,-1824,-2.014,12.689,14,14,108
1995,3132,1689,2039,239354,240233,174,8.595,145,7.162,18803,5032,13771,2.095,7.827,20196,6936,13260,2.887,8.407,-1393,-0.580,15.654,115,115,2614
1995,3133,5436,6099,148927,147473,552,9.054,547,8.972,18975,4304,14671,2.919,12.867,16116,5440,10676,3.689,10.928,2859,1.939,21.856,440,449,3280
1995,3141,2911,3205,129217,128170,339,10.574,341,10.636,15210,4041,11169,3.153,11.867,12879,4047,8832,3.158,10.048,2331,1.819,20.097,283,283,3180
1995,3149,4169,4303,120081,117159,544,12.803,436,10.261,21020,5544,15476,4.732,17.942,15188,6150,9038,5.249,12.964,5832,4.978,25.927,361,361,4283
1995,3151,1124,1253,117529,118893,133,10.530,153,12.114,12850,1909,10941,1.606,10.808,15298,6274,9024,5.277,12.867,-2448,-2.059,21.616,124,124,2343
1995,3152,11046,12041,613791,622369,2155,17.845,2225,18.425,98364,38950,59414,6.258,15.805,114647,53084,61563,8.529,18.421,-16283,-2.616,31.610,1869,1876,34473
1995,3159,1876,1988,59083,58608,253,12.817,225,11.398,8574,2460,6114,4.197,14.630,7656,2160,5496,3.686,13.063,918,1.566,26.126,200,200,1761
1995,3161,303,332,16429,16499,18,5.302,33,9.720,1912,429,1483,2.600,11.589,2071,979,1092,5.934,12.553,-159,-0.964,23.178,21,21,289
1995,3162,331,412,56505,58201,31,7.515,32,7.758,4646,790,3856,1.357,7.983,8105,2080,6025,3.574,13.926,-3459,-5.943,15.965,20,21,550
1995,3169,1015,1055,31752,31958,111,10.576,100,9.528,4165,899,3266,2.813,13.033,4635,1419,3216,4.440,14.503,-470,-1.471,26.065,77,77,615
1995,3211,4324,4837,136711,135795,428,8.837,440,9.085,15409,4396,11013,3.237,11.347,13575,4270,9305,3.144,9.997,1834,1.351,19.993,346,347,2095
1995,3212,1375,1693,107504,105396,146,8.774,88,5.288,11969,3451,8518,3.274,11.356,7719,3024,4695,2.869,7.324,4250,4.032,14.648,62,63,1121
1995,3219,9446,10151,309632,297818,1145,11.407,919,9.155,51677,14434,37243,4.847,17.352,28167,10968,17199,3.683,9.458,23510,7.894,18.916,724,729,7037
1995,3221,225,547,180236,181279,28,5.195,12,2.226,4906,1768,3138,0.975,2.706,7060,632,6428,0.349,3.895,-2154,-1.188,5.413,7,7,210
1995,3222,3567,5247,412689,408155,281,5.378,237,4.536,35035,6944,28091,1.701,8.584,26023,5909,20114,1.448,6.376,9012,2.208,12.752,169,169,2346
1995,3231,40392,42325,838782,827218,3170,7.440,3736,8.768,102393,27692,74701,3.348,12.378,79536,29499,50037,3.566,9.615,22857,2.763,19.230,3141,3152,19865
1995,3241,1078,2005,110681,110988,94,4.694,89,4.444,6683,1053,5630,0.949,6.021,7154,825,6329,0.743,6.446,-471,-0.424,12.043,39,39,253
1995,3251,1177,2371,207071,206934,130,5.492,122,5.154,13288,3430,9858,1.658,6.421,12686,2662,10024,1.286,6.130,602,0.291,12.261,56,56,699
1995,3252,392,673,134127,134717,45,6.782,26,3.919,6364,1414,4950,1.050,4.724,7563,615,6948,0.457,5.614,-1199,-0.890,9.448,19,19,219
1995,3253,640,895,37912,38183,63,7.083,52,5.846,2767,677,2090,1.773,7.247,3373,833,2540,2.182,8.834,-606,-1.587,14.494,33,33,217
1995,3254,1138,1427,191567,192149,123,8.730,87,6.175,14074,3207,10867,1.669,7.325,15539,1956,13583,1.018,8.087,-1465,-0.762,14.649,55,55,471
1995,3255,1578,2039,73671,72912,117,5.765,98,4.829,7002,978,6024,1.341,9.603,5479,1631,3848,2.237,7.515,1523,2.089,15.029,66,66,462
1995,3256,2050,2270,122950,122952,168,7.393,173,7.613,10993,2397,8596,1.950,8.941,10902,2718,8184,2.211,8.867,91,0.074,17.734,121,121,916
1995,3259,2234,2929,132080,130992,202,6.904,196,6.699,12849,2104,10745,1.606,9.809,10544,2550,7994,1.947,8.049,2305,1.760,16.099,121,121,1046
1995,3261,10614,12883,768849,748963,1036,8.121,784,6.146,101186,19795,81391,2.643,13.510,61244,19031,42213,2.541,8.177,39942,5.333,16.354,539,544,10286
1995,3262,2289,2815,201709,198395,202,7.244,149,5.343,16699,3146,13553,1.586,8.417,10072,2134,7938,1.076,5.077,6627,3.340,10.154,112,112,1180
1995,3271,1524,1798,81508,79757,203,11.401,168,9.436,9700,2010,7690,2.520,12.162,6343,2396,3947,3.004,7.953,3357,4.209,15.906,129,130,992
1995,3272,1736,1999,136381,134920,196,9.864,172,8.656,11757,1776,9981,1.316,8.714,8596,2075,6521,1.538,6.371,3161,2.343,12.742,131,132,905
1995,3273,5762,8745,175837,172656,514,5.879,510,5.833,26127,5336,20791,3.091,15.132,19756,4832,14924,2.799,11.442,6371,3.690,22.885,318,321,2424
1995,3274,256,361,17544,17089,37,10.437,24,6.770,1868,937,931,5.483,10.931,937,303,634,1.773,5.483,931,5.448,10.966,18,18,268
1995,3279,1954,2272,71755,70558,190,8.392,174,7.686,8690,1644,7046,2.330,12.316,6116,2632,3484,3.730,8.668,2574,3.648,17.336,133,134,911
1995,3311,249,330,155936,156988,30,9.063,32,9.668,5191,670,4521,0.427,3.307,7187,2101,5086,1.338,4.578,-1996,-1.271,6.613,21,21,162
1995,3312,537,736,70953,69649,49,6.703,39,5.335,5907,899,5008,1.291,8.481,3361,1437,1924,2.063,4.826,2546,3.655,9.651,25,25,638
1995,3313,322,475,80737,79555,19,3.975,25,5.230,6570,836,5734,1.051,8.258,4247,1278,2969,1.606,5.338,2323,2.920,10.677,18,18,305
1995,3314,754,926,77975,75573,71,7.701,63,6.833,8259,1286,6973,1.702,10.929,3351,712,2639,0.942,4.434,4908,6.494,8.868,50,51,652
1995,3315,2402,2669,217122,209570,151,5.668,141,5.293,25021,2231,22790,1.065,11.939,9927,3517,6410,1.678,4.737,15094,7.202,9.474,106,106,1511
1995,3321,3111,3310,141870,137828,173,5.223,177,5.344,18574,3622,14952,2.628,13.476,10471,3432,7039,2.490,7.597,8103,5.879,15.194,142,142,1995
1995,3322,1357,1492,79955,78263,80,5.371,75,5.035,8146,981,7165,1.253,10.409,4841,2017,2824,2.577,6.186,3305,4.223,12.371,49,49,280
1995,3323,10450,11222,346386,335573,872,7.811,755,6.763,52414,9623,42791,2.868,15.619,30778,8017,22761,2.389,9.172,21636,6.447,18.344,607,612,5529
1995,3324,1566,1893,110552,108893,99,5.233,97,5.127,12423,2302,10121,2.114,11.408,9163,2748,6415,2.524,8.415,3260,2.994,16.829,64,65,1007
1995,3325,925,1016,69976,68598,69,6.811,63,6.219,6487,1393,5094,2.031,9.457,3756,1158,2598,1.688,5.475,2731,3.981,10.951,49,49,678
1995,3326,1558,1736,76598,74150,131,7.583,114,6.599,9447,1321,8126,1.782,12.740,4589,1132,3457,1.527,6.189,4858,6.552,12.378,91,91,842
1995,3327,23026,23390,381228,364313,2062,8.931,1456,6.307,60770,10716,50054,2.941,16.681,26852,8618,18234,2.366,7.371,33918,9.310,14.741,1163,1164,6034
1995,3328,5412,5831,145296,140578,403,6.944,348,5.996,21072,4718,16354,3.356,14.990,11676,4026,7650,2.864,8.306,9396,6.684,16.611,257,257,2332
1995,3329,5716,6220,310009,304940,448,7.214,429,6.908,34639,6957,27682,2.281,11.359,24647,6714,17933,2.202,8.083,9992,3.277,16.165,335,336,3120
1995,3331,2770,3032,202214,198095,225,7.445,205,6.784,20665,3869,16796,1.953,10.432,12674,2668,10006,1.347,6.398,7991,4.034,12.796,150,150,1063
1995,3332,4055,4301,172728,165612,270,6.284,261,6.075,25271,2949,22322,1.781,15.259,11102,2842,8260,1.716,6.704,14169,8.556,13.407,192,193,1697
1995,3333,2433,2560,126298,127918,211,8.234,216,8.429,12839,2317,10522,1.811,10.037,16428,4175,12253,3.264,12.843,-3589,-2.806,20.074,164,165,1808
1995,3334,1567,1822,165778,160593,113,6.226,99,5.455,20087,2544,17543,1.584,12.508,9565,3529,6036,2.197,5.956,10522,6.552,11.912,72,72,865
1995,3335,9587,9929,231652,222363,722,7.341,535,5.439,32750,6348,26402,2.855,14.728,14211,4493,9718,2.021,6.391,18539,8.337,12.782,414,414,2798
1995,3336,745,902,120601,120240,40,4.413,49,5.405,9958,1451,8507,1.207,8.282,9022,1241,7781,1.032,7.503,936,0.778,15.007,32,32,286
1995,3339,5617,6249,324858,315918,464,7.494,350,5.652,39400,7001,32399,2.216,12.472,21649,8158,13491,2.582,6.853,17751,5.619,13.705,264,264,3227
1995,3341,1625,1715,199928,193883,207,12.056,211,12.289,31819,4644,27175,2.395,16.411,19538,5140,14398,2.651,10.077,12281,6.334,20.154,163,163,2274
1995,3342,1811,2124,223620,217788,297,14.467,155,7.550,28901,4789,24112,2.199,13.270,17537,4666,12871,2.142,8.052,11364,5.218,16.105,108,108,1504
1995,3343,452,484,37926,36151,58,12.236,38,8.017,5440,437,5003,1.209,15.048,1863,450,1413,1.245,5.153,3577,9.895,10.307,31,31,417
1995,3344,5182,5731,511202,493513,588,10.374,462,8.151,72038,13269,58769,2.689,14.597,36584,9014,27570,1.826,7.413,35454,7.184,14.826,345,346,4404
1995,3345,4589,5190,492411,500103,384,7.406,374,7.213,44945,16008,28937,3.201,8.987,59570,15159,44411,3.031,11.912,-14625,-2.924,17.974,241,241,2842
1995,3346,773,827,49950,47571,116,14.330,81,10.006,7705,887,6818,1.865,16.197,3064,751,2313,1.579,6.441,4641,9.756,12.882,62,62,360
1995,3351,1171,1291,76269,74307,125,9.796,95,7.445,8886,1466,7420,1.973,11.958,4845,1497,3348,2.015,6.520,4041,5.438,13.040,71,72,597
1995,3352,334,403,106888,105718,44,11.153,27,6.844,8765,1748,7017,1.653,8.291,6371,1818,4553,1.720,6.026,2394,2.265,12.053,17,17,206
1995,3353,2256,2656,205235,203501,189,7.132,177,6.679,20795,4110,16685,2.020,10.219,17243,6320,10923,3.106,8.473,3552,1.745,16.946,117,117,1153
1995,3359,1820,2210,198085,193712,123,5.557,130,5.873,22376,3376,19000,1.743,11.551,13916,2516,11400,1.299,7.184,8460,4.367,14.368,92,93,1014
1995,3361,277,336,228599,225438,36,10.746,34,10.149,22711,6119,16592,2.714,10.074,16572,9439,7133,4.187,7.351,6139,2.723,14.702,27,28,204
1995,3362,1740,1907,132508,125644,189,10.003,154,8.150,21200,2866,18334,2.281,16.873,7513,1564,5949,1.245,5.980,13687,10.894,11.959,126,126,1190
1995,3363,4390,5359,742889,723577,412,7.758,315,5.932,86528,13595,72933,1.879,11.958,48611,11256,37355,1.556,6.718,37917,5.240,13.436,222,222,3917
1995,3364,1344,1628,474465,500321,113,6.878,143,8.704,14120,2230,11890,0.446,2.822,64913,12136,52777,2.426,12.974,-50793,-10.152,5.644,77,78,997
1995,3365,170,227,30273,28864,21,9.459,11,4.955,4906,1541,3365,5.339,16.997,2067,255,1812,0.883,7.161,2839,9.836,14.323,9,9,252
1995,3366,1392,1492,143493,145951,145,9.741,138,9.271,15122,1982,13140,1.358,10.361,19496,9263,10233,6.347,13.358,-4374,-2.997,20.722,109,109,2744
1995,3369,559,579,34661,33737,77,13.592,52,9.179,5938,1633,4305,4.840,17.601,4138,325,3813,0.963,12.265,1800,5.335,24.531,38,38,228
1995,3371,13383,13951,383152,379214,1688,12.091,1707,12.227,49308,12917,36391,3.406,13.003,41304,14457,26847,3.812,10.892,8004,2.111,21.784,1316,1328,11217
1995,3372,3334,3544,159598,156503,321,9.162,240,6.850,19375,3613,15762,2.309,12.380,13124,3261,9863,2.084,8.386,6251,3.994,16.772,192,193,2225
1995,3379,1056,1184,40429,39615,93,7.845,96,8.098,5561,1468,4093,3.706,14.038,4006,1496,2510,3.776,10.112,1555,3.925,20.225,70,70,696
1995,3391,10785,11349,274731,275771,952,8.404,910,8.033,31294,8281,23013,3.003,11.348,33271,12924,20347,4.686,12.065,-1977,-0.717,22.696,675,677,5255
1995,3399,16016,16571,424212,413721,1884,11.475,1580,9.623,64677,19961,44716,4.825,15.633,43039,13967,29072,3.376,10.403,21638,5.230,20.806,1300,1306,9920
1995,4231,18443,22438,279964,273149,2190,9.770,2146,9.574,44923,13996,30927,5.124,16.446,31374,12255,19119,4.487,11.486,13549,4.960,22.972,1564,1610,7456
1995,4232,8817,9925,128999,125375,1167,11.874,974,9.910,22059,5916,16143,4.719,17.594,14854,5188,9666,4.138,11.848,7205,5.747,23.695,753,762,3863
1995,4233,8232,10927,138230,134358,1249,11.615,901,8.379,22690,6490,16200,4.830,16.888,14962,4993,9969,3.716,11.136,7728,5.752,22.272,625,639,2924
1995,4234,28740,37063,612409,602077,4920,13.465,3872,10.597,106099,32914,73185,5.467,17.622,85640,27820,57820,4.621,14.224,20459,3.398,28.448,2606,2741,16596
1995,4235,7111,9495,144570,140493,819,8.710,634,6.743,20535,5316,15219,3.784,14.616,12542,4147,8395,2.952,8.927,7993,5.689,17.854,389,399,2368
1995,4236,18640,27059,366196,351924,3063,11.436,2513,9.382,75061,27261,47800,7.746,21.329,46735,18601,28134,5.286,13.280,28326,8.049,26.560,1442,1506,8591
1995,4237,11015,15636,178334,175523,1202,7.744,972,6.262,23763,5019,18744,2.859,13.538,18037,6199,11838,3.532,10.276,5726,3.262,20.552,673,699,3722
1995,4238,48293,62516,688187,672168,5149,8.288,4374,7.040,100068,25363,74705,3.773,14.887,68352,24946,43406,3.711,10.169,31716,4.718,20.338,2938,3075,14675
1995,4239,27232,29453,317597,306206,3950,13.621,3042,10.490,61567,18472,43095,6.033,20.106,38639,14364,24275,4.691,12.619,22928,7.488,25.237,2436,2453,10821
1995,4241,9783,12797,200747,200776,1161,9.099,1085,8.504,27221,8176,19045,4.072,13.558,27529,8875,18654,4.420,13.711,-308,-0.153,27.116,690,709,4326
1995,4242,4118,5476,149753,145777,905,17.108,533,10.076,27160,12347,14813,8.470,18.631,19332,6968,12364,4.780,13.261,7828,5.370,26.523,389,393,2638
1995,4243,10952,11752,141151,138005,2207,19.237,1648,14.365,30757,10461,20296,7.580,22.287,24586,9283,15303,6.727,17.815,6171,4.472,35.631,1363,1375,7155
1995,4244,27957,33943,740442,733705,3588,10.564,3634,10.699,104370,28245,76125,3.850,14.225,90380,36166,54214,4.929,12.318,13990,1.907,24.637,2709,2782,20440
1995,4245,5811,8667,77303,77987,407,4.622,683,7.757,9657,2322,7335,2.977,12.383,11063,4066,6997,5.214,14.186,-1406,-1.803,24.766,419,444,2805
1995,4246,9073,12929,151927,148255,1217,9.507,960,7.500,24525,7830,16695,5.281,16.542,16912,5468,11444,3.688,11.407,7613,5.135,22.815,546,554,2184
1995,4247,8246,11570,132964,132357,644,5.555,690,5.952,16928,4121,12807,3.114,12.790,15732,4138,11594,3.126,11.886,1196,0.904,23.772,428,452,2496
1995,4248,3383,4366,142058,141403,223,5.091,252,5.753,13292,3256,10036,2.303,9.400,11872,3814,8058,2.697,8.396,1420,1.004,16.792,178,199,2467
1995,4249,21950,26317,335761,326215,3550,13.675,2834,10.917,60535,20066,40469,6.151,18.557,41551,13989,27562,4.288,12.737,18984,5.819,25.475,2138,2177,9508
1995,4251,33884,36178,303677,297835,4024,11.295,2918,8.191,53692,16603,37089,5.575,18.027,42046,14846,27200,4.985,14.117,11646,3.910,28.234,2044,2054,9823
1995,4411,39873,42602,1061582,1036662,4430,10.545,3245,7.724,127575,37845,89730,3.651,12.306,77809,25826,51983,2.491,7.506,49766,4.801,15.011,2583,2606,20613
1995,4412,10848,11626,91319,87538,1121,9.755,853,7.423,17016,4423,12593,5.053,19.438,9487,3558,5929,4.065,10.838,7529,8.601,21.675,695,704,2888
1995,4413,39041,59461,493805,484010,4855,8.221,4050,6.858,76108,30504,45604,6.302,15.724,57327,20256,37071,4.185,11.844,18781,3.880,23.688,2675,2845,12763
1995,4421,21483,28238,257209,252291,2924,10.414,2602,9.267,44538,16982,27556,6.731,17.653,34743,14217,20526,5.635,13.771,9795,3.882,27.542,1808,1900,9149
1995,4422,24375,32672,224253,219818,3713,11.466,3135,9.681,45228,18972,26256,8.631,20.575,36055,13469,22586,6.127,16.402,9173,4.173,32.804,2022,2261,8362
1995,4431,31476,48449,410327,390350,6153,12.913,4558,9.565,98188,44912,53276,11.506,25.154,58942,24858,34084,6.368,15.100,39246,10.054,30.200,3076,3280,15473
1995,4441,53483,73341,924771,896430,5812,7.980,4792,6.580,152009,66846,85163,7.457,16.957,95729,34550,61179,3.854,10.679,56280,6.278,21.358,3394,3526,16531
1995,4442,17471,21424,175752,172911,1573,7.352,1514,7.077,27087,7110,19977,4.112,15.665,21358,6666,14692,3.855,12.352,5729,3.313,24.704,1075,1098,4271
1995,4451,61770,90074,2574474,2545198,9216,10.225,9324,10.345,337985,142602,195383,5.603,13.279,275920,104803,171117,4.118,10.841,62065,2.439,21.682,6223,6356,35279
1995,4452,17465,21744,135578,134633,2731,12.482,3001,13.716,28712,12329,16383,9.157,21.326,26794,12062,14732,8.959,19.902,1918,1.425,39.803,2152,2191,8442
1995,4453,23629,27691,135200,135746,2418,8.693,2668,9.592,21533,7911,13622,5.828,15.863,22573,8270,14303,6.092,16.629,-1040,-0.766,31.726,2037,2071,6310
1995,4461,45214,78642,804116,789032,7585,9.683,6974,8.903,140164,58164,82000,7.372,17.764,109599,48795,60804,6.184,13.890,30565,3.874,27.781,4145,4412,22223
1995,4471,72105,123117,923495,919629,8982,7.272,9772,7.912,157008,56219,100789,6.113,17.073,149822,57715,92107,6.276,16.292,7186,0.781,32.583,6341,6680,34504
1995,4481,43661,94222,963012,981531,10349,10.747,14493,15.051,171329,83535,87794,8.511,17.455,205617,108868,96749,11.092,20.949,-34288,-3.493,34.911,6365,7372,29600
1995,4482,7827,31513,186173,185191,2895,9.049,3855,12.050,39343,18545,20798,10.014,21.245,37910,16570,21340,8.948,20.471,1433,0.774,40.942,958,1060,4059
1995,4483,19009,28451,158326,156188,3414,12.179,2574,9.183,29109,12944,16165,8.287,18.637,24735,8937,15798,5.722,15.837,4374,2.800,31.673,1658,1730,5079
1995,4511,32141,43112,366716,355052,5202,12.084,5077,11.793,77197,30896,46301,8.702,21.742,52957,24632,28325,6.938,14.915,24240,6.827,29.831,3497,3645,13058
1995,4512,9076,14733,121829,117413,1786,12.134,1757,11.937,28771,16297,12474,13.880,24.504,19846,6745,13101,5.745,16.903,8925,7.601,33.806,1004,1048,3826
1995,4522,111,6314,1090191,1071698,210,3.332,186,2.951,106480,35426,71054,3.306,9.936,68778,16914,51864,1.578,6.418,37702,3.518,12.835,3,3,234
1995,4523,10385,28279,1291840,1244009,3024,10.640,3307,11.636,188439,106223,82216,8.539,15.148,93962,39891,54071,3.207,7.553,94477,7.595,15.106,1201,1370,5947
1995,4531,23153,24517,123759,122446,2551,10.407,2543,10.374,22944,7896,15048,6.449,18.738,20493,7126,13367,5.820,16.736,2451,2.002,33.473,2026,2059,5761
1995,4532,30401,40339,299674,293053,5045,12.551,4762,11.847,62341,29057,33284,9.915,21.273,49320,19641,29679,6.702,16.830,13021,4.443,33.659,3518,3673,13533
1995,4533,12393,15520,92151,90563,2280,14.934,1775,11.626,17016,7589,9427,8.380,18.789,13846,5555,8291,6.134,15.289,3170,3.500,30.578,1444,1469,4259
1995,4539,27098,32290,184645,176623,5490,17.470,3760,11.965,48259,22899,25360,12.965,27.323,32181,13155,19026,7.448,18.220,16078,9.103,36.440,2877,2979,10284
1995,4541,5880,6528,153511,149390,1108,17.479,730,11.516,27997,10142,17855,6.789,18.741,19756,6892,12864,4.613,13.224,8241,5.516,26.449,524,528,3920
1995,4542,4763,5561,71356,70348,690,12.498,610,11.049,9202,2938,6264,4.176,13.081,7111,2851,4260,4.053,10.108,2091,2.972,20.217,412,416,1689
1995,4543,18388,24817,231319,224908,2698,11.042,1930,7.899,42545,15617,26928,6.944,18.917,29870,11408,18462,5.072,13.281,12675,5.636,26.562,1394,1410,6991
1995,4811,648,3141,446352,444616,380,12.246,304,9.797,36534,7259,29275,1.633,8.217,33144,4541,28603,1.021,7.455,3390,0.762,14.909,76,88,1480
1995,4812,1298,1461,24855,25136,209,14.504,169,11.728,5404,1162,4242,4.623,21.499,6290,1003,5287,3.990,25.024,-886,-3.525,42.998,113,113,592
1995,4831,458,773,37587,36986,89,11.726,61,8.037,5827,1967,3860,5.318,15.755,4416,970,3446,2.623,11.940,1411,3.815,23.879,30,33,518
1995,4832,305,345,12625,12482,44,12.884,37,10.835,1850,425,1425,3.405,14.821,1527,143,1384,1.146,12.234,323,2.588,24.467,30,30,107
1995,4841,28479,36242,780052,746702,6762,19.280,4424,12.614,150585,48796,101789,6.535,20.167,84129,30627,53502,4.102,11.267,66456,8.900,22.533,3353,3392,17344
1995,4842,47452,51031,479936,474140,8452,16.871,6583,13.141,99393,34883,64510,7.357,20.963,88346,34831,53515,7.346,18.633,11047,2.330,37.266,5129,5175,24132
1995,4851,415,494,27940,27689,57,11.538,57,11.538,4265,1173,3092,4.236,15.404,3710,2222,1488,8.025,13.399,555,2.004,26.798,36,38,933
1995,4852,274,482,19370,19664,29,5.888,50,10.152,1856,562,1294,2.858,9.439,2478,333,2145,1.693,12.602,-622,-3.163,18.877,28,28,181
1995,4853,5360,5495,54915,54448,968,17.742,890,16.312,12661,5051,7610,9.277,23.254,11670,6004,5666,11.027,21.433,991,1.820,42.867,760,766,5318
1995,4854,3299,4292,143571,140448,353,8.234,343,8.001,21806,5113,16693,3.640,15.526,15290,6760,8530,4.813,10.887,6516,4.639,21.773,272,279,2701
1995,4855,1166,1275,28065,27315,135,10.622,127,9.992,4919,1360,3559,4.979,18.008,3454,1089,2365,3.987,12.645,1465,5.363,25.290,93,93,834
1995,4859,1897,2060,40495,38747,374,18.556,285,14.140,10172,4267,5905,11.013,26.253,6751,3529,3222,9.108,17.424,3421,8.829,34.847,223,224,2260
1995,4861,49,397,8905,9244,51,13.264,26,6.762,1282,707,575,7.649,13.869,1979,251,1728,2.715,21.410,-697,-7.540,27.738,3,3,4
1995,4862,149,1416,36074,37164,61,4.275,83,5.816,2023,435,1588,1.170,5.443,4166,686,3480,1.846,11.210,-2143,-5.766,10.887,12,14,156
1995,4869,60,564,6455,6195,164,33.435,17,3.466,1356,1099,257,17.740,21.889,866,116,750,1.872,13.979,490,7.910,27.958,3,3,9
1995,4871,337,373,7420,7077,58,15.761,48,13.043,1460,367,1093,5.186,20.630,780,243,537,3.434,11.022,680,9.609,22.043,37,37,210
1995,4872,1219,1253,12404,12051,180,14.417,171,13.696,2711,853,1858,7.078,22.496,2049,760,1289,6.307,17.003,662,5.493,34.005,123,123,420
1995,4879,133,136,1303,1222,22,16.479,17,12.734,321,142,179,11.625,26.279,151,38,113,3.111,12.362,170,13.917,24.724,14,14,33
1995,4881,2647,3420,96021,92545,564,16.950,379,11.390,19486,7742,11744,8.366,21.056,12553,5101,7452,5.512,13.564,6933,7.492,27.129,253,256,2074
1995,4882,467,751,19868,19182,111,15.216,68,9.321,4538,2162,2376,11.271,23.658,3118,1267,1851,6.605,16.255,1420,7.403,32.510,37,39,362
1995,4883,2054,2619,83393,82968,251,9.580,253,9.656,13496,3281,10215,3.955,16.267,12513,3307,9206,3.986,15.082,983,1.185,30.163,182,186,2326
1995,4884,4775,4976,35514,34212,765,15.663,581,11.896,8018,3454,4564,10.096,23.437,5422,2514,2908,7.348,15.848,2596,7.588,31.697,431,438,1659
1995,4885,9655,12835,125334,120095,1746,13.909,1182,9.416,26616,9684,16932,8.064,22.162,16214,6459,9755,5.378,13.501,10402,8.661,27.002,859,893,4249
1995,4889,796,843,10716,10535,123,14.513,132,15.575,2143,675,1468,6.408,20.343,1807,873,934,8.287,17.153,336,3.190,34.306,99,110,740
1995,4921,1756,4809,421316,400524,714,15.230,472,10.068,59335,9103,50232,2.273,14.814,17952,6590,11362,1.645,4.482,41383,10.332,8.964,288,291,2932
1995,4922,3947,4245,70738,69898,808,19.567,577,13.973,13294,4438,8856,6.349,19.019,11584,6293,5291,9.003,16.573,1710,2.446,33.145,483,485,3710
1995,4931,6429,10695,461708,448712,1021,9.651,790,7.467,80773,24452,56321,5.449,18.001,54723,14873,39850,3.315,12.196,26050,5.806,24.391,311,315,3704
1995,5111,15611,18390,687548,682612,2081,11.450,1650,9.079,67531,19841,47690,2.907,9.893,57149,20658,36491,3.026,8.372,10382,1.521,16.744,1272,1280,8250
1995,5112,6236,7690,168067,157852,1590,21.692,870,11.869,49507,24209,25298,15.337,31.363,28740,9362,19378,5.931,18.207,20767,13.156,36.414,532,543,5638
1995,5121,10886,15193,238658,227183,2175,14.521,1746,11.657,61122,31212,29910,13.739,26.904,39501,13044,26457,5.742,17.387,21621,9.517,34.775,1115,1154,8159
1995,5122,2032,2074,16329,15495,418,20.703,308,15.255,4688,2204,2484,14.224,30.256,3030,1428,1602,9.216,19.555,1658,10.701,39.111,248,248,911
1995,5151,6336,8274,243584,244187,972,11.859,816,9.956,36960,13925,23035,5.703,15.136,37467,12402,25065,5.079,15.344,-507,-0.208,30.272,587,633,8230
1995,5152,212,393,17050,15971,47,12.176,33,8.549,3254,698,2556,4.370,20.374,1153,434,719,2.717,7.219,2101,13.155,14.439,25,26,344
1995,5173,6611,29416,1039020,1028863,3552,12.206,2921,10.038,172403,57857,114546,5.623,16.757,152710,42360,110350,4.117,14.843,19693,1.914,29.685,745,788,8669
1995,5174,273,381,8020,7235,106,30.814,32,9.302,2962,1854,1108,25.625,40.940,1426,475,951,6.565,19.710,1536,21.230,39.419,19,19,260
1995,5179,1922,2623,40600,38674,801,32.882,427,17.529,12190,5735,6455,14.829,31.520,8518,4108,4410,10.622,22.025,3672,9.495,44.051,173,183,1191
1995,5182,5007,7797,322927,306838,1524,20.480,813,10.925,65961,26725,39236,8.710,21.497,34529,9943,24586,3.240,11.253,31432,10.244,22.506,455,458,4830
1995,5191,2613,3079,36975,38345,292,9.631,198,6.530,5197,2154,3043,5.617,13.553,8145,4821,3324,12.573,21.242,-2948,-7.688,27.107,156,157,936
1995,5211,14,46,22574,22805,D,D,3,6.452,459,D,454,D,2.013,948,81,867,0.355,4.157,-489,-2.144,4.026,3,3,81
1995,5221,20690,98830,1951727,1956795,6481,6.582,5740,5.830,241188,84093,157095,4.297,12.326,249491,79237,170254,4.049,12.750,-8303,-0.424,24.651,718,1477,22461
1995,5222,15449,39442,470139,480564,6694,17.431,4614,12.015,94365,48904,45461,10.176,19.636,115594,39386,76208,8.196,24.054,-21229,-4.418,39.273,1880,2008,14933
1995,5223,8512,11564,102556,107410,2142,18.370,2335,20.025,26230,14374,11856,13.382,24.421,35575,15097,20478,14.056,33.121,-9345,-8.700,48.841,1578,1646,10504
1995,5231,8221,24324,382106,380775,4115,17.545,2374,10.122,64653,26529,38124,6.967,16.979,61562,15614,45948,4.101,16.168,3091,0.812,32.335,794,833,5502
1995,5232,32,51,6636,6548,8,16.162,5,10.101,451,21,430,0.321,6.888,245,233,12,3.558,3.742,206,3.146,7.483,5,5,233
1995,5239,18436,20280,177024,173707,3417,17.109,2801,14.025,40753,18287,22466,10.527,23.461,33862,14663,19199,8.441,19.494,6891,3.967,38.987,1933,1953,7284
1995,5241,4258,37886,1472235,1487658,3971,10.617,3006,8.037,160476,52466,108010,3.527,10.787,190144,44433,145711,2.987,12.781,-29668,-1.994,21.574,293,317,5569
1995,5242,107228,118305,694442,690671,11632,9.900,10022,8.529,110352,41271,69081,5.975,15.978,103108,38662,64446,5.598,14.929,7244,1.049,29.857,7215,7353,25465
1995,5259,583,632,20382,19241,63,9.737,93,14.374,3430,1053,2377,5.473,17.827,1131,621,510,3.227,5.878,2299,11.948,11.756,59,59,215
1995,5311,89825,97927,514698,511903,10899,11.165,10276,10.527,96886,44411,52475,8.676,18.927,91593,41854,49739,8.176,17.893,5293,1.034,35.785,8085,8218,30636
1995,5312,43305,48518,214088,211291,7597,15.859,6370,13.297,49916,21680,28236,10.261,23.624,43893,18439,25454,8.727,20.774,6023,2.851,41.548,4635,4688,13109
1995,5313,34739,40082,400269,396601,6715,17.270,4315,11.098,86891,46289,40602,11.671,21.909,78620,23299,55321,5.875,19.823,8271,2.085,39.647,3059,3101,16292
1995,5321,4859,9868,136956,133288,1133,11.591,946,9.678,22103,5610,16493,4.209,16.583,14849,5321,9528,3.992,11.141,7254,5.442,22.281,547,579,2473
1995,5322,20553,30733,250051,239702,4417,14.523,3779,12.425,64240,22849,41391,9.532,26.800,44253,18810,25443,7.847,18.462,19987,8.338,36.923,2746,2993,13758
1995,5323,3869,6234,41642,40806,497,8.008,441,7.106,7063,1984,5079,4.862,17.309,5361,2126,3235,5.210,13.138,1702,4.171,26.276,297,319,1463
1995,5324,7347,9992,116640,114272,1155,11.649,1001,10.096,22692,6957,15735,6.088,19.858,18010,6466,11544,5.658,15.761,4682,4.097,31.521,627,654,3633
1995,5331,1670,1828,19796,18861,337,19.131,204,11.581,5589,2604,2985,13.806,29.633,3616,1540,2076,8.165,19.172,1973,10.461,38.344,145,145,783
1995,5411,150283,157020,1004705,1009750,15405,9.905,12433,7.994,123274,42605,80669,4.219,12.208,133408,38421,94987,3.805,13.212,-10134,-1.004,24.417,9257,9356,28440
1995,5412,80892,85577,795018,772684,10014,11.848,7902,9.349,141227,53811,87416,6.964,18.277,98077,30855,67222,3.993,12.693,43150,5.584,25.386,5769,5817,22621
1995,5413,71331,80342,1010437,993500,11030,14.047,7390,9.411,180057,54989,125068,5.535,18.124,146162,44223,101939,4.451,14.712,33895,3.412,29.424,5094,5175,24671
1995,5414,20291,20527,112479,108967,3833,19.144,2823,14.099,28407,11785,16622,10.815,26.069,21134,10182,10952,9.344,19.395,7273,6.674,38.790,2215,2220,7790
1995,5415,38203,43214,566476,530456,11170,27.675,5464,13.538,158464,64543,93921,12.167,29.873,85873,33123,52750,6.244,16.189,72591,13.685,32.377,3646,3703,16136
1995,5416,46798,49703,455886,439993,10161,21.073,7190,14.912,114569,41539,73030,9.441,26.039,82480,30896,51584,7.022,18.746,32089,7.293,37.492,5527,5579,23106
1995,5417,7880,9911,456728,457687,1481,15.376,923,9.583,54296,17928,36368,3.917,11.863,56671,16294,40377,3.560,12.382,-2375,-0.519,23.726,558,561,3459
1995,5418,30924,33770,401987,393615,4996,15.055,3824,11.524,76583,23027,53556,5.850,19.456,59801,22355,37446,5.679,15.193,16782,4.264,30.386,3004,3049,14730
1995,5419,38044,43585,379585,370102,4338,10.092,3134,7.291,73556,20077,53479,5.425,19.875,54704,17550,37154,4.742,14.781,18852,5.094,29.562,2193,2221,10595
1995,5511,28612,51852,3215254,3182490,4916,9.525,4437,8.597,525160,169780,355380,5.335,16.502,460457,129231,331226,4.061,14.468,64703,2.033,28.937,998,1034,14647
1995,5611,17037,18484,337929,329570,3711,20.851,2339,13.142,90906,37092,53814,11.255,27.583,73557,39900,33657,12.107,22.319,17349,5.264,44.638,1793,1810,23769
1995,5612,692,1248,75128,74110,263,22.624,92,7.914,15187,7284,7903,9.829,20.493,13176,4920,8256,6.639,17.779,2011,2.714,35.558,33,34,502
1995,5613,21299,32118,2522034,2364041,6071,19.738,3352,10.898,803868,302780,501088,12.808,34.004,485497,141655,343842,5.992,20.537,318371,13.467,41.073,2260,2337,94603
1995,5614,25191,28962,453319,430072,4556,16.061,3364,11.859,107950,38658,69292,8.989,25.100,61379,18922,42457,4.400,14.272,46571,10.829,28.544,2621,2648,12459
1995,5615,26023,32598,275683,269988,3877,12.018,3199,9.917,50263,18509,31754,6.856,18.617,39603,15505,24098,5.743,14.668,10660,3.948,29.337,2175,2459,12008
1995,5616,14576,17970,603109,585482,2609,14.718,2121,11.965,120965,36431,84534,6.222,20.661,84978,27474,57504,4.693,14.514,35987,6.147,29.028,1573,1588,15209
1995,5617,105995,110740,1252849,1224134,20412,18.918,14721,13.644,277207,95514,181693,7.803,22.645,220015,80029,139986,6.538,17.973,57192,4.672,35.946,11737,11759,57669
1995,5619,18748,20393,301766,292322,3932,19.999,2468,12.553,79804,28065,51739,9.601,27.300,60727,20732,39995,7.092,20.774,19077,6.526,41.548,1951,1976,13276
1995,5621,6598,7194,113384,108375,868,12.259,641,9.053,21184,5975,15209,5.513,19.547,11208,4109,7099,3.791,10.342,9976,9.205,20.684,532,532,3173
1995,5622,1728,2704,98925,97413,325,12.184,252,9.447,14235,3908,10327,4.012,14.613,11155,3391,7764,3.481,11.451,3080,3.162,22.903,158,165,1338
1995,5629,5080,5496,69714,69720,791,14.640,605,11.197,15578,4832,10746,6.931,22.344,15469,4778,10691,6.853,22.187,109,0.156,44.375,460,461,2474
1995,6111,14670,16829,589912,576551,794,4.765,460,2.761,59127,9796,49331,1.699,10.255,32460,5951,26509,1.032,5.630,26667,4.625,11.260,326,326,4457
1995,6112,555,830,73444,73882,33,3.933,51,6.079,4992,610,4382,0.826,6.757,5934,776,5158,1.050,8.032,-942,-1.275,13.513,32,43,637
1995,6113,2138,2573,1178711,1170288,126,4.931,91,3.561,68939,2090,66849,0.179,5.891,52235,2542,49693,0.217,4.463,16704,1.427,8.927,60,62,1500
1995,6114,4251,4676,51149,50157,962,21.413,595,13.244,12314,4956,7358,9.881,24.551,10364,4721,5643,9.412,20.663,1950,3.888,41.326,415,459,3593
1995,6115,5139,5974,64708,63668,689,11.663,556,9.412,11740,4357,7383,6.843,18.439,9704,3073,6631,4.827,15.242,2036,3.198,30.483,390,409,2265
1995,6116,17932,19092,148937,145875,3368,18.227,2140,11.581,35384,16302,19082,11.175,24.256,28895,9932,18963,6.809,19.808,6489,4.448,39.616,1699,1710,8015
1995,6117,2745,2877,26217,24710,571,20.404,414,14.794,6342,2790,3552,11.291,25.666,3400,1361,2039,5.508,13.760,2942,11.906,27.519,314,316,1092
1995,6211,173698,189095,1606756,1587554,13692,7.186,16563,8.693,265127,97115,168012,6.117,16.700,226610,95564,131046,6.020,14.274,38517,2.426,28.548,13301,13644,72082
1995,6212,104016,107210,613520,602052,5074,4.759,3902,3.660,83048,20668,62380,3.433,13.794,59960,15009,44951,2.493,9.959,23088,3.835,19.919,3197,3248,12678
1995,6213,71329,75629,346690,333064,8515,11.434,6204,8.330,80929,35394,45535,10.627,24.298,53901,20476,33425,6.148,16.183,27028,8.115,32.367,4724,4841,16582
1995,6214,8928,15898,349550,335508,1977,12.771,1141,7.371,69999,28716,41283,8.559,20.864,41807,11583,30224,3.452,12.461,28192,8.403,24.922,708,780,7070
1995,6215,5327,8330,144818,142392,1259,15.333,1021,12.435,29075,12870,16205,9.038,20.419,23775,13656,10119,9.590,16.697,5300,3.722,33.394,672,715,7703
1995,6216,7726,13667,744485,710040,2811,21.776,1295,10.032,178400,66450,111950,9.359,25.125,110419,35101,75318,4.944,15.551,67981,9.574,31.102,611,637,11349
1995,6219,5397,7216,164942,160923,777,10.816,712,9.912,30629,9084,21545,5.645,19.033,22423,9235,13188,5.739,13.934,8206,5.099,27.868,529,538,6468
1995,6221,2915,4621,4119461,4132507,142,3.077,129,2.796,184300,44740,139560,1.083,4.460,209690,49015,160675,1.186,5.074,-25390,-0.614,8.920,73,75,33462
1995,6222,596,929,300463,301751,55,5.867,72,7.680,13827,2842,10985,0.942,4.582,16278,6626,9652,2.196,5.395,-2451,-0.812,9.165,22,23,2229
1995,6223,256,384,131461,130594,27,7.162,13,3.448,8753,1695,7058,1.298,6.702,6753,2836,3917,2.172,5.171,2000,1.531,10.342,8,8,2098
1995,6231,8246,14668,1458710,1435149,980,6.732,757,5.200,162724,61212,101512,4.265,11.338,116492,53492,63000,3.727,8.117,46232,3.221,16.234,466,502,30748
1995,6232,7511,17076,341698,332049,1835,11.193,470,2.867,53461,18405,35056,5.543,16.100,34293,7156,27137,2.155,10.328,19168,5.773,20.655,284,299,5029
1995,6233,11249,13457,337490,330668,1885,14.317,1303,9.897,46571,17029,29542,5.150,14.084,32933,14691,18242,4.443,9.960,13638,4.124,19.919,896,957,11460
1995,6239,4032,5947,152578,147471,548,9.398,316,5.419,21515,6900,14615,4.679,14.589,11349,3487,7862,2.365,7.696,10166,6.894,15.392,193,199,1833
1995,6241,24699,34115,527700,507348,3834,11.571,1875,5.659,88740,27399,61341,5.400,17.491,48257,9770,38487,1.926,9.512,40483,7.979,19.023,1279,1306,6555
1995,6242,6474,7948,81084,80301,782,10.046,454,5.832,13362,4388,8974,5.464,16.640,11653,2881,8772,3.588,14.512,1709,2.128,29.023,322,327,1407
1995,6243,5475,8589,319998,316540,582,6.807,503,5.883,44760,7280,37480,2.300,14.140,37968,4619,33349,1.459,11.995,6792,2.146,23.989,281,300,2469
1995,6244,43586,53605,568006,552582,6741,12.836,4567,8.696,100590,39566,61024,7.160,18.204,69670,23883,45787,4.322,12.608,30920,5.596,25.216,3598,3657,18853
1995,7111,6722,6801,96002,95812,1248,18.851,887,13.398,21962,8975,12987,9.367,22.922,21512,5212,16300,5.440,22.452,450,0.470,44.905,625,629,4005
1995,7112,2841,2958,77891,78662,479,16.326,431,14.690,12692,3582,9110,4.554,16.135,14264,2906,11358,3.694,18.133,-1572,-1.998,32.270,339,341,2251
1995,7113,2681,2772,52929,53042,440,16.108,359,13.143,11493,3399,8094,6.408,21.668,11771,3078,8693,5.803,22.192,-278,-0.524,43.335,278,278,2333
1995,7114,1864,1914,14204,14168,345,18.563,234,12.591,3215,1659,1556,11.710,22.693,3157,1476,1681,10.418,22.283,58,0.409,44.567,182,182,1108
1995,7115,7525,7573,44474,43569,1474,19.885,1153,15.555,13060,5482,7578,12.582,29.975,11169,4862,6307,11.159,25.635,1891,4.340,51.270,738,746,3379
1995,7121,3585,3918,77358,75938,367,9.607,171,4.476,8563,1688,6875,2.223,11.276,5737,814,4923,1.072,7.555,2826,3.721,15.110,113,113,544
1995,7131,1644,2792,113716,107673,470,17.462,269,9.994,23245,11666,11579,10.835,21.589,10645,4251,6394,3.948,9.886,12600,11.702,19.773,198,203,1351
1995,7132,1406,1649,89860,79570,298,19.276,92,5.951,29320,10090,19230,12.681,36.848,9002,1626,7376,2.043,11.313,20318,25.535,22.627,66,66,1186
1995,7139,42547,45916,770012,750362,5539,12.227,4312,9.518,142045,57336,84709,7.641,18.930,102757,35234,67523,4.696,13.694,39288,5.236,27.389,3375,3437,26487
1995,7211,31457,38322,1487734,1474911,4295,11.329,3477,9.171,217509,99653,117856,6.757,14.747,191810,84326,107484,5.717,13.005,25699,1.742,26.010,2388,2452,48213
1995,7212,4714,5101,32908,32547,557,11.067,421,8.365,6244,1828,4416,5.616,19.185,5520,1465,4055,4.501,16.960,724,2.224,33.920,276,280,854
1995,7213,3059,3152,15606,15558,246,7.722,313,9.826,2930,1117,1813,7.180,18.833,2810,1293,1517,8.311,18.061,120,0.771,36.123,229,230,921
1995,7223,11470,22235,437315,425669,3700,16.983,2803,12.866,95084,48962,46122,11.502,22.338,72699,29463,43236,6.922,17.079,22385,5.259,34.158,2167,2185,19063
1995,7224,49589,50114,329525,325256,7014,13.987,7078,14.115,85474,43678,41796,13.429,26.279,76882,37113,39769,11.410,23.637,8592,2.642,47.275,5862,5875,31436
1995,7225,251121,344338,6529761,6404025,49430,14.556,39921,11.756,1357657,720783,636874,11.255,21.200,1108711,454673,654038,7.100,17.313,248946,3.887,34.625,28689,29865,289438
1995,8111,131243,141887,763792,742715,17864,12.757,14154,10.108,155024,64399,90625,8.671,20.873,112886,46779,66107,6.298,15.199,42138,5.674,30.398,10844,11037,36580
1995,8112,13548,16153,141636,137218,2041,12.709,1855,11.550,31427,13003,18424,9.476,22.903,22033,8532,13501,6.218,16.057,9394,6.846,32.114,1246,1293,5373
1995,8113,22021,23329,188848,182833,2724,11.793,2263,9.797,36434,11222,25212,6.138,19.927,24555,8960,15595,4.901,13.430,11879,6.497,26.861,1750,1758,6406
1995,8114,25703,27355,160656,162149,3684,13.482,3623,13.259,28295,10831,17464,6.680,17.450,30654,11569,19085,7.135,18.905,-2359,-1.455,34.900,2834,2858,8892
1995,8121,76327,87208,457501,453134,11012,12.665,10492,12.067,89782,40882,48900,9.022,19.814,81318,35268,46050,7.783,17.946,8464,1.868,35.891,8335,8602,28791
1995,8122,16531,21294,148378,143520,1624,7.719,1116,5.304,27136,11551,15585,8.048,18.907,16864,5344,11520,3.724,11.750,10272,7.157,23.501,744,791,3943
1995,8123,34793,41613,387586,383388,4300,10.325,4366,10.484,58427,20742,37685,5.410,15.240,50171,20488,29683,5.344,13.086,8256,2.153,26.172,3270,3435,15344
1995,8129,15516,24536,178406,176521,3568,14.759,2846,11.772,41249,17775,23474,10.070,23.368,36598,13197,23401,7.476,20.733,4651,2.635,41.466,1644,1756,7110
1995,8131,146935,147054,1321765,1296516,8610,5.930,4909,3.381,156648,23900,132748,1.843,12.082,105797,14468,91329,1.116,8.160,50851,3.922,16.320,3097,3097,9689
1995,8132,11118,12899,165086,159129,944,7.390,695,5.441,27345,9729,17616,6.114,17.184,15796,3587,12209,2.254,9.927,11549,7.258,19.853,476,485,2431
1995,8133,9832,11613,129363,125100,1020,8.894,730,6.366,21310,4147,17163,3.315,17.034,12980,3196,9784,2.555,10.376,8330,6.659,20.751,460,466,1848
1995,8134,31403,33286,331119,333907,1686,5.063,1709,5.133,41154,7998,33156,2.395,12.325,46207,5888,40319,1.763,13.838,-5053,-1.513,24.650,1234,1235,4104
1995,8139,64393,66666,513083,516056,4044,6.038,4671,6.974,68102,17079,51023,3.310,13.197,74119,22771,51348,4.413,14.363,-6017,-1.166,26.393,3451,3463,16315
1996,1131,230,281,2720,2757,34,12.100,34,12.100,589,241,348,8.741,21.364,681,168,513,6.094,24.701,-92,-3.337,42.728,27,27,108
1996,1132,123,157,1936,1672,33,22.449,13,8.844,765,347,418,20.760,45.767,249,53,196,3.171,14.897,516,30.870,29.794,7,7,29
1996,1133,12041,12121,84440,84737,1667,13.709,1744,14.343,16993,6416,10577,7.572,20.054,17662,6194,11468,7.310,20.843,-669,-0.790,40.108,1323,1324,4792
1996,1141,1234,1246,9548,9199,225,18.375,182,14.863,2754,723,2031,7.860,29.940,2123,901,1222,9.795,23.080,631,6.860,46.160,116,116,398
1996,1142,228,233,1751,1792,35,15.351,25,10.965,237,64,173,3.571,13.225,310,74,236,4.129,17.299,-73,-4.074,26.451,16,16,55
1996,1151,4501,4818,58204,58641,564,11.741,535,11.138,10964,3653,7311,6.229,18.697,11819,3201,8618,5.459,20.155,-855,-1.458,37.394,405,409,2153
1996,1152,2570,2604,15982,15778,429,16.840,316,12.404,3203,1437,1766,9.108,20.300,2771,1093,1678,6.927,17.562,432,2.738,35.125,248,248,892
1996,1153,1145,1179,14143,14078,190,16.302,163,13.985,2857,649,2208,4.610,20.294,2653,719,1934,5.107,18.845,204,1.449,37.690,120,120,486
1996,2111,6310,7492,92288,95289,646,8.491,878,11.540,12649,4451,8198,4.671,13.274,19019,7604,11415,7.980,19.959,-6370,-6.685,26.549,585,591,2308
1996,2121,1110,1539,85401,89713,179,10.968,365,22.365,10852,3594,7258,4.006,12.096,19319,8136,11183,9.069,21.534,-8467,-9.438,24.193,246,248,4525
1996,2122,344,489,42459,42567,62,12.679,62,12.679,4355,426,3929,1.001,10.231,4367,1840,2527,4.323,10.259,-12,-0.028,20.462,35,35,1263
1996,2123,3316,5044,97630,98468,339,6.725,333,6.606,11418,2502,8916,2.541,11.596,12981,4424,8557,4.493,13.183,-1563,-1.587,23.191,214,215,1403
1996,2131,6984,8063,149045,146527,942,11.611,1042,12.844,34014,7410,26604,5.057,23.213,29074,11785,17289,8.043,19.842,4940,3.371,39.684,745,765,7403
1996,2211,1576,7701,554732,567731,667,8.874,297,3.952,36475,19736,16739,3.476,6.425,62301,3874,58427,0.682,10.974,-25826,-4.549,12.849,53,53,580
1996,2212,605,2740,102930,104993,202,7.344,223,8.108,9169,3308,5861,3.151,8.733,13321,3800,9521,3.619,12.688,-4152,-3.955,17.466,43,49,381
1996,2213,4096,4540,34498,33889,314,6.966,249,5.524,4164,1572,2592,4.639,12.287,2958,1191,1767,3.514,8.729,1206,3.559,17.457,166,168,716
1996,2361,124323,124966,645109,641619,22471,18.121,20554,16.575,176771,71766,105005,11.185,27.551,169516,67792,101724,10.566,26.420,7255,1.131,52.840,14920,14922,52436
1996,2362,37885,38594,646504,637353,5188,13.601,4288,11.242,139909,30218,109691,4.741,21.952,121685,28063,93622,4.403,19.092,18224,2.859,38.184,3184,3189,21069
1996,2371,14652,14955,338051,334162,1450,9.788,1169,7.891,65470,16451,49019,4.923,19.592,59058,10964,48094,3.281,17.673,6412,1.919,35.347,878,880,7400
1996,2372,8542,8723,63374,63153,1837,21.628,1378,16.224,16132,7062,9070,11.182,25.544,15599,6158,9441,9.751,24.700,533,0.844,49.401,1048,1056,4226
1996,2373,9812,10238,232856,229305,925,9.066,856,8.389,44733,8272,36461,3.607,19.508,37544,7253,30291,3.163,16.373,7189,3.135,32.746,624,625,5296
1996,2379,4620,4687,67472,67861,623,13.233,665,14.125,13635,4025,9610,5.931,20.093,14524,3514,11010,5.178,21.403,-889,-1.310,40.185,490,491,2603
1996,2381,85092,85504,770080,753039,11925,14.057,10578,12.470,194710,53819,140891,7.147,25.857,160612,49235,111377,6.538,21.329,34098,4.528,42.657,8080,8081,40112
1996,2382,133675,135606,1399713,1368111,16017,11.962,12597,9.408,276446,65412,211034,4.781,20.206,213332,58088,155244,4.246,15.593,63114,4.613,31.186,9596,9601,45490
1996,2383,89691,90190,681384,672995,14999,16.768,13520,15.115,173033,54774,118259,8.139,25.711,156128,53559,102569,7.958,23.199,16905,2.512,46.398,10324,10337,43269
1996,2389,45571,45848,362868,358248,6437,14.224,5248,11.597,85441,24866,60575,6.941,23.850,76235,22554,53681,6.296,21.280,9206,2.570,42.560,3946,3949,17867
1996,3111,1102,1733,46254,46452,73,4.182,98,5.614,4912,1930,2982,4.155,10.574,5300,1306,3994,2.812,11.410,-388,-0.835,21.149,64,64,357
1996,3112,475,836,62706,64646,55,6.647,38,4.592,3925,1233,2692,1.907,6.072,7766,1363,6403,2.108,12.013,-3841,-5.942,12.143,26,26,421
1996,3113,1464,1648,82752,83915,142,8.506,185,11.081,7580,1470,6110,1.752,9.033,9826,1714,8112,2.043,11.709,-2246,-2.677,18.066,134,134,920
1996,3114,1251,1665,170746,173261,103,6.153,121,7.228,13352,2596,10756,1.498,7.706,18534,3926,14608,2.266,10.697,-5182,-2.991,15.413,87,88,1903
1996,3115,1220,1725,129591,130125,81,4.647,117,6.713,10440,959,9481,0.737,8.023,11666,4422,7244,3.398,8.965,-1226,-0.942,16.046,70,72,1607
1996,3116,3402,4020,457807,448506,249,6.183,263,6.531,46642,7256,39386,1.618,10.399,27585,6090,21495,1.358,6.150,19057,4.249,12.301,200,200,2552
1996,3117,622,732,41688,42192,67,9.011,90,12.105,5546,1423,4123,3.373,13.145,6604,1962,4642,4.650,15.652,-1058,-2.508,26.290,65,65,1384
1996,3118,9262,10179,310555,308755,1181,11.519,1328,12.953,43958,10763,33195,3.486,14.237,40853,15507,25346,5.022,13.232,3105,1.006,26.463,932,950,7905
1996,3119,2173,2556,133704,135483,202,7.863,228,8.875,13373,3050,10323,2.251,9.871,16841,6691,10150,4.939,12.430,-3468,-2.560,19.741,174,175,3006
1996,3121,1840,2262,133035,132170,231,10.410,145,6.534,13923,2809,11114,2.125,10.534,12128,3985,8143,3.015,9.176,1795,1.358,18.352,102,103,1701
1996,3122,67,98,28723,28492,6,6.186,4,4.124,2270,126,2144,0.442,7.967,1723,859,864,3.015,6.047,547,1.920,12.095,D,D,D
1996,3131,362,595,80448,85001,31,5.141,47,7.794,3437,475,2962,0.559,4.044,12501,3665,8836,4.312,14.707,-9064,-10.663,8.087,28,28,652
1996,3132,1682,2045,224528,233633,169,8.228,187,9.104,12328,4237,8091,1.814,5.277,30350,7011,23339,3.001,12.990,-18022,-7.714,10.553,143,143,2457
1996,3133,5185,5816,138182,142673,426,7.159,695,11.680,12595,3587,9008,2.514,8.828,21766,6567,15199,4.603,15.256,-9171,-6.428,17.656,555,557,3802
1996,3141,2803,3067,118733,122377,272,8.671,412,13.134,9761,2439,7322,1.993,7.976,17079,5019,12060,4.101,13.956,-7318,-5.980,15.952,320,345,3228
1996,3149,4214,4347,109670,113030,559,12.977,480,11.143,16166,5605,10561,4.959,14.302,23148,9545,13603,8.445,20.480,-6982,-6.177,28.605,400,403,6691
1996,3151,1081,1198,110910,115335,111,9.076,161,13.164,9904,3533,6371,3.063,8.587,18823,6399,12424,5.548,16.320,-8919,-7.733,17.174,123,124,2840
1996,3152,10756,11674,551667,579411,2039,17.186,2420,20.397,79793,35990,43803,6.211,13.771,134433,56581,77852,9.765,23.202,-54640,-9.430,27.543,2058,2081,36411
1996,3159,1831,1949,55795,58023,227,11.508,274,13.891,6336,2238,4098,3.857,10.920,10714,2990,7724,5.153,18.465,-4378,-7.545,21.840,223,224,2599
1996,3161,299,327,15064,15369,32,9.831,29,8.909,1322,504,818,3.279,8.602,1902,357,1545,2.323,12.376,-580,-3.774,17.204,23,23,284
1996,3162,309,380,45990,50327,29,7.417,51,13.043,2083,291,1792,0.578,4.139,10812,3353,7459,6.662,21.484,-8729,-17.345,8.278,35,35,683
1996,3169,987,1022,29713,30852,88,8.494,116,11.197,2770,526,2244,1.705,8.978,5122,1796,3326,5.821,16.602,-2352,-7.623,17.957,89,89,904
1996,3211,4171,4658,124931,128768,309,6.522,468,9.879,10606,2642,7964,2.052,8.237,18281,5194,13087,4.034,14.197,-7675,-5.960,16.473,379,380,3083
1996,3212,1383,1735,111731,110165,114,6.605,96,5.562,11563,3357,8206,3.047,10.496,8432,1630,6802,1.480,7.654,3131,2.842,15.308,69,69,1082
1996,3219,9360,10097,305639,305707,1001,9.902,1025,10.139,39719,10443,29276,3.416,12.993,39672,11576,28096,3.787,12.977,47,0.015,25.954,820,823,7619
1996,3221,219,534,178107,179658,8,1.479,22,4.067,5027,467,4560,0.260,2.798,7917,1644,6273,0.915,4.407,-2890,-1.609,5.596,9,9,145
1996,3222,3553,5235,396862,401773,272,5.215,234,4.486,26428,7452,18976,1.855,6.578,36290,9727,26563,2.421,9.032,-9862,-2.455,13.156,151,153,3411
1996,3231,39723,41658,824665,830003,2909,6.919,3681,8.755,81758,20129,61629,2.425,9.850,92468,29631,62837,3.570,11.141,-10710,-1.290,19.701,3039,3044,18660
1996,3241,1081,2027,106786,108535,110,5.448,94,4.656,6493,1412,5081,1.301,5.982,10040,1255,8785,1.156,9.250,-3547,-3.268,11.965,54,55,440
1996,3251,1135,2312,211765,212583,127,5.475,142,6.122,14761,3884,10877,1.827,6.944,16428,5672,10756,2.668,7.728,-1667,-0.784,13.887,69,69,790
1996,3252,408,710,118394,120496,47,6.700,30,4.277,5106,1299,3807,1.078,4.238,9375,1234,8141,1.024,7.780,-4269,-3.543,8.475,18,18,771
1996,3253,626,884,38812,39325,55,6.190,64,7.203,2339,453,1886,1.152,5.948,3321,653,2668,1.661,8.445,-982,-2.497,11.896,41,42,388
1996,3254,1190,1479,199510,198109,140,9.632,89,6.123,17317,3781,13536,1.909,8.741,14659,2677,11982,1.351,7.399,2658,1.342,14.799,49,49,666
1996,3255,1563,2030,72234,72103,140,6.908,133,6.563,7112,1993,5119,2.764,9.864,6695,2357,4338,3.269,9.285,417,0.578,18.571,85,85,883
1996,3256,2023,2240,122798,122748,153,6.805,170,7.561,11970,1773,10197,1.444,9.752,11983,3639,8344,2.965,9.762,-13,-0.011,19.503,122,123,1931
1996,3259,2254,2952,127471,128914,198,6.736,173,5.885,9561,1850,7711,1.435,7.417,12388,2112,10276,1.638,9.610,-2827,-2.193,14.833,112,112,1011
1996,3261,10648,13004,765498,768543,959,7.417,810,6.265,80980,19926,61054,2.593,10.537,87174,19320,67854,2.514,11.343,-6194,-0.806,21.074,596,606,10351
1996,3262,2149,2658,198283,198409,217,8.232,173,6.563,15782,5338,10444,2.690,7.954,16094,4105,11989,2.069,8.112,-312,-0.157,15.909,120,124,2203
1996,3271,1540,1814,77623,79299,174,9.645,154,8.537,6638,1719,4919,2.168,8.371,10058,1874,8184,2.363,12.684,-3420,-4.313,16.742,117,117,755
1996,3272,1763,2031,135921,136596,207,10.288,169,8.400,10626,3331,7295,2.439,7.779,11898,3910,7988,2.862,8.710,-1272,-0.931,15.558,125,125,1471
1996,3273,5676,8789,180519,178428,590,6.730,546,6.228,25356,7353,18003,4.121,14.211,21171,5892,15279,3.302,11.865,4185,2.345,23.731,303,329,3109
1996,3274,259,372,18467,18128,32,8.660,27,7.307,1718,503,1215,2.775,9.477,1042,442,600,2.438,5.748,676,3.729,11.496,18,18,125
1996,3279,2000,2332,71030,70793,206,8.933,154,6.678,7802,2957,4845,4.177,11.021,7331,1634,5697,2.308,10.356,471,0.665,20.711,116,118,739
1996,3311,226,307,151984,153880,19,6.100,28,8.989,6121,3475,2646,2.258,3.978,9764,4812,4952,3.127,6.345,-3643,-2.367,7.956,23,23,2009
1996,3312,524,719,67585,67796,43,6.001,38,5.304,4202,1025,3177,1.512,6.198,4643,1120,3523,1.652,6.848,-441,-0.650,12.396,29,29,617
1996,3313,330,486,80716,81001,25,5.225,10,2.090,5545,2671,2874,3.298,6.846,6012,2473,3539,3.053,7.422,-467,-0.577,13.691,7,7,315
1996,3314,748,931,81116,80261,57,6.132,54,5.810,6455,1423,5032,1.773,8.043,4793,1108,3685,1.380,5.972,1662,2.071,11.944,36,36,313
1996,3315,2370,2645,215527,215173,136,5.141,137,5.179,19498,5399,14099,2.509,9.062,18779,4398,14381,2.044,8.727,719,0.334,17.455,99,100,2465
1996,3321,3106,3307,141052,140204,179,5.427,162,4.911,14195,2568,11627,1.832,10.125,12650,3296,9354,2.351,9.023,1545,1.102,18.045,126,126,2043
1996,3322,1363,1502,76206,76943,81,5.396,79,5.263,4537,717,3820,0.932,5.897,6108,1108,5000,1.440,7.938,-1571,-2.042,11.793,58,58,410
1996,3323,10483,11265,346390,342686,842,7.509,738,6.582,43334,9448,33886,2.757,12.645,35662,10406,25256,3.037,10.407,7672,2.239,20.813,574,580,5860
1996,3324,1556,1876,106759,106801,105,5.606,99,5.286,10058,1956,8102,1.831,9.418,10144,2676,7468,2.506,9.498,-86,-0.081,18.835,70,71,1222
1996,3325,908,1001,66046,67724,53,5.268,63,6.262,3683,737,2946,1.088,5.438,7136,941,6195,1.389,10.537,-3453,-5.099,10.876,51,51,518
1996,3326,1541,1722,69609,69940,128,7.466,113,6.591,6782,2069,4713,2.958,9.697,7612,1875,5737,2.681,10.884,-830,-1.187,19.394,82,83,1127
1996,3327,23743,24115,390363,383122,2075,8.724,1413,5.941,51868,12269,39599,3.202,13.538,37294,10166,27128,2.653,9.734,14574,3.804,19.468,1131,1134,7052
1996,3328,5483,5914,143127,142882,401,6.826,323,5.498,17460,4789,12671,3.352,12.220,17116,5340,11776,3.737,11.979,344,0.241,23.958,252,252,3140
1996,3329,5705,6215,312898,313476,421,6.789,394,6.353,27166,5639,21527,1.799,8.666,28708,6342,22366,2.023,9.158,-1542,-0.492,17.332,300,302,3290
1996,3331,2725,2991,196439,197384,202,6.736,218,7.269,15031,2489,12542,1.261,7.615,16919,3661,13258,1.855,8.572,-1888,-0.957,15.230,166,167,1765
1996,3332,4096,4363,179023,174367,324,7.483,258,5.958,23092,3576,19516,2.051,13.243,13812,3882,9930,2.226,7.921,9280,5.322,15.842,198,201,2127
1996,3333,2377,2502,129805,125230,195,7.770,210,8.368,20887,9997,10890,7.983,16.679,12120,3092,9028,2.469,9.678,8767,7.001,19.356,158,160,1396
1996,3334,1537,1808,168780,167442,95,5.231,111,6.112,14046,1439,12607,0.859,8.389,11382,2956,8426,1.765,6.798,2664,1.591,13.595,85,85,2488
1996,3335,9661,10009,236687,232704,664,6.677,534,5.370,26262,5305,20957,2.280,11.286,18206,4825,13381,2.073,7.824,8056,3.462,15.647,425,426,3401
1996,3336,751,901,113229,115174,43,4.791,36,4.011,7299,1885,5414,1.637,6.337,11067,1075,9992,0.933,9.609,-3768,-3.272,12.675,24,24,181
1996,3339,5701,6337,334378,330966,444,7.056,355,5.642,32815,6707,26108,2.026,9.915,26095,7800,18295,2.357,7.884,6720,2.030,15.769,251,251,3099
1996,3341,1568,1670,197274,197993,193,11.606,179,10.764,23193,3545,19648,1.790,11.714,24648,6105,18543,3.083,12.449,-1455,-0.735,23.428,137,138,1900
1996,3342,1765,1971,225287,221466,159,8.018,183,9.228,28119,5337,22782,2.410,12.697,20760,5995,14765,2.707,9.374,7359,3.323,18.748,127,127,2353
1996,3343,499,530,34960,35895,84,16.454,45,8.815,4353,1198,3155,3.338,12.127,6270,2221,4049,6.187,17.468,-1917,-5.341,24.254,33,33,269
1996,3344,5172,5751,542118,525481,486,8.481,445,7.765,73591,10392,63199,1.978,14.005,40143,12937,27206,2.462,7.639,33448,6.365,15.279,334,335,3649
1996,3345,4528,5120,493654,499697,344,6.696,379,7.377,39866,10953,28913,2.192,7.978,51513,18296,33217,3.661,10.309,-11647,-2.331,15.956,269,270,4735
1996,3346,697,755,48146,48184,117,15.726,95,12.769,6825,1809,5016,3.754,14.164,7000,2700,4300,5.604,14.528,-175,-0.363,28.329,73,73,864
1996,3351,1122,1235,72568,73704,80,6.405,108,8.647,5760,1386,4374,1.881,7.815,7975,1451,6524,1.969,10.820,-2215,-3.005,15.630,85,87,639
1996,3352,325,397,106175,107996,29,7.223,38,9.465,5505,2146,3359,1.987,5.097,8981,1817,7164,1.682,8.316,-3476,-3.219,10.195,29,29,433
1996,3353,2222,2639,202499,203497,166,6.309,150,5.701,16330,2211,14119,1.087,8.025,17848,3633,14215,1.785,8.771,-1518,-0.746,16.049,100,101,1651
1996,3359,1835,2221,190663,192758,154,6.957,139,6.280,16402,2984,13418,1.548,8.509,20459,6110,14349,3.170,10.614,-4057,-2.105,17.018,85,88,1810
1996,3361,277,342,214231,221135,41,12.130,33,9.763,10310,1205,9105,0.545,4.662,24655,284,24371,0.128,11.149,-14345,-6.487,9.325,27,27,262
1996,3362,1708,1902,123590,127075,198,10.446,185,9.760,13487,3889,9598,3.060,10.613,20302,4996,15306,3.932,15.976,-6815,-5.363,21.227,150,150,3281
1996,3363,4376,5423,728538,737815,419,7.772,355,6.585,63347,22637,40710,3.068,8.586,82666,23488,59178,3.183,11.204,-19319,-2.618,17.172,248,249,5067
1996,3364,1343,1631,443328,449290,130,8.025,108,6.667,29765,11561,18204,2.573,6.625,41755,13249,28506,2.949,9.294,-11990,-2.669,13.250,69,69,770
1996,3365,177,239,30650,30711,20,8.511,12,5.106,2622,933,1689,3.038,8.538,2752,732,2020,2.384,8.961,-130,-0.423,17.075,7,7,86
1996,3366,1407,1521,137657,139588,174,11.596,133,8.864,13585,2961,10624,2.121,9.732,17230,3002,14228,2.151,12.344,-3645,-2.611,19.464,93,93,2373
1996,3369,589,618,36652,36009,99,16.597,56,9.388,6186,2633,3553,7.312,17.179,4919,2424,2495,6.732,13.661,1267,3.519,27.321,44,44,551
1996,3371,13435,13967,374542,379769,1533,10.898,1733,12.320,38974,11494,27480,3.027,10.263,49681,17121,32560,4.508,13.082,-10707,-2.819,20.525,1308,1329,10854
1996,3372,3408,3611,154056,156037,350,9.774,290,8.098,14886,4379,10507,2.806,9.540,19090,5119,13971,3.281,12.234,-4204,-2.694,19.080,217,219,3598
1996,3379,1034,1159,40612,40555,83,7.094,105,8.974,4641,1032,3609,2.545,11.444,4532,1354,3178,3.339,11.175,109,0.269,22.350,86,87,866
1996,3391,10851,11423,275021,272591,970,8.536,850,7.480,31020,9996,21024,3.667,11.380,26418,7596,18822,2.787,9.691,4602,1.688,19.383,652,653,4159
1996,3399,16230,16795,413133,414173,1791,10.713,1637,9.792,50887,12870,38017,3.107,12.286,52818,14176,38642,3.423,12.753,-1931,-0.466,24.573,1330,1334,10448
1996,4231,18164,22641,279818,278382,2660,11.843,2299,10.236,39852,13869,25983,4.982,14.316,37146,13447,23699,4.830,13.344,2706,0.972,26.687,1622,1648,7368
1996,4232,8976,10122,127440,127104,1232,12.298,1023,10.212,20060,6676,13384,5.252,15.782,19332,6264,13068,4.928,15.210,728,0.573,30.419,748,769,4190
1996,4233,8669,11477,142450,142670,1215,10.642,1094,9.583,20122,6036,14086,4.231,14.104,20632,6960,13672,4.878,14.461,-510,-0.357,28.208,755,782,4275
1996,4234,28659,37072,615965,609867,5008,13.612,4445,12.082,111619,38581,73038,6.326,18.302,99575,38438,61137,6.303,16.327,12044,1.975,32.655,2883,3020,21990
1996,4235,7378,9781,146720,144893,872,9.038,607,6.291,18087,5194,12893,3.585,12.483,14462,3824,10638,2.639,9.981,3625,2.502,19.962,397,405,2096
1996,4236,18655,27580,374458,366524,3377,12.430,2553,9.397,69480,23979,45501,6.542,18.956,53509,18808,34701,5.131,14.599,15971,4.357,29.198,1494,1545,9016
1996,4237,11289,16058,180714,179349,1305,8.196,1033,6.488,23106,6993,16113,3.899,12.883,20255,5379,14876,2.999,11.294,2851,1.590,22.587,682,710,3408
1996,4238,49233,64004,707146,696194,5437,8.557,4509,7.096,99048,31399,67649,4.510,14.227,76888,25892,50996,3.719,11.044,22160,3.183,22.088,3008,3141,16312
1996,4239,28185,30450,319306,316298,4024,13.378,3282,10.911,55379,18300,37079,5.786,17.508,49507,19110,30397,6.042,15.652,5872,1.856,31.304,2632,2673,14370
1996,4241,9455,12381,203660,200798,1119,9.033,1132,9.138,29446,7625,21821,3.797,14.665,23522,9617,13905,4.789,11.714,5924,2.950,23.429,672,688,4807
1996,4242,4387,5635,152443,150868,799,14.319,689,12.348,26452,7776,18676,5.154,17.533,23258,10073,13185,6.677,15.416,3194,2.117,30.832,423,462,4109
1996,4243,11209,11996,139180,139920,2039,17.134,1848,15.529,28707,12346,16361,8.824,20.517,30207,12006,18201,8.581,21.589,-1500,-1.072,41.033,1495,1520,9075
1996,4244,27853,33616,726718,731075,3492,10.324,3906,11.548,97845,24201,73644,3.310,13.384,106089,38600,67489,5.280,14.511,-8244,-1.128,26.767,2883,2946,21968
1996,4245,5540,8492,74126,75796,474,5.521,661,7.699,8355,2300,6055,3.034,11.023,11631,3740,7891,4.934,15.345,-3276,-4.322,22.046,428,444,2388
1996,4246,9473,13471,158860,155300,1325,9.973,954,7.181,27748,7376,20372,4.750,17.867,20410,5837,14573,3.759,13.142,7338,4.725,26.285,570,589,2518
1996,4247,7549,10856,125441,126459,703,6.430,858,7.847,18379,4866,13513,3.848,14.534,20456,4872,15584,3.853,16.176,-2077,-1.642,29.067,416,431,2143
1996,4248,3275,4259,138923,139027,224,5.224,281,6.554,13036,3332,9704,2.397,9.377,13282,4932,8350,3.548,9.554,-246,-0.177,18.753,203,205,3004
1996,4249,22120,26567,332486,330624,3713,14.100,3245,12.323,57227,19872,37355,6.010,17.309,53662,20233,33429,6.120,16.231,3565,1.078,32.461,2404,2428,12303
1996,4251,34389,36783,297452,297723,4108,11.329,3061,8.442,48433,16299,32134,5.475,16.268,49309,18431,30878,6.191,16.562,-876,-0.294,32.536,2094,2103,11544
1996,4411,40747,43487,1075580,1058770,4714,10.986,3560,8.296,129776,43174,86602,4.078,12.257,96882,33307,63575,3.146,9.150,32894,3.107,18.301,2773,2811,26291
1996,4412,11052,11875,94732,92344,1158,9.867,880,7.498,16367,5606,10761,6.071,17.724,11630,3729,7901,4.038,12.594,4737,5.130,25.188,692,704,2951
1996,4413,37753,60218,521515,505813,5905,9.917,4560,7.658,102125,59537,42588,11.771,20.190,73209,24526,48683,4.849,14.474,28916,5.717,28.947,2824,2920,13781
1996,4421,21288,28185,254457,254673,2855,10.144,2774,9.856,39600,17640,21960,6.927,15.549,40586,14261,26325,5.600,15.937,-986,-0.387,31.099,1957,2128,10258
1996,4422,24533,33197,231331,227074,3674,11.154,3157,9.585,44616,19512,25104,8.593,19.648,35798,12930,22868,5.694,15.765,8818,3.883,31.530,2111,2252,7804
1996,4431,31743,48751,430426,418825,6085,12.562,5462,11.276,96678,45509,51169,10.866,23.083,73145,28988,44157,6.921,17.464,23533,5.619,34.929,3526,3718,17315
1996,4441,48140,68664,920366,904645,5430,7.915,5308,7.737,146136,55137,90999,6.095,16.154,116596,41978,74618,4.640,12.889,29540,3.265,25.777,3441,3557,18986
1996,4442,17364,21431,173644,173427,1607,7.496,1619,7.552,25054,7292,17762,4.205,14.446,24509,6694,17815,3.860,14.132,545,0.314,28.264,1146,1161,4448
1996,4451,61223,89302,2611407,2586267,9166,10.243,9541,10.662,319414,138245,181169,5.345,12.350,266259,104672,161587,4.047,10.295,53155,2.055,20.590,6640,6794,45025
1996,4452,17124,21634,137400,134719,2918,13.514,2834,13.125,31908,12622,19286,9.369,23.685,26777,12302,14475,9.132,19.876,5131,3.809,39.752,2161,2180,9125
1996,4453,23381,27155,134170,134218,2378,8.692,2786,10.183,21735,7720,14015,5.752,16.194,21943,8636,13307,6.434,16.349,-208,-0.155,32.388,1987,2022,6111
1996,4461,43956,78277,788376,791509,6940,8.876,6759,8.645,123322,53521,69801,6.762,15.581,130374,47355,83019,5.983,16.472,-7052,-0.891,31.161,4193,4389,23002
1996,4471,70484,122077,923083,921263,9613,7.855,10219,8.350,161801,60882,100919,6.609,17.563,158223,59881,98342,6.500,17.175,3578,0.388,34.349,6434,6779,35316
1996,4481,41346,91843,901797,930734,9956,10.738,11705,12.624,155208,75544,79664,8.117,16.676,212858,65148,147710,7.000,22.870,-57650,-6.194,33.352,6209,7081,27390
1996,4482,7340,30418,184565,185704,1806,5.853,2682,8.692,35219,12501,22718,6.732,18.965,37548,11264,26284,6.066,20.219,-2329,-1.254,37.930,918,1031,3432
1996,4483,18780,28286,150869,153521,2742,9.703,2687,9.509,24689,10130,14559,6.598,16.082,30581,11427,19154,7.443,19.920,-5892,-3.838,32.164,1672,1833,7740
1996,4511,31863,43586,379427,371354,5532,12.799,4803,11.113,74579,35859,38720,9.656,20.083,58666,22543,36123,6.070,15.798,15913,4.285,31.596,3485,3669,13886
1996,4512,8923,14638,126529,123586,1509,10.283,1582,10.781,27336,11605,15731,9.390,22.119,20709,7160,13549,5.794,16.757,6627,5.362,33.514,1029,1047,3680
1996,4522,94,6268,1080581,1083372,231,3.679,253,4.029,113853,36715,77138,3.389,10.509,121274,24493,96781,2.261,11.194,-7421,-0.685,21.018,3,3,181
1996,4523,10257,28741,1343020,1318557,2931,10.283,2456,8.616,170389,75070,95319,5.693,12.922,124370,38723,85647,2.937,9.432,46019,3.490,18.865,1274,1352,7249
1996,4531,22760,24092,122013,121751,2403,9.925,2643,10.916,20623,7160,13463,5.881,16.939,20075,7604,12471,6.246,16.489,548,0.450,32.977,2141,2172,6128
1996,4532,29803,39770,298225,293875,5143,13.021,4601,11.648,60807,29993,30814,10.206,20.691,53096,21802,31294,7.419,18.068,7711,2.624,36.135,3472,3597,12917
1996,4533,12485,15707,91508,90272,2358,15.249,1870,12.093,18511,8183,10328,9.065,20.506,16209,5808,10401,6.434,17.956,2302,2.550,35.911,1413,1426,3477
1996,4539,28336,33740,198538,191955,5638,17.057,4264,12.900,50347,25069,25278,13.060,26.229,37246,15919,21327,8.293,19.404,13101,6.825,38.807,3165,3226,11118
1996,4541,6978,7657,166885,163369,1225,16.544,720,9.724,28474,10497,17977,6.425,17.429,21414,5569,15845,3.409,13.108,7060,4.322,26.216,547,548,2841
1996,4542,4919,5713,70247,70480,798,14.167,638,11.326,9273,3810,5463,5.406,13.157,9869,3638,6231,5.162,14.003,-596,-0.846,26.314,488,488,2191
1996,4543,18679,24936,228018,227048,2699,10.910,2303,9.310,37066,12159,24907,5.355,16.325,34748,13068,21680,5.756,15.304,2318,1.021,30.609,1513,1542,7904
1996,4811,650,3103,464542,455344,312,10.000,346,11.090,51849,17178,34671,3.773,11.387,34024,17965,16059,3.945,7.472,17825,3.915,14.944,95,113,1735
1996,4812,1391,1555,26566,25471,234,15.528,138,9.157,6215,1766,4449,6.934,24.401,3735,1220,2515,4.790,14.664,2480,9.737,29.328,99,106,983
1996,4831,477,807,41024,39588,91,11.418,71,8.908,8693,2802,5891,7.078,21.959,6150,1185,4965,2.993,15.535,2543,6.424,31.070,35,40,866
1996,4832,332,367,12505,12541,52,14.566,32,8.964,1929,765,1164,6.100,15.382,1923,527,1396,4.202,15.334,6,0.048,30.669,19,19,126
1996,4841,29570,37510,803897,794941,6373,17.286,5087,13.798,119815,38486,81329,4.841,15.072,102228,32436,69792,4.080,12.860,17587,2.212,25.720,3707,3770,21044
1996,4842,47893,51294,476473,476460,7945,15.570,7415,14.531,92008,34493,57515,7.239,19.311,92140,37572,54568,7.886,19.338,-132,-0.028,38.622,5737,5772,26740
1996,4851,454,550,29206,28751,88,16.651,45,8.515,3964,2512,1452,8.737,13.788,3150,1201,1949,4.177,10.956,814,2.831,21.913,37,37,573
1996,4852,247,421,17893,18446,35,7.910,78,17.627,1583,320,1263,1.735,8.582,2686,645,2041,3.497,14.562,-1103,-5.980,17.164,28,33,172
1996,4853,5338,5461,55900,55417,918,16.752,956,17.445,12251,5305,6946,9.573,22.107,11290,5799,5491,10.464,20.373,961,1.734,40.746,797,801,4552
1996,4854,3259,4292,145504,143446,354,8.266,335,7.823,18086,7333,10753,5.112,12.608,13925,6688,7237,4.662,9.708,4161,2.901,19.415,272,279,3405
1996,4855,1215,1331,28699,28268,188,14.401,137,10.494,5212,1167,4045,4.128,18.438,4393,1542,2851,5.455,15.541,819,2.897,31.081,106,106,1191
1996,4859,1971,2146,41713,40574,397,18.982,288,13.770,9390,3952,5438,9.740,23.143,7052,3624,3428,8.932,17.381,2338,5.762,34.762,224,226,2462
1996,4861,52,381,7896,8395,36,9.231,54,13.846,969,425,544,5.063,11.543,1973,354,1619,4.217,23.502,-1004,-11.959,23.085,D,D,D
1996,4862,144,1342,34850,35912,99,7.161,180,13.020,3370,1169,2201,3.255,9.384,5417,1615,3802,4.497,15.084,-2047,-5.700,18.768,20,20,139
1996,4869,57,530,6260,6356,32,5.850,66,12.066,744,212,532,3.336,11.706,913,433,480,6.813,14.366,-169,-2.659,23.413,5,5,29
1996,4871,337,375,7542,7474,61,16.420,54,14.536,1110,331,779,4.429,14.852,946,291,655,3.894,12.658,164,2.194,25.316,45,45,205
1996,4872,1221,1259,12201,12027,191,15.335,164,13.167,2471,749,1722,6.228,20.545,2110,621,1489,5.163,17.544,361,3.002,35.088,123,123,422
1996,4879,129,133,1373,1305,23,17.424,21,15.909,322,74,248,5.670,24.674,190,80,110,6.130,14.559,132,10.115,29.119,15,15,58
1996,4881,2755,3609,101383,99139,577,16.399,396,11.255,20901,8128,12773,8.199,21.083,16191,4420,11771,4.458,16.332,4710,4.751,32.663,255,262,1653
1996,4882,473,771,19326,19145,82,10.740,67,8.775,3638,1777,1861,9.282,19.002,3221,912,2309,4.764,16.824,417,2.178,33.648,39,40,480
1996,4883,2061,2645,82291,82769,254,9.607,252,9.531,11234,2039,9195,2.463,13.573,12493,2124,10369,2.566,15.094,-1259,-1.521,27.146,172,176,1150
1996,4884,4987,5178,37828,36606,886,17.496,658,12.994,8867,3667,5200,10.017,24.223,6365,3712,2653,10.140,17.388,2502,6.835,34.776,496,528,3102
1996,4885,10215,13527,129247,126526,1807,13.658,1213,9.169,23652,8190,15462,6.473,18.693,18084,6772,11312,5.352,14.293,5568,4.401,28.586,877,919,4854
1996,4889,840,885,10687,10740,132,15.068,114,13.014,2104,616,1488,5.736,19.591,2173,944,1229,8.790,20.234,-69,-0.642,39.182,90,94,871
1996,4921,1786,4965,467351,444318,615,12.590,455,9.314,77665,7687,69978,1.730,17.480,31273,19352,11921,4.355,7.038,46392,10.441,14.077,292,297,2889
1996,4922,4181,4492,65049,68337,813,18.469,633,14.380,16288,8282,8006,12.119,23.835,22161,15067,7094,22.048,32.429,-5873,-8.594,47.670,530,541,3255
1996,4931,6575,11149,474265,467853,1236,11.307,801,7.327,81191,29036,52155,6.206,17.354,67759,21126,46633,4.516,14.483,13432,2.871,28.966,290,293,3350
1996,5111,15844,18659,668595,671897,1974,10.644,1749,9.430,57699,16146,41553,2.403,8.587,65189,17447,47742,2.597,9.702,-7490,-1.115,17.175,1378,1392,10294
1996,5112,6755,8482,183482,173155,1695,21.070,820,10.193,46029,16114,29915,9.306,26.583,25448,8601,16847,4.967,14.697,20581,11.886,29.393,516,540,5035
1996,5121,11393,15682,240986,232330,2362,15.314,1846,11.968,55734,17379,38355,7.480,23.989,38194,12665,25529,5.451,16.440,17540,7.550,32.879,1165,1190,6990
1996,5122,2133,2201,19184,18846,458,21.609,295,13.918,3858,1823,2035,9.673,20.471,3263,1306,1957,6.930,17.314,595,3.157,34.628,225,225,1012
1996,5151,6287,8286,235231,238436,919,11.128,864,10.462,31388,13026,18362,5.463,13.164,37516,12294,25222,5.156,15.734,-6128,-2.570,26.328,664,711,8919
1996,5152,206,406,18946,18101,91,22.750,79,19.750,5673,3393,2280,18.745,31.342,3920,1580,2340,8.729,21.657,1753,9.685,43.314,30,31,290
1996,5173,7008,30074,1085705,1064488,4841,16.267,4212,14.153,241309,109301,132008,10.268,22.669,200085,78300,121785,7.356,18.796,41224,3.873,37.593,1040,1163,12924
1996,5174,339,451,9671,8943,101,23.765,49,11.529,4058,1471,2587,16.449,45.376,2577,1505,1072,16.829,28.816,1481,16.560,57.632,17,17,335
1996,5179,2889,3457,45813,43648,1393,45.530,598,19.546,17024,8686,8338,19.900,39.003,12694,6830,5864,15.648,29.083,4330,9.920,58.165,250,251,1261
1996,5182,4953,8308,337616,329540,1572,19.652,954,11.926,59688,25095,34593,7.615,18.113,43137,10308,32829,3.128,13.090,16551,5.022,26.180,456,465,3138
1996,5191,2740,3293,40673,39363,318,9.857,184,5.704,6415,1801,4614,4.575,16.297,3908,1438,2470,3.653,9.928,2507,6.369,19.856,150,150,866
1996,5211,16,46,22705,22679,0,0.000,D,D,551,0,551,0.000,2.430,529,D,469,D,2.333,22,0.097,4.665,0,0,0
1996,5221,19880,100351,1917388,1932497,6875,6.910,5164,5.190,243400,93262,150138,4.826,12.595,272854,74945,197909,3.878,14.119,-29454,-1.524,25.190,621,1191,16146
1996,5222,16235,41552,494453,481007,6544,16.191,4276,10.579,122447,50333,72114,10.464,25.456,95514,42621,52893,8.861,19.857,26933,5.599,39.714,1501,1646,11752
1996,5223,9122,12446,129911,115672,2686,22.455,1717,14.354,48342,25567,22775,22.103,41.792,20260,9058,11202,7.831,17.515,28082,24.277,35.030,996,1064,4317
1996,5231,8958,25322,408682,394895,3237,13.036,2256,9.085,71267,19746,51521,5.000,18.047,43688,17358,26330,4.396,11.063,27579,6.984,22.126,775,786,4606
1996,5232,29,46,6418,6516,7,14.433,12,24.742,118,27,91,0.414,1.811,313,91,222,1.397,4.804,-195,-2.993,3.622,6,6,70
1996,5239,19465,21483,189634,181786,3820,18.302,2597,12.443,47284,18778,28506,10.330,26.011,31895,13557,18338,7.458,17.545,15389,8.465,35.091,1837,1843,7855
1996,5241,4452,38153,1513578,1490373,4088,10.760,3766,9.913,206869,78974,127895,5.299,13.880,159995,37676,122319,2.528,10.735,46874,3.145,21.470,284,344,5187
1996,5242,108168,119435,710279,699790,11890,10.011,10566,8.896,121414,44026,77388,6.291,17.350,99235,38313,60922,5.475,14.181,22179,3.169,28.361,7554,7743,24092
1996,5259,538,570,20885,20280,34,5.709,85,14.274,4101,336,3765,1.657,20.222,2734,685,2049,3.378,13.481,1367,6.741,26.963,54,54,266
1996,5311,89766,98474,511799,512315,10848,11.048,10284,10.473,93092,41368,51724,8.075,18.171,94021,41552,52469,8.111,18.352,-929,-0.181,36.342,8137,8237,31381
1996,5312,44025,49194,209707,210522,7288,14.930,6529,13.375,44403,20287,24116,9.637,21.092,46168,19819,26349,9.414,21.930,-1765,-0.838,42.184,4520,4627,14142
1996,5313,36062,41775,406664,401089,5735,13.978,4244,10.344,78334,32924,45410,8.209,19.530,67024,20644,46380,5.147,16.711,11310,2.820,33.421,2926,3012,14411
1996,5321,4782,9649,147152,142084,872,8.929,1106,11.325,28580,6230,22350,4.385,20.115,17904,6704,11200,4.718,12.601,10676,7.514,25.202,562,587,3693
1996,5322,19386,30285,216051,231882,4105,13.501,4345,14.290,47387,20826,26561,8.981,20.436,76613,24055,52558,10.374,33.040,-29226,-12.604,40.872,3072,3455,17743
1996,5323,3834,6212,41616,41525,474,7.629,476,7.661,6584,2014,4570,4.850,15.856,6444,2321,4123,5.589,15.518,140,0.337,31.037,308,339,1503
1996,5324,7471,10200,117795,116572,1313,13.014,1091,10.814,22933,7856,15077,6.739,19.673,20564,7161,13403,6.143,17.641,2369,2.032,35.281,646,674,3305
1996,5331,1421,1529,15848,15585,281,18.259,301,19.558,4822,1404,3418,9.009,30.941,4285,2955,1330,18.961,27.495,537,3.446,54.991,191,209,1204
1996,5411,152207,159123,992796,992956,15299,9.694,12677,8.033,123957,44444,79513,4.476,12.484,123772,35964,87808,3.622,12.465,185,0.019,24.930,9657,9730,27837
1996,5412,82672,87620,901548,888995,9745,11.217,8265,9.513,143491,48103,95388,5.411,16.141,117857,34058,83799,3.831,13.257,25634,2.883,26.515,6019,6111,23539
1996,5413,74014,83217,1035565,1019135,10798,13.223,7685,9.411,176976,50099,126877,4.916,17.365,144738,48199,96539,4.729,14.202,32238,3.163,28.404,5328,5404,23728
1996,5414,19918,20130,104455,104225,3672,18.504,3100,15.622,24698,10961,13737,10.517,23.697,24354,12863,11491,12.342,23.367,344,0.330,46.734,2411,2419,9980
1996,5415,43995,49633,638108,598414,12851,27.683,6428,13.847,187037,79359,107678,13.262,31.255,107437,42760,64677,7.146,17.954,79600,13.302,35.907,4358,4429,21987
1996,5416,51560,54776,504289,488092,11309,21.364,7626,14.406,126266,48787,77479,9.995,25.869,94450,33402,61048,6.843,19.351,31816,6.518,38.702,5821,5858,25110
1996,5417,8384,10566,472484,462898,1574,15.311,1003,9.756,78970,25158,53812,5.435,17.060,60867,17668,43199,3.817,13.149,18103,3.911,26.298,607,624,4638
1996,5418,31619,34618,419739,409600,5146,15.094,4095,12.011,82397,27898,54499,6.811,20.116,62133,21357,40776,5.214,15.169,20264,4.947,30.338,3283,3306,14905
1996,5419,38495,44329,383072,377929,4311,9.852,3171,7.247,64606,18090,46516,4.787,17.095,54459,17255,37204,4.566,14.410,10147,2.685,28.820,2368,2391,12786
1996,5511,28294,51981,3219004,3209020,4818,9.306,4404,8.506,511865,149824,362041,4.669,15.951,491716,124143,367573,3.869,15.323,20149,0.628,30.646,1004,1056,15918
1996,5611,15558,16511,270150,264712,3649,22.668,2822,17.531,77515,39263,38252,14.832,29.283,66665,33240,33425,12.557,25.184,10850,4.099,50.368,1964,1985,23095
1996,5612,864,1640,79570,78141,304,19.811,93,6.061,19687,10127,9560,12.960,25.194,16232,8898,7334,11.387,20.773,3455,4.421,41.545,28,30,518
1996,5613,22307,34683,2733600,2609689,6356,19.044,3741,11.209,874646,293409,581237,11.243,33.515,629500,175164,454336,6.712,24.122,245146,9.394,48.243,2342,2457,108112
1996,5614,24499,28440,486942,461326,4397,15.704,3517,12.561,118901,49943,68958,10.826,25.774,68153,21547,46606,4.671,14.773,50748,11.000,29.547,2705,2750,13690
1996,5615,25789,32869,277643,274607,4328,13.293,3706,11.383,52675,24106,28569,8.778,19.182,47121,19252,27869,7.011,17.159,5554,2.023,34.319,2525,2608,10822
1996,5616,15176,18796,618057,610509,2848,15.391,2264,12.235,123123,36321,86802,5.949,20.167,108939,44380,64559,7.269,17.844,14184,2.323,35.688,1626,1658,21571
1996,5617,109392,114216,1279887,1259421,19625,17.477,15770,14.044,264292,84268,180024,6.691,20.985,222842,78587,144255,6.240,17.694,41450,3.291,35.388,12661,12692,59570
1996,5619,17040,18755,287888,281151,3683,20.152,2726,14.915,70383,26150,44233,9.301,25.034,56828,20744,36084,7.378,20.213,13555,4.821,40.425,2054,2075,13382
1996,5621,6536,7217,116375,113666,790,11.073,625,8.760,18436,5666,12770,4.985,16.219,13050,4227,8823,3.719,11.481,5386,4.738,22.962,508,508,3377
1996,5622,1730,2693,88761,93443,292,10.839,294,10.913,12642,2822,9820,3.020,13.529,22111,10684,11427,11.434,23.663,-9469,-10.134,27.058,173,182,2102
1996,5629,5186,5653,78246,74897,733,13.042,668,11.885,20937,9734,11203,12.997,27.955,14589,4514,10075,6.027,19.479,6348,8.476,38.958,501,502,2478
1996,6111,14886,17070,598882,592502,856,5.063,532,3.146,53149,12015,41134,2.028,8.970,40436,8360,32076,1.411,6.825,12713,2.146,13.649,360,376,6198
1996,6112,551,811,71270,72312,43,5.250,59,7.204,5926,770,5156,1.065,8.195,7906,3431,4475,4.745,10.933,-1980,-2.738,16.390,31,40,2610
1996,6113,2141,2592,1141935,1140537,131,5.092,92,3.576,62513,3380,59133,0.296,5.481,60130,5659,54471,0.496,5.272,2383,0.209,10.544,61,61,4830
1996,6114,4641,5109,55043,53186,1053,21.359,695,14.097,12997,5528,7469,10.394,24.437,9386,4461,4925,8.388,17.648,3611,6.789,35.295,532,546,3165
1996,6115,5340,6195,66870,65771,818,13.441,600,9.859,12956,4550,8406,6.918,19.699,10900,4600,6300,6.994,16.573,2056,3.126,33.145,408,423,2360
1996,6116,18726,19960,149611,146935,3351,17.199,2399,12.313,33267,14048,19219,9.561,22.641,27970,12380,15590,8.425,19.036,5297,3.605,38.071,1926,1939,9600
1996,6117,2929,3079,27364,26675,583,19.404,434,14.445,5841,2471,3370,9.264,21.897,4473,1659,2814,6.219,16.769,1368,5.128,33.538,342,342,1172
1996,6211,167433,184852,1618351,1607858,13605,7.292,17073,9.150,262333,96060,166273,5.974,16.316,240587,105309,135278,6.550,14.963,21746,1.352,29.926,13690,14059,78633
1996,6212,104310,107663,625799,617244,4986,4.651,4063,3.790,81092,20958,60134,3.395,13.138,63795,16399,47396,2.657,10.335,17297,2.802,20.671,3311,3347,13948
1996,6213,72489,77084,357309,351924,8489,11.128,6891,9.033,72774,29202,43572,8.298,20.679,61819,23420,38399,6.655,17.566,10955,3.113,35.132,5278,5411,18136
1996,6214,9003,16867,372511,361138,2364,14.448,1355,8.281,71758,31718,40040,8.783,19.870,48597,17646,30951,4.886,13.457,23161,6.413,26.913,787,868,10290
1996,6215,5215,7665,141563,142442,990,12.390,1640,20.526,22524,9497,13027,6.667,15.813,24422,14121,10301,9.914,17.145,-1898,-1.332,31.626,640,670,5813
1996,6216,8731,14983,785646,762059,3068,21.398,1777,12.394,189308,77467,111841,10.165,24.842,143408,58550,84858,7.683,18.819,45900,6.023,37.637,651,743,20402
1996,6219,5264,7185,176887,173160,686,9.454,829,11.424,34541,8285,26256,4.785,19.947,26755,10541,16214,6.087,15.451,7786,4.496,30.902,557,579,6814
1996,6221,2722,4498,4057634,4052418,117,2.600,121,2.689,222825,67282,155543,1.660,5.499,209993,40263,169730,0.994,5.182,12832,0.317,10.364,63,63,14530
1996,6222,547,844,276363,288481,31,3.563,83,9.540,9854,4680,5174,1.622,3.416,33792,10509,23283,3.643,11.714,-23938,-8.298,6.832,28,32,7456
1996,6223,228,362,127061,127766,19,5.249,19,5.249,7138,3171,3967,2.482,5.587,8574,1522,7052,1.191,6.711,-1436,-1.124,11.174,9,9,735
1996,6231,8164,14772,1472532,1462689,896,6.092,770,5.235,147796,56143,91653,3.838,10.104,127175,44110,83065,3.016,8.695,20621,1.410,17.389,487,511,28004
1996,6232,7644,18341,357063,348249,1876,10.600,589,3.328,54434,19554,34880,5.615,15.631,36848,7800,29048,2.240,10.581,17586,5.050,21.162,386,401,5028
1996,6233,11693,13930,349451,342878,2033,14.856,1542,11.268,52370,21154,31216,6.170,15.274,39274,18105,21169,5.280,11.454,13096,3.819,22.908,1009,1067,11256
1996,6239,4039,6129,157274,154688,571,9.458,387,6.410,20075,7454,12621,4.819,12.978,15111,4788,10323,3.095,9.769,4964,3.209,19.537,234,245,2607
1996,6241,25798,35837,536989,528681,3907,11.172,2177,6.225,78080,25689,52391,4.859,14.769,61648,12078,49570,2.285,11.661,16432,3.108,23.321,1432,1471,7765
1996,6242,6619,8226,81864,81176,763,9.430,493,6.093,12121,4468,7653,5.504,14.932,10652,2850,7802,3.511,13.122,1469,1.810,26.244,339,346,1729
1996,6243,5518,8690,311639,314113,683,7.919,552,6.400,40131,8040,32091,2.560,12.776,44861,7749,37112,2.467,14.282,-4730,-1.506,25.552,256,312,3794
1996,6244,44803,55345,585485,575555,6809,12.506,5013,9.207,95852,40626,55226,7.059,16.654,76288,27249,49039,4.734,13.255,19564,3.399,26.509,4006,4076,21158
1996,7111,6940,7026,93676,93892,1173,17.002,919,13.321,20585,7027,13558,7.484,21.924,20997,4771,16226,5.081,22.363,-412,-0.439,43.848,651,652,3343
1996,7112,2976,3092,81370,78047,574,18.972,441,14.576,20093,6622,13471,8.485,25.745,13415,4617,8798,5.916,17.188,6678,8.556,34.377,341,346,3543
1996,7113,2759,2860,56867,54294,489,17.514,353,12.643,13879,4541,9338,8.364,25.563,8643,2871,5772,5.288,15.919,5236,9.644,31.838,277,278,2489
1996,7114,1941,1990,13644,13287,380,19.854,228,11.912,3664,2170,1494,16.332,27.577,2939,1698,1241,12.780,22.120,725,5.457,44.240,178,178,1241
1996,7115,7743,7795,46990,44599,1534,20.143,1175,15.429,17441,4930,12511,11.054,39.106,12858,4404,8454,9.875,28.830,4583,10.276,57.660,756,760,2677
1996,7121,3729,4071,77430,76985,339,8.485,188,4.705,7641,1322,6319,1.717,9.925,6893,679,6214,0.882,8.954,748,0.972,17.907,126,126,566
1996,7131,1734,2924,132429,127433,328,11.235,319,10.927,26440,11866,14574,9.312,20.748,16233,2502,13731,1.963,12.738,10207,8.010,25.477,234,237,1643
1996,7132,1427,1702,115261,105715,296,18.137,156,9.559,29640,13673,15967,12.934,28.038,11011,1772,9239,1.676,10.416,18629,17.622,20.832,107,108,1290
1996,7139,43074,46536,760698,756800,5445,11.811,4576,9.926,124606,48338,76268,6.387,16.465,116317,38883,77434,5.138,15.370,8289,1.095,30.739,3599,3636,30804
1996,7211,32056,39296,1513718,1501389,4508,11.619,3511,9.050,241433,138510,102923,9.225,16.081,216404,101459,114945,6.758,14.414,25029,1.667,28.827,2458,2523,62153
1996,7212,4858,5308,35179,34261,576,10.963,468,8.907,7372,2744,4628,8.009,21.517,5561,1685,3876,4.918,16.231,1811,5.286,32.463,322,323,1228
1996,7213,2972,3063,15476,15605,209,6.733,291,9.375,2196,500,1696,3.204,14.072,2435,1125,1310,7.209,15.604,-239,-1.532,28.145,225,225,961
1996,7223,10728,23378,446424,441608,3987,17.490,2823,12.384,83579,45367,38212,10.273,18.926,73704,28111,45593,6.366,16.690,9875,2.236,33.380,2197,2210,17931
1996,7224,48870,49392,328005,328080,6706,13.493,7321,14.731,78604,40304,38300,12.285,23.959,79154,38393,40761,11.702,24.126,-550,-0.168,47.918,6170,6184,32048
1996,7225,256429,352058,6677989,6591206,49224,14.148,40974,11.776,1308910,715249,593661,10.852,19.858,1135068,455160,679908,6.906,17.221,173842,2.637,34.442,29682,30720,291169
1996,8111,134115,145826,799621,780263,18290,12.721,14194,9.872,159944,68485,91459,8.777,20.499,121040,49516,71524,6.346,15.513,38904,4.986,31.025,11033,11193,39686
1996,8112,13922,16556,148625,145396,2248,13.699,1956,11.920,31956,11118,20838,7.647,21.979,25447,10281,15166,7.071,17.502,6509,4.477,35.004,1292,1374,5922
1996,8113,22118,23622,192614,189773,2592,11.040,2304,9.813,34554,11096,23458,5.847,18.208,28703,10048,18655,5.295,15.125,5851,3.083,30.250,1742,1744,7099
1996,8114,25839,27628,157429,159511,3566,12.928,3477,12.605,25539,9930,15609,6.225,16.011,29435,10325,19110,6.473,18.453,-3896,-2.442,32.022,2799,2807,8168
1996,8121,76012,86790,455932,454469,11227,12.938,11204,12.911,90431,44433,45998,9.777,19.898,86778,36932,49846,8.126,19.094,3653,0.804,38.189,8900,9100,29477
1996,8122,16158,21131,148187,147245,1314,6.222,1288,6.099,24177,9561,14616,6.493,16.420,21996,7222,14774,4.905,14.938,2181,1.481,29.877,819,870,4212
1996,8123,34599,41266,386221,384879,4311,10.425,4485,10.846,57053,22606,34447,5.874,14.824,54409,21450,32959,5.573,14.137,2644,0.687,28.273,3350,3494,16288
1996,8129,15555,24629,187252,181623,3440,14.064,3101,12.678,46000,18565,27435,10.222,25.327,35009,15557,19452,8.566,19.276,10991,6.052,38.551,1784,1873,9495
1996,8131,150670,150789,1372004,1346639,8609,5.781,4877,3.275,164499,24568,139931,1.824,12.216,113242,13598,99644,1.010,8.409,51257,3.806,16.818,3027,3027,8184
1996,8132,11768,13600,164130,163298,999,7.429,693,5.154,20802,4474,16328,2.740,12.739,19070,3340,15730,2.045,11.678,1732,1.061,23.356,477,485,2483
1996,8133,10037,11891,129332,129316,992,8.442,712,6.059,17279,5110,12169,3.952,13.362,17192,3301,13891,2.553,13.295,87,0.067,26.589,468,487,2240
1996,8134,31000,32882,332213,330818,1503,4.549,1821,5.511,37955,6205,31750,1.876,11.473,35160,6324,28836,1.912,10.628,2795,0.845,21.256,1371,1373,4735
1996,8139,64438,66667,512864,512182,4057,6.085,4074,6.110,66754,15695,51059,3.064,13.033,65221,16296,48925,3.182,12.734,1533,0.299,25.468,2969,2989,10800
1997,1131,219,269,2808,2773,35,12.987,36,13.358,604,112,492,4.040,21.785,542,164,378,5.915,19.549,62,2.236,39.098,31,32,71
1997,1132,128,167,1922,1928,27,17.089,9,5.696,612,243,369,12.607,31.751,566,72,494,3.735,29.364,46,2.387,58.729,6,6,58
1997,1133,11785,11850,80798,81814,1465,12.237,1708,14.267,15454,5134,10320,6.275,18.889,17526,6361,11165,7.775,21.422,-2072,-2.533,37.778,1315,1316,4613
1997,1141,1242,1251,9623,9520,227,18.343,200,16.162,2172,734,1438,7.710,22.815,2016,1021,995,10.725,21.176,156,1.639,42.353,125,125,693
1997,1142,238,242,2120,1919,34,14.376,23,9.725,557,332,225,17.305,29.033,170,93,77,4.848,8.861,387,20.172,17.722,16,17,58
1997,1151,4535,4882,66717,63986,542,11.100,544,11.141,18114,7074,11040,11.056,28.309,12501,5025,7476,7.853,19.537,5613,8.772,39.074,379,387,3312
1997,1152,2787,2826,17223,16927,472,17.101,340,12.319,3289,1373,1916,8.112,19.431,2693,1142,1551,6.747,15.910,596,3.521,31.820,264,264,947
1997,1153,1167,1200,14458,14332,168,14.100,151,12.673,2756,595,2161,4.152,19.230,2518,713,1805,4.975,17.570,238,1.661,35.139,114,114,448
1997,2111,6193,7320,99323,95556,716,9.691,852,11.532,28396,8885,19511,9.298,29.717,20641,6990,13651,7.315,21.601,7755,8.116,43.202,524,529,2258
1997,2121,969,1368,83860,84851,174,12.254,278,19.577,12578,5140,7438,6.058,14.824,14449,6167,8282,7.268,17.029,-1871,-2.205,29.647,168,173,3057
1997,2122,332,465,42608,42252,72,15.434,75,16.077,4719,889,3830,2.104,11.169,3951,1185,2766,2.805,9.351,768,1.818,18.702,46,48,552
1997,2123,3272,5007,98050,97762,365,7.307,341,6.827,14134,4007,10127,4.099,14.458,13586,3448,10138,3.527,13.897,548,0.561,27.794,186,191,1475
1997,2131,7011,8128,154960,152877,1103,13.607,1059,13.064,41028,16315,24713,10.672,26.837,36280,20858,15422,13.644,23.732,4748,3.106,47.463,673,677,5981
1997,2211,1545,7695,552574,560663,452,5.879,440,5.722,38279,13772,24507,2.456,6.827,54129,7103,47026,1.267,9.654,-15850,-2.827,13.655,64,64,611
1997,2212,580,2631,99997,100031,160,6.028,207,7.798,11872,2999,8873,2.998,11.868,11740,3701,8039,3.700,11.736,132,0.132,23.473,61,64,1252
1997,2213,4089,4549,33797,33752,281,6.186,268,5.900,4168,1232,2936,3.650,12.349,4116,1892,2224,5.606,12.195,52,0.154,24.390,186,187,937
1997,2361,125940,126551,641757,627119,23330,18.687,19915,15.952,184504,74124,110380,11.820,29.421,155109,68085,87024,10.857,24.734,29395,4.687,49.467,14491,14495,51944
1997,2362,40082,40810,693990,681290,5263,13.046,4327,10.726,148237,30533,117704,4.482,21.758,122439,33804,88635,4.962,17.972,25798,3.787,35.943,3162,3164,22773
1997,2371,15603,15886,364418,354167,1418,8.994,1177,7.466,83559,14657,68902,4.138,23.593,63198,17304,45894,4.886,17.844,20361,5.749,35.688,854,855,6311
1997,2372,8486,8627,51870,51159,1838,21.721,1508,17.821,15708,7377,8331,14.420,30.704,14536,7453,7083,14.568,28.413,1172,2.291,56.827,1164,1165,4372
1997,2373,10679,11039,258057,251861,996,9.064,896,8.154,52449,8065,44384,3.202,20.825,40324,9043,31281,3.590,16.010,12125,4.814,32.021,602,603,5286
1997,2379,4689,4769,64687,64759,605,12.611,662,13.799,14951,3212,11739,4.960,23.087,14989,4159,10830,6.422,23.146,-38,-0.059,46.175,510,510,2996
1997,2381,88675,89094,840925,810350,12874,14.665,10262,11.690,223785,58973,164812,7.277,27.616,162355,51191,111164,6.317,20.035,61430,7.581,40.070,7868,7892,41386
1997,2382,138107,140030,1505290,1461955,15960,11.528,12798,9.244,302425,66758,235667,4.566,20.686,216640,63665,152975,4.355,14.819,85785,5.868,29.637,9815,9826,49423
1997,2383,91674,92148,712141,690366,15343,16.846,13200,14.493,189929,55864,134065,8.092,27.511,146374,54738,91636,7.929,21.202,43555,6.309,42.405,10171,10179,43393
1997,2389,46804,47062,380045,369383,6559,14.120,5337,11.490,96501,29968,66533,8.113,26.125,75332,28282,47050,7.657,20.394,21169,5.731,40.788,4029,4029,20315
1997,3111,1019,1628,45974,46285,90,5.473,123,7.479,4214,1195,3019,2.582,9.104,4847,1572,3275,3.396,10.472,-633,-1.368,18.209,69,71,674
1997,3112,503,859,62926,63020,47,5.475,46,5.358,3575,538,3037,0.854,5.673,3667,827,2840,1.312,5.819,-92,-0.146,11.346,28,28,215
1997,3113,1423,1607,84111,83285,162,10.084,161,10.022,9160,1601,7559,1.922,10.998,7387,1994,5393,2.394,8.870,1773,2.129,17.739,110,111,1359
1997,3114,1284,1671,168091,169148,111,6.615,125,7.449,15306,2472,12834,1.461,9.049,17210,4985,12225,2.947,10.175,-1904,-1.126,18.098,73,77,1373
1997,3115,1188,1693,129348,129751,87,5.094,117,6.850,11726,2047,9679,1.578,9.037,12476,3798,8678,2.927,9.615,-750,-0.578,18.075,71,74,1295
1997,3116,3488,4093,452239,455263,269,6.535,316,7.676,35400,7007,28393,1.539,7.776,41872,14474,27398,3.179,9.197,-6472,-1.422,15.551,234,236,6830
1997,3117,641,747,41518,42423,81,10.800,87,11.600,6397,858,5539,2.022,15.079,8204,2857,5347,6.735,19.339,-1807,-4.259,30.158,58,62,1066
1997,3118,9237,10051,304474,308424,1263,12.486,1392,13.761,36440,10319,26121,3.346,11.815,44030,15236,28794,4.940,14.276,-7590,-2.461,23.630,1025,1045,7197
1997,3119,2197,2559,143106,141465,226,8.816,235,9.167,18937,2784,16153,1.968,13.386,15769,5636,10133,3.984,11.147,3168,2.239,22.294,162,162,2257
1997,3121,1920,2349,137646,136894,269,11.670,181,7.852,12767,2961,9806,2.163,9.326,11461,3005,8456,2.195,8.372,1306,0.954,16.744,129,132,1897
1997,3122,71,103,30516,29669,15,15.306,5,5.102,3015,559,2456,1.884,10.162,1401,21,1380,0.071,4.722,1614,5.440,9.444,5,5,21
1997,3131,337,572,81870,83285,46,7.986,54,9.375,7947,2662,5285,3.196,9.542,10844,4185,6659,5.025,13.020,-2897,-3.478,19.084,27,28,680
1997,3132,1674,2002,216474,217671,152,7.519,191,9.448,18472,3755,14717,1.725,8.486,20783,8173,12610,3.755,9.548,-2311,-1.062,16.972,132,133,2293
1997,3133,3255,3592,112451,113983,304,8.003,717,18.876,13276,3353,9923,2.942,11.647,16463,6543,9920,5.740,14.443,-3187,-2.796,23.295,572,575,4275
1997,3141,2826,3072,127466,126650,256,8.200,356,11.403,14447,3417,11030,2.698,11.407,12584,4052,8532,3.199,9.936,1863,1.471,19.872,276,278,1703
1997,3149,4364,4493,109669,109455,535,11.957,498,11.130,17181,5506,11675,5.030,15.697,16794,6709,10085,6.129,15.343,387,0.354,30.687,383,383,4310
1997,3151,1086,1192,103976,106802,102,8.395,148,12.181,9869,1936,7933,1.813,9.241,15434,4788,10646,4.483,14.451,-5565,-5.211,18.481,114,115,1918
1997,3152,10401,11218,521314,539658,1947,17.029,2378,20.799,85294,33272,52022,6.165,15.805,122181,63523,58658,11.771,22.640,-36887,-6.835,31.610,2041,2059,42108
1997,3159,2028,2144,57870,57834,283,13.271,260,12.192,9003,4179,4824,7.226,15.567,8862,2675,6187,4.625,15.323,141,0.244,30.646,215,215,1767
1997,3161,305,334,16251,15943,27,7.988,35,10.355,2304,718,1586,4.504,14.452,1720,375,1345,2.352,10.789,584,3.663,21.578,31,31,190
1997,3162,319,383,44343,45090,30,7.792,34,8.831,4345,1359,2986,3.014,9.636,5593,2676,2917,5.935,12.404,-1248,-2.768,19.273,23,23,705
1997,3169,966,996,29195,29378,89,8.865,105,10.458,3524,832,2692,2.832,11.996,3898,1237,2661,4.211,13.269,-374,-1.273,23.991,87,87,608
1997,3211,4101,4569,129751,129050,320,6.933,413,8.948,14914,2957,11957,2.291,11.557,13480,4589,8891,3.556,10.446,1434,1.111,20.891,331,332,2204
1997,3212,1404,1752,111205,110749,111,6.350,103,5.892,11301,2234,9067,2.017,10.204,10402,2991,7411,2.701,9.392,899,0.812,18.785,71,73,1332
1997,3219,8994,9721,316483,309642,979,10.088,947,9.758,45515,9140,36375,2.952,14.699,31629,9939,21690,3.210,10.215,13886,4.485,20.429,734,734,6329
1997,3221,206,508,173035,174813,11,2.138,24,4.665,6176,2468,3708,1.412,3.533,9586,3581,6005,2.048,5.484,-3410,-1.951,7.066,8,8,73
1997,3222,3481,5154,397588,397839,263,5.071,327,6.305,38074,13591,24483,3.416,9.570,38990,19338,19652,4.861,9.800,-916,-0.230,19.140,183,185,3512
1997,3231,38412,40273,821727,827724,2657,6.509,3757,9.203,90476,21471,69005,2.594,10.931,102608,41267,61341,4.986,12.396,-12132,-1.466,21.861,3067,3076,20973
1997,3241,1091,2049,106290,107477,111,5.382,138,6.691,9004,3967,5037,3.691,8.378,11388,4006,7382,3.727,10.596,-2384,-2.218,16.755,62,65,743
1997,3251,1083,2260,207064,210340,157,6.942,160,7.075,10810,3209,7601,1.526,5.139,17361,3643,13718,1.732,8.254,-6551,-3.114,10.279,56,67,972
1997,3252,436,749,120969,120000,48,6.396,51,6.795,8082,2697,5385,2.248,6.735,6220,1624,4596,1.353,5.183,1862,1.552,10.367,31,31,565
1997,3253,644,858,36110,35922,49,5.665,63,7.283,3168,358,2810,0.997,8.819,2749,811,1938,2.258,7.653,419,1.166,15.305,29,30,317
1997,3254,1285,1606,204267,202353,133,8.320,118,7.382,25835,2554,23281,1.262,12.767,20840,4846,15994,2.395,10.299,4995,2.468,20.598,66,68,1177
1997,3255,1618,2074,73452,73248,131,6.301,141,6.782,8691,2100,6591,2.867,11.865,8277,2914,5363,3.978,11.300,414,0.565,22.600,86,87,1114
1997,3256,2076,2278,122912,124397,189,8.273,202,8.842,13047,2298,10749,1.847,10.488,15815,8063,7752,6.482,12.713,-2768,-2.225,20.976,136,136,1375
1997,3259,2119,2773,125053,124417,198,7.120,214,7.695,11770,2058,9712,1.654,9.460,10497,2947,7550,2.369,8.437,1273,1.023,16.874,127,127,1125
1997,3261,10659,13030,789803,781364,895,6.874,875,6.720,95468,19943,75525,2.552,12.218,78755,25983,52772,3.325,10.079,16713,2.139,20.158,600,606,13417
1997,3262,2083,2600,195829,196204,175,6.690,207,7.913,16321,3721,12600,1.897,8.318,16920,5359,11561,2.731,8.624,-599,-0.305,16.637,144,154,2779
1997,3271,1542,1792,80312,79168,129,7.119,169,9.327,8764,735,8029,0.928,11.070,6533,1638,4895,2.069,8.252,2231,2.818,16.504,118,118,715
1997,3272,1811,2077,131655,132135,204,9.917,164,7.973,12203,3652,8551,2.764,9.235,12789,3161,9628,2.392,9.679,-586,-0.443,18.471,124,124,652
1997,3273,5538,8739,186600,183660,553,6.334,537,6.150,27770,6445,21325,3.509,15.120,22169,6563,15606,3.573,12.071,5601,3.050,24.141,315,320,3605
1997,3274,233,356,19299,19191,20,5.533,31,8.575,1709,271,1438,1.412,8.905,1501,320,1181,1.667,7.822,208,1.084,15.643,23,23,228
1997,3279,1971,2343,72472,72263,192,8.246,163,7.000,8313,1812,6501,2.508,11.504,7771,2767,5004,3.829,10.754,542,0.750,21.508,120,121,1359
1997,3311,184,265,145471,148834,24,8.989,28,10.487,3300,643,2657,0.432,2.217,9838,1264,8574,0.849,6.610,-6538,-4.393,4.434,21,21,1185
1997,3312,484,673,65457,65749,27,3.976,39,5.744,4097,329,3768,0.500,6.231,4660,1024,3636,1.557,7.088,-563,-0.856,12.463,33,33,910
1997,3313,336,505,83332,82692,38,7.654,21,4.230,6226,2197,4029,2.657,7.529,4983,1315,3668,1.590,6.026,1243,1.503,12.052,11,11,178
1997,3314,685,865,81433,80299,56,6.508,47,5.462,7273,1759,5514,2.191,9.057,5032,1484,3548,1.848,6.267,2241,2.791,12.533,26,27,136
1997,3315,2355,2646,218556,217682,121,4.547,151,5.675,18708,3313,15395,1.522,8.594,16966,3612,13354,1.659,7.794,1742,0.800,15.588,110,110,1679
1997,3321,2755,2971,140897,139091,138,4.597,200,6.662,15405,3596,11809,2.585,11.075,11626,4760,6866,3.422,8.359,3779,2.717,16.717,153,154,3248
1997,3322,1472,1612,77965,77861,105,6.569,78,4.880,5784,617,5167,0.792,7.429,5479,1366,4113,1.754,7.037,305,0.392,14.074,55,55,337
1997,3323,10881,11677,364815,358259,805,6.907,759,6.513,49413,9880,39533,2.758,13.793,36397,11543,24854,3.222,10.159,13016,3.633,20.319,547,547,5251
1997,3324,1436,1758,104348,105190,81,4.557,120,6.751,9479,1212,8267,1.152,9.011,11239,3651,7588,3.471,10.685,-1760,-1.673,18.023,70,70,1612
1997,3325,795,881,66747,65698,53,5.975,65,7.328,6905,573,6332,0.872,10.510,4775,927,3848,1.411,7.268,2130,3.242,14.536,42,46,563
1997,3326,1590,1765,68503,68198,117,6.642,110,6.245,6180,920,5260,1.349,9.062,5605,1514,4091,2.220,8.219,575,0.843,16.438,75,75,483
1997,3327,24869,25258,410703,403323,2114,8.450,1635,6.535,53310,11090,42220,2.750,13.218,38697,11465,27232,2.843,9.595,14613,3.623,19.189,1296,1296,8376
1997,3328,5573,6046,150639,147076,423,7.034,358,5.953,20993,4508,16485,3.065,14.274,13894,3204,10690,2.178,9.447,7099,4.827,18.894,267,269,2070
1997,3329,5441,5946,305599,303634,509,8.618,430,7.280,28925,5626,23299,1.853,9.526,25091,7321,17770,2.411,8.264,3834,1.263,16.527,315,315,3310
1997,3331,2637,2913,206701,203183,212,7.274,215,7.377,22118,4485,17633,2.207,10.886,14903,2983,11920,1.468,7.335,7215,3.551,14.670,167,167,1705
1997,3332,4073,4331,178969,180336,381,8.851,328,7.620,20599,3654,16945,2.026,11.423,23256,5304,17952,2.941,12.896,-2657,-1.473,22.845,222,223,2087
1997,3333,2343,2479,129888,129055,215,8.692,204,8.247,13809,3095,10714,2.398,10.700,12310,2991,9319,2.318,9.539,1499,1.162,19.077,151,151,1604
1997,3334,1474,1758,171907,170937,122,6.924,130,7.378,16011,4062,11949,2.376,9.367,14238,4739,9499,2.772,8.329,1773,1.037,16.659,96,96,1439
1997,3335,9501,9857,239821,238019,551,5.591,547,5.550,25319,5482,19837,2.303,10.637,21634,6365,15269,2.674,9.089,3685,1.548,18.178,437,437,3529
1997,3336,736,894,110699,110452,42,4.711,37,4.150,7984,1755,6229,1.589,7.229,7276,966,6310,0.875,6.588,708,0.641,13.175,27,28,346
1997,3339,5978,6615,349468,347974,438,6.652,376,5.711,37804,9625,28179,2.766,10.864,34222,12368,21854,3.554,9.835,3582,1.029,19.669,270,273,5249
1997,3341,1614,1712,222078,217253,210,12.335,191,11.219,27795,3332,24463,1.534,12.794,18198,7190,11008,3.310,8.376,9597,4.417,16.753,138,139,2113
1997,3342,1821,2016,238263,231778,149,7.360,166,8.200,32034,3661,28373,1.580,13.821,18894,4677,14217,2.018,8.152,13140,5.669,16.304,100,100,1621
1997,3343,493,527,32190,31725,68,12.940,65,12.369,4523,1405,3118,4.429,14.257,3590,908,2682,2.862,11.316,933,2.941,22.632,47,47,317
1997,3344,5087,5698,549269,545842,516,9.096,466,8.214,62073,15732,46341,2.882,11.372,55926,13433,42493,2.461,10.246,6147,1.126,20.492,337,338,5135
1997,3345,4523,5125,483734,487279,359,7.002,363,7.080,49779,16418,33361,3.369,10.216,57191,24198,32993,4.966,11.737,-7412,-1.521,20.431,245,245,2504
1997,3346,758,825,48290,47183,100,12.376,66,8.168,7459,1133,6326,2.401,15.809,5230,1024,4206,2.170,11.085,2229,4.724,22.169,50,50,325
1997,3351,1121,1230,72948,73305,78,6.247,115,9.211,6177,740,5437,1.009,8.426,6801,2164,4637,2.952,9.278,-624,-0.851,16.853,78,78,895
1997,3352,236,303,98468,100729,18,5.797,33,10.628,6342,1284,5058,1.275,6.296,11008,4409,6599,4.377,10.928,-4666,-4.632,12.592,26,26,566
1997,3353,2380,2792,206862,206330,160,5.746,145,5.207,16945,3969,12976,1.924,8.213,15811,5669,10142,2.748,7.663,1134,0.550,15.326,90,91,980
1997,3359,1760,2140,192594,190417,156,7.269,168,7.829,18523,2543,15980,1.335,9.728,14358,5184,9174,2.722,7.540,4165,2.187,15.081,97,97,1870
1997,3361,266,330,224699,217831,53,16.258,45,13.804,22860,4558,18302,2.092,10.494,9358,3383,5975,1.553,4.296,13502,6.198,8.592,23,23,339
1997,3362,1781,1961,120502,122613,164,8.333,178,9.045,11812,2032,9780,1.657,9.634,15954,4575,11379,3.731,13.012,-4142,-3.378,19.267,124,124,3317
1997,3363,4585,5634,777712,760830,431,7.664,411,7.308,84693,21303,63390,2.800,11.132,50542,11984,38558,1.575,6.643,34151,4.489,13.286,246,250,3472
1997,3364,1375,1654,446385,433916,115,6.928,127,7.651,53929,5582,48347,1.286,12.428,27391,17824,9567,4.108,6.313,26538,6.116,12.625,68,68,965
1997,3365,164,221,28598,29735,12,5.286,24,10.573,2383,475,1908,1.597,8.014,4444,1219,3225,4.100,14.946,-2061,-6.931,16.029,12,12,150
1997,3366,1469,1572,139091,138676,178,11.436,147,9.444,17045,4863,12182,3.507,12.291,16264,4559,11705,3.288,11.728,781,0.563,23.456,82,83,1620
1997,3369,631,655,37405,36827,76,11.541,83,12.604,4167,403,3764,1.094,11.315,3125,781,2344,2.121,8.486,1042,2.829,16.971,55,55,330
1997,3371,13065,13564,375484,373809,1523,11.170,1664,12.204,45224,11951,33273,3.197,12.098,41861,16521,25340,4.420,11.199,3363,0.900,22.397,1248,1265,9780
1997,3372,4045,4260,176455,172730,377,8.928,302,7.152,22362,3565,18797,2.064,12.946,14858,4726,10132,2.736,8.602,7504,4.344,17.204,225,228,2323
1997,3379,998,1118,40736,40578,72,6.344,106,9.339,4675,791,3884,1.949,11.521,4328,1713,2615,4.221,10.666,347,0.855,21.332,88,88,1085
1997,3391,11085,11620,271174,272858,932,8.013,953,8.194,31693,7486,24207,2.744,11.615,35232,15493,19739,5.678,12.912,-3539,-1.297,23.230,713,726,7236
1997,3399,16489,17062,424215,424070,1786,10.476,1760,10.323,56320,15994,40326,3.772,13.281,55933,21193,34740,4.998,13.190,387,0.091,26.379,1429,1437,11061
1997,4231,17741,21747,282337,278200,2172,9.830,2869,12.985,48286,12879,35407,4.629,17.357,39739,15817,23922,5.685,14.284,8547,3.072,28.569,1664,1724,8110
1997,4232,9587,10738,137481,134824,1254,11.775,1078,10.122,23082,6178,16904,4.582,17.120,17920,6116,11804,4.536,13.291,5162,3.829,26.583,747,763,3661
1997,4233,8316,11144,139484,136173,1253,11.320,1103,9.965,25619,8303,17316,6.097,18.814,18967,7880,11087,5.787,13.929,6652,4.885,27.857,755,773,4610
1997,4234,28620,36446,637213,623448,4480,12.250,4729,12.931,139309,41926,97383,6.725,22.345,111897,49993,61904,8.019,17.948,27412,4.397,35.896,2814,3005,21202
1997,4235,7861,10396,160019,155824,847,8.194,728,7.043,24479,6736,17743,4.323,15.709,16152,4708,11444,3.021,10.366,8327,5.344,20.731,432,445,2947
1997,4236,19612,28642,398083,389321,3067,10.740,2896,10.141,75198,21072,54126,5.413,19.315,57163,22388,34775,5.751,14.683,18035,4.632,29.365,1610,1686,11263
1997,4237,11320,15981,183650,181597,1202,7.522,1200,7.509,26685,7048,19637,3.881,14.695,22501,7194,15307,3.962,12.391,4184,2.304,24.781,721,748,4128
1997,4238,49640,64604,715235,709660,5150,7.977,5066,7.847,102180,25966,76214,3.659,14.398,91180,31121,60059,4.385,12.848,11000,1.550,25.697,3074,3170,16642
1997,4239,27965,30256,312101,311286,4016,13.331,3756,12.468,57921,20758,37163,6.668,18.607,56675,21521,35154,6.914,18.207,1246,0.400,36.413,2875,2904,13237
1997,4241,9849,12741,203834,203809,1052,8.218,1173,9.163,26195,6281,19914,3.082,12.853,26052,10983,15069,5.389,12.783,143,0.070,25.565,680,695,4365
1997,4242,4841,6236,163833,161048,1047,17.189,757,12.428,32408,9090,23318,5.644,20.123,27262,13089,14173,8.127,16.928,5146,3.195,33.856,475,482,4324
1997,4243,12985,13904,167230,165165,2149,15.627,1844,13.409,33538,9317,24221,5.641,20.306,29258,11381,17877,6.891,17.714,4280,2.591,35.429,1486,1493,7494
1997,4244,27892,33575,744927,737992,3573,10.578,3976,11.771,121640,33339,88301,4.518,16.483,107553,44489,63064,6.028,14.574,14087,1.909,29.147,2827,2868,23048
1997,4245,5295,8203,70834,71561,481,5.770,748,8.973,10290,2646,7644,3.698,14.379,11655,4008,7647,5.601,16.287,-1365,-1.907,28.759,418,450,2455
1997,4246,9728,13649,158914,158895,1270,9.323,1215,8.920,27538,9002,18536,5.665,17.331,27900,10038,17862,6.317,17.559,-362,-0.228,34.662,576,615,4089
1997,4247,7395,10420,126079,125998,559,5.256,988,9.291,19027,3685,15342,2.925,15.101,18962,5956,13006,4.727,15.049,65,0.052,30.099,400,420,2658
1997,4248,3188,4116,138568,138221,250,5.982,376,8.997,15454,3884,11570,2.810,11.181,14793,5832,8961,4.219,10.702,661,0.478,21.405,228,244,3154
1997,4249,22154,26411,336062,333706,3779,14.317,3746,14.192,65119,21284,43835,6.378,19.514,60695,24034,36661,7.202,18.188,4424,1.326,36.376,2655,2688,12463
1997,4251,33524,35842,284087,280185,4055,11.415,3418,9.622,53242,18290,34952,6.528,19.002,45761,20121,25640,7.181,16.332,7481,2.670,32.665,2199,2224,11417
1997,4411,41979,44778,1118034,1102139,4650,10.445,4134,9.286,144527,46229,98298,4.194,13.113,112439,43146,69293,3.915,10.202,32088,2.911,20.404,3126,3157,29138
1997,4412,11523,12365,101789,99919,1215,9.881,1078,8.767,18043,5431,12612,5.435,18.058,14155,5428,8727,5.432,14.166,3888,3.891,28.333,807,829,3818
1997,4413,37273,60600,525156,524044,4990,8.236,4967,8.198,76895,30618,46277,5.843,14.673,74883,26769,48114,5.108,14.289,2012,0.384,28.579,2960,3144,14305
1997,4421,19800,27487,252727,252927,3245,11.860,2994,10.942,44901,18346,26555,7.253,17.753,45454,16574,28880,6.553,17.971,-553,-0.219,35.505,1957,2117,9404
1997,4422,23971,32388,231378,228406,3552,10.977,3491,10.789,46020,17962,28058,7.864,20.148,40433,15011,25422,6.572,17.702,5587,2.446,35.405,2094,2248,7996
1997,4431,31784,48629,423202,423678,6325,13.046,6028,12.434,88668,39170,49498,9.245,20.928,90197,37139,53058,8.766,21.289,-1529,-0.361,41.856,3563,3771,17394
1997,4441,49674,71030,983745,959135,5226,7.367,5042,7.108,154951,68346,86605,7.126,16.155,107188,44451,62737,4.634,11.175,47763,4.980,22.351,3157,3347,20189
1997,4442,16477,20552,172810,171728,1558,7.533,1818,8.790,28026,7444,20582,4.335,16.320,25956,8535,17421,4.970,15.115,2070,1.205,30.229,1220,1243,4700
1997,4451,60006,88184,2607002,2608648,9852,11.148,10226,11.572,356320,177178,179142,6.792,13.659,360272,111062,249210,4.257,13.811,-3952,-0.151,27.318,6929,7110,42469
1997,4452,15910,19714,123965,126808,2515,12.424,3574,17.655,26589,11365,15224,8.962,20.968,31779,16640,15139,13.122,25.061,-5190,-4.093,41.936,2163,2213,9164
1997,4453,23066,26589,127658,129013,2274,8.440,2983,11.071,21415,7210,14205,5.589,16.599,24201,10416,13785,8.074,18.759,-2786,-2.159,33.198,2087,2150,7175
1997,4461,41264,78283,893010,836750,8365,10.765,7203,9.270,223353,68487,154866,8.185,26.693,112435,47317,65118,5.655,13.437,110918,13.256,26.874,4357,4750,26562
1997,4471,65676,118056,905626,910438,10055,8.479,11124,9.380,163883,64673,99210,7.104,18.000,171963,67811,104152,7.448,18.888,-8080,-0.887,36.001,6993,7384,39014
1997,4481,39772,87279,885632,897167,9957,11.101,14785,16.484,167472,75297,92175,8.393,18.667,187742,84508,103234,9.419,20.926,-20270,-2.259,37.334,5713,6957,26963
1997,4482,7022,28615,181363,183101,2361,7.989,4239,14.343,38729,16361,22368,8.936,21.152,41542,19693,21849,10.755,22.688,-2813,-1.536,42.304,887,1065,5270
1997,4483,18678,28386,162758,156901,2964,10.457,2880,10.161,38489,11447,27042,7.296,24.531,26366,9659,16707,6.156,16.804,12123,7.727,33.608,1664,1779,4820
1997,4511,30800,41872,359222,368739,4728,11.125,5978,14.067,64535,26085,38450,7.074,17.502,82949,32606,50343,8.843,22.495,-18414,-4.994,35.003,3641,4045,16910
1997,4512,8024,13682,129079,126192,1354,9.797,1630,11.795,26806,10282,16524,8.148,21.242,20675,8448,12227,6.695,16.384,6131,4.858,32.768,1028,1069,4975
1997,4522,75,6254,1051427,1066068,170,2.711,203,3.237,97195,25606,71589,2.402,9.117,125923,19722,106201,1.850,11.812,-28728,-2.695,18.234,5,7,817
1997,4523,9064,27596,1457634,1394843,3088,11.148,3295,11.896,260722,66579,194143,4.773,18.692,138344,50965,87379,3.654,9.918,122378,8.774,19.836,1439,1811,11385
1997,4531,22420,23631,121845,122242,2364,9.884,2935,12.272,22513,7167,15346,5.863,18.417,23186,9175,14011,7.506,18.967,-673,-0.551,36.833,2282,2313,6876
1997,4532,29741,40843,313281,304877,5591,13.780,5051,12.449,71118,31559,39559,10.351,23.327,55112,21421,33691,7.026,18.077,16006,5.250,36.154,3480,3655,13560
1997,4533,12710,16059,95535,93212,2318,14.632,1885,11.898,19054,8171,10883,8.766,20.442,14383,5331,9052,5.719,15.430,4671,5.011,30.861,1501,1515,3663
1997,4539,29408,35805,219759,213780,5904,16.770,4707,13.370,56910,27170,29740,12.709,26.621,44665,18295,26370,8.558,20.893,12245,5.728,41.786,3408,3513,13607
1997,4541,7932,8695,198411,190288,1350,15.868,975,11.460,39499,13763,25736,7.233,20.757,23103,9395,13708,4.937,12.141,16396,8.616,24.282,663,676,4364
1997,4542,5166,5879,69804,69856,735,12.518,720,12.263,11159,5248,5911,7.513,15.974,11199,5216,5983,7.467,16.032,-40,-0.057,31.949,504,530,2428
1997,4543,19070,25109,217942,222306,2826,11.282,2705,10.799,38860,14066,24794,6.327,17.480,47547,22541,25006,10.140,21.388,-8687,-3.908,34.961,1740,1804,8979
1997,4811,601,2978,489819,481174,261,8.719,292,9.754,46018,6323,39695,1.314,9.564,28950,3090,25860,0.642,6.017,17068,3.547,12.033,87,94,1888
1997,4812,1471,1612,25466,25640,228,14.277,198,12.398,4846,1490,3356,5.811,18.901,5247,932,4315,3.635,20.465,-401,-1.564,37.801,120,123,610
1997,4831,762,1144,52752,51429,133,11.849,90,8.018,9223,3966,5257,7.712,17.933,6387,1820,4567,3.539,12.419,2836,5.514,24.838,37,37,973
1997,4832,485,530,17961,17241,49,9.423,29,5.577,3343,306,3037,1.775,19.390,1984,492,1492,2.854,11.508,1359,7.883,23.016,16,16,41
1997,4841,31612,39799,849527,834050,7106,18.209,5556,14.237,150026,49875,100151,5.980,17.988,118988,43893,75095,5.263,14.266,31038,3.721,28.533,4036,4104,23457
1997,4842,47558,50796,476224,475373,7635,14.991,7901,15.514,98378,35711,62667,7.512,20.695,97055,41263,55792,8.680,20.417,1323,0.278,40.833,6086,6126,25986
1997,4851,456,556,28900,28703,90,16.319,81,14.687,4500,1662,2838,5.790,15.678,4112,1840,2272,6.411,14.326,388,1.352,28.653,56,56,710
1997,4852,188,339,16420,15900,24,6.838,48,13.675,2703,218,2485,1.371,17.000,1641,666,975,4.189,10.321,1062,6.679,20.642,17,17,244
1997,4853,5518,5592,58748,58299,960,17.231,919,16.495,14565,6106,8459,10.474,24.983,13974,8178,5796,14.028,23.970,591,1.014,47.939,718,725,5194
1997,4854,3220,4245,148772,147211,402,9.415,452,10.585,28088,11607,16481,7.885,19.080,25274,11054,14220,7.509,17.169,2814,1.912,34.337,250,256,3292
1997,4855,1265,1382,29574,29052,149,10.884,123,8.985,5661,1507,4154,5.187,19.486,4613,1405,3208,4.836,15.879,1048,3.607,31.757,92,93,971
1997,4859,2099,2274,44742,45126,376,16.663,341,15.112,9747,3158,6589,6.998,21.600,10604,5782,4822,12.813,23.499,-857,-1.899,43.199,229,229,2939
1997,4861,45,362,7672,7826,13,3.426,48,12.648,942,289,653,3.693,12.037,1256,438,818,5.597,16.049,-314,-4.012,24.074,4,4,108
1997,4862,126,1412,33509,34812,155,11.187,102,7.362,4193,1935,2258,5.559,12.045,6824,1695,5129,4.869,19.603,-2631,-7.558,24.090,18,18,230
1997,4869,50,469,5705,5918,48,9.836,86,17.623,675,281,394,4.749,11.407,1074,776,298,13.114,18.150,-399,-6.743,22.814,4,4,7
1997,4871,325,363,8170,8246,53,13.893,90,23.591,1785,467,1318,5.663,21.647,1982,1207,775,14.637,24.036,-197,-2.389,43.294,59,59,451
1997,4872,1134,1168,12885,12404,173,14.649,199,16.850,3565,1856,1709,14.964,28.742,2667,1067,1600,8.602,21.502,898,7.240,43.004,144,144,637
1997,4879,131,135,1574,1475,21,15.730,18,13.483,449,75,374,5.086,30.451,248,144,104,9.766,16.819,201,13.632,33.639,10,10,32
1997,4881,2972,3864,108243,106781,534,13.913,482,12.559,20157,7265,12892,6.804,18.877,17409,7855,9554,7.356,16.303,2748,2.573,32.607,293,295,3246
1997,4882,431,785,19184,19083,107,13.798,88,11.348,3656,1886,1770,9.883,19.158,3574,1566,2008,8.206,18.729,82,0.430,37.457,45,45,1050
1997,4883,1714,2202,72443,71880,214,9.573,281,12.570,13851,1612,12239,2.243,19.270,12711,4807,7904,6.688,17.684,1140,1.586,35.368,156,165,1664
1997,4884,5492,5721,44703,42600,950,16.931,730,13.010,11306,5996,5310,14.075,26.540,7128,3489,3639,8.190,16.732,4178,9.808,33.465,549,562,2472
1997,4885,10721,14245,138134,133251,2104,15.071,1535,10.995,31705,11589,20116,8.697,23.794,22022,9915,12107,7.441,16.527,9683,7.267,33.054,984,1004,5311
1997,4889,732,789,19354,14650,150,19.182,136,17.391,11568,10784,784,73.613,78.965,2645,1302,1343,8.888,18.055,8923,60.910,36.110,101,106,1192
1997,4921,1748,5110,463287,462006,565,11.178,454,8.982,41716,7697,34019,1.666,9.029,38186,6561,31625,1.420,8.265,3530,0.764,16.531,318,322,4692
1997,4922,4389,4774,68114,68706,888,18.904,735,15.647,17005,7448,9557,10.840,24.751,18164,7055,11109,10.268,26.437,-1159,-1.687,49.501,578,594,5309
1997,4931,6407,11598,502505,490418,1542,13.620,989,8.736,105668,40258,65410,8.209,21.547,81362,25498,55864,5.199,16.590,24306,4.956,33.181,361,378,5189
1997,5111,16018,19014,688499,687515,1943,10.236,1878,9.894,78904,18219,60685,2.650,11.477,76757,23618,53139,3.435,11.164,2147,0.312,22.329,1463,1467,9071
1997,5112,8438,10548,251435,234569,1814,17.888,1000,9.861,71665,23639,48026,10.078,30.552,37810,15204,22606,6.482,16.119,33855,14.433,32.238,608,634,9770
1997,5121,11501,15780,250394,243329,2297,14.646,2104,13.415,65469,37456,28013,15.393,26.906,52259,18859,33400,7.750,21.477,13210,5.429,42.953,1269,1333,7427
1997,5122,2312,2424,19359,19206,433,18.239,333,14.027,4021,1705,2316,8.877,20.936,3681,2055,1626,10.700,19.166,340,1.770,38.332,252,252,1298
1997,5151,5895,7998,243372,240552,984,12.089,1267,15.566,47676,18923,28753,7.866,19.819,41683,19701,21982,8.190,17.328,5993,2.491,34.656,869,911,12043
1997,5152,241,435,24450,22397,62,14.075,73,16.572,7487,1927,5560,8.604,33.429,3423,2398,1025,10.707,15.284,4064,18.146,30.567,19,19,137
1997,5173,6848,30146,1109033,1095458,4121,13.757,3740,12.485,218307,72219,146088,6.593,19.928,190046,67735,122311,6.183,17.349,28261,2.580,34.697,1153,1221,13494
1997,5174,336,452,10654,10493,82,18.263,76,16.927,3768,1813,1955,17.279,35.911,3348,2610,738,24.875,31.909,420,4.003,63.817,32,32,647
1997,5179,4010,4475,58750,49535,1720,43.473,683,17.263,27809,14879,12930,30.038,56.141,9285,5212,4073,10.522,18.745,18524,37.396,37.489,376,378,2358
1997,5182,4160,7385,307090,306515,1411,19.016,1481,19.960,64996,29336,35660,9.571,21.205,63591,24097,39494,7.862,20.746,1405,0.458,41.493,549,557,6392
1997,5191,2697,3314,47395,47362,250,7.561,235,7.107,8122,2814,5308,5.942,17.149,7765,1698,6067,3.585,16.395,357,0.754,32.790,175,179,869
1997,5211,12,42,22130,22387,0,0.000,D,D,171,0,171,0.000,0.764,699,D,694,D,3.122,-528,-2.359,1.528,0,0,0
1997,5221,19332,103040,1922304,1921098,11949,11.741,9417,9.253,384184,178239,205945,9.278,19.998,381298,187372,193926,9.753,19.848,2886,0.150,39.696,664,1116,16208
1997,5222,16912,43016,521899,510208,6969,16.535,5232,12.414,141957,69222,72735,13.567,27.823,117080,59817,57263,11.724,22.948,24877,4.876,45.895,1602,1792,11338
1997,5223,9902,14079,156018,146561,3485,26.252,1877,14.139,46533,18401,28132,12.555,31.750,27036,11437,15599,7.804,18.447,19497,13.303,36.894,1060,1107,6097
1997,5231,10589,27421,475543,444660,4616,17.245,3307,12.355,134466,36358,98108,8.177,30.240,69288,26291,42997,5.913,15.582,65178,14.658,31.165,859,885,7202
1997,5232,19,31,5937,5975,0,0.000,12,32.432,97,0,97,0.000,1.624,171,41,130,0.686,2.862,-74,-1.239,3.247,5,5,14
1997,5239,20975,23458,243585,234260,4628,20.511,2840,12.586,64114,22927,41187,9.787,27.369,45345,18493,26852,7.894,19.357,18769,8.012,38.713,1918,1925,8622
1997,5241,4412,36227,1547899,1546947,4354,11.697,6346,17.049,217692,78628,139064,5.083,14.072,214677,81250,133427,5.252,13.877,3015,0.195,27.755,383,408,5644
1997,5242,111124,122165,731444,723230,13251,10.931,11377,9.385,135488,52965,82523,7.323,18.734,119603,53774,65829,7.435,16.537,15885,2.196,33.075,7388,7527,25810
1997,5259,152,160,1512,2055,29,15.065,94,48.831,240,111,129,5.401,11.679,1354,1230,124,59.854,65.888,-1114,-54.209,23.358,62,62,730
1997,5311,88826,98675,496541,496757,11335,11.473,11585,11.726,102652,44898,57754,9.038,20.664,102871,52236,50635,10.515,20.709,-219,-0.044,41.329,8966,9065,37510
1997,5312,45686,51209,220438,217599,7984,15.828,6448,12.783,54979,23907,31072,10.987,25.266,49810,24044,25766,11.050,22.891,5169,2.375,45.782,4333,4392,14692
1997,5313,38439,44942,451825,440769,6062,13.728,4494,10.177,99732,37259,62473,8.453,22.627,77680,29530,48150,6.700,17.624,22052,5.003,35.247,2921,2990,16542
1997,5321,4530,9610,154145,149611,1096,11.459,1005,10.508,30164,5901,24263,3.944,20.162,20977,8185,12792,5.471,14.021,9187,6.141,28.042,543,589,3745
1997,5322,18104,31443,227966,218007,5465,17.754,4143,13.459,65629,35361,30268,16.220,30.104,46500,19193,27307,8.804,21.330,19129,8.775,42.659,2963,3189,14041
1997,5323,3535,6012,38982,38944,543,9.000,585,9.697,6509,2297,4212,5.898,16.714,6494,2845,3649,7.305,16.675,15,0.039,33.350,347,402,1963
1997,5324,7202,10315,130028,124305,1520,14.939,1240,12.187,32337,11609,20728,9.339,26.014,20654,9187,11467,7.391,16.616,11683,9.399,33.231,799,835,6038
1997,5331,1630,1752,17876,18062,287,16.710,218,12.693,4813,2136,2677,11.826,26.647,5222,2644,2578,14.638,28.912,-409,-2.264,53.294,157,157,2126
1997,5411,153919,161230,1019168,1009387,15869,9.888,14380,8.960,144243,47006,97237,4.657,14.290,124640,41120,83520,4.074,12.348,19603,1.942,24.696,10814,10929,30936
1997,5412,83577,88667,946393,922977,9712,11.010,8806,9.983,193982,69043,124939,7.480,21.017,147280,47378,99902,5.133,15.957,46702,5.060,31.914,6206,6280,32456
1997,5413,77531,86653,1064895,1049263,11282,13.233,8483,9.950,201577,57326,144251,5.463,19.211,169948,65835,104113,6.274,16.197,31629,3.014,32.394,5641,5746,27668
1997,5414,21749,21953,112615,110320,3817,17.648,3169,14.652,27274,11824,15450,10.718,24.723,22854,10667,12187,9.669,20.716,4420,4.007,41.432,2497,2501,8489
1997,5415,51053,57084,740294,682500,15305,28.708,7763,14.561,247660,82843,164817,12.138,36.287,131510,62154,69356,9.107,19.269,116150,17.018,38.538,5307,5370,32855
1997,5416,52748,56024,457187,440111,13321,24.816,8630,16.077,130663,57889,72774,13.153,29.689,97015,46673,50342,10.605,22.043,33648,7.645,44.087,6358,6419,32011
1997,5417,8641,10895,476060,479791,1651,15.467,1209,11.327,81666,25684,55982,5.353,17.021,88043,25880,62163,5.394,18.350,-6377,-1.329,34.042,667,675,5275
1997,5418,31150,34199,423920,416275,5024,14.787,4579,13.477,82024,27908,54116,6.704,19.704,67164,27631,39533,6.638,16.135,14860,3.570,32.269,3514,3583,21302
1997,5419,39091,44892,389747,383909,4069,9.112,3600,8.061,72286,21547,50739,5.613,18.829,60639,22626,38013,5.894,15.795,11647,3.034,31.590,2441,2532,13874
1997,5511,27882,50512,3211444,3221755,5037,9.833,6459,12.610,603019,171083,431936,5.310,18.717,620099,230628,389471,7.158,19.247,-17080,-0.530,37.434,1295,1397,23488
1997,5611,18649,20978,330390,315435,5026,25.351,2721,13.725,103297,51660,51637,16.377,32.748,74034,39371,34663,12.482,23.470,29263,9.277,46.941,2025,2052,28758
1997,5612,1145,2311,106852,100727,600,28.708,158,7.560,28006,12823,15183,12.731,27.804,15963,5156,10807,5.119,15.848,12043,11.956,31.696,47,50,756
1997,5613,23330,36973,3112338,2976127,6979,19.494,4636,12.949,1029021,352038,676983,11.829,34.576,754455,236520,517935,7.947,25.350,274566,9.226,50.700,2515,2665,119579
1997,5614,24800,29329,577460,537194,4811,16.651,3938,13.630,172522,79449,93073,14.790,32.115,91957,35785,56172,6.661,17.118,80565,14.997,34.236,2834,2918,20499
1997,5615,25507,32534,282408,279058,3781,11.524,4330,13.198,59553,21915,37638,7.853,21.341,52373,24710,27663,8.855,18.768,7180,2.573,37.536,2640,2711,13343
1997,5616,15271,18997,642698,628761,2832,15.101,2346,12.509,131654,42399,89255,6.743,20.939,104880,36001,68879,5.726,16.680,26774,4.258,33.361,1693,1701,18940
1997,5617,111174,116267,1331574,1297598,20035,17.451,17118,14.910,317813,110339,207474,8.503,24.492,249194,97884,151310,7.543,19.204,68619,5.288,38.409,13593,13608,65296
1997,5619,20523,22472,332976,320030,4276,19.659,2833,13.025,85612,33694,51918,10.528,26.751,59530,25265,34265,7.895,18.601,26082,8.150,37.203,2197,2200,17795
1997,5621,6428,7455,139323,135865,858,11.508,859,11.522,27452,9874,17578,7.268,20.205,20618,8262,12356,6.081,15.175,6834,5.030,30.351,677,682,5605
1997,5622,1409,2141,56577,60929,293,13.342,403,18.352,12238,5857,6381,9.613,20.086,21211,7602,13609,12.477,34.813,-8973,-14.727,40.171,197,215,2703
1997,5629,4983,5499,83734,82025,782,14.332,697,12.774,21232,7661,13571,9.340,25.885,17559,5554,12005,6.771,21.407,3673,4.478,42.814,506,510,3474
1997,6111,15399,17603,636261,621743,885,5.067,608,3.481,66386,11466,54920,1.844,10.677,37267,8379,28888,1.348,5.994,29119,4.683,11.988,388,396,6239
1997,6112,552,818,73084,72484,33,4.005,45,5.461,6857,741,6116,1.022,9.460,5808,894,4914,1.233,8.013,1049,1.447,16.026,24,30,530
1997,6113,2263,2781,1180263,1165919,177,6.463,92,3.360,75487,2091,73396,0.179,6.474,46393,2482,43911,0.213,3.979,29094,2.495,7.958,57,60,2086
1997,6114,5038,5592,59292,56362,1074,19.935,665,12.343,16953,6998,9955,12.416,30.079,11116,5030,6086,8.924,19.723,5837,10.356,39.445,499,508,3872
1997,6115,5230,6144,66440,63804,820,13.515,667,10.993,15093,4922,10171,7.714,23.655,9887,3573,6314,5.600,15.496,5206,8.159,30.992,445,449,2220
1997,6116,19044,20335,154891,150344,3211,16.031,2601,12.986,38772,15224,23548,10.126,25.789,29523,11692,17831,7.777,19.637,9249,6.152,39.274,2026,2038,7843
1997,6117,2873,3091,28544,27587,574,18.966,445,14.703,6776,1975,4801,7.159,24.563,4823,2124,2699,7.699,17.483,1953,7.080,34.966,352,352,1626
1997,6211,160487,180188,1556552,1529789,16897,9.353,17831,9.870,320130,131005,189125,8.564,20.926,265999,118911,147088,7.773,17.388,54131,3.538,34.776,13347,13787,78928
1997,6212,104760,108275,645306,634649,5655,5.236,5089,4.712,93376,25097,68279,3.954,14.713,72397,22655,49742,3.570,11.407,20979,3.306,22.815,3842,3912,17332
1997,6213,75253,80770,402320,389447,9289,11.609,7780,9.723,99001,42670,56331,10.957,25.421,72437,32654,39783,8.385,18.600,26564,6.821,37.200,5639,5719,23521
1997,6214,9639,19962,491440,480191,3313,17.339,1603,8.390,100850,41878,58972,8.721,21.002,77172,24864,52308,5.178,16.071,23678,4.931,32.142,799,852,12636
1997,6215,5396,8986,145390,147226,2252,26.543,1249,14.721,34426,16961,17465,11.520,23.383,38149,18859,19290,12.810,25.912,-3723,-2.529,46.766,590,616,6570
1997,6216,10683,17773,903130,876229,3495,20.654,1792,10.590,223302,85300,138002,9.735,25.484,169107,58685,110422,6.697,19.299,54195,6.185,38.599,781,912,26235
1997,6219,3948,5869,164848,157908,742,12.414,958,16.028,48218,23614,24604,14.954,30.536,33543,18069,15474,11.443,21.242,14675,9.293,42.484,522,560,7002
1997,6221,2589,4395,4072867,4074222,173,3.919,212,4.802,330432,97020,233412,2.381,8.110,331861,93016,238845,2.283,8.145,-1429,-0.035,16.221,93,101,45589
1997,6222,491,786,243552,255970,84,10.619,94,11.884,26625,12689,13936,4.957,10.402,52289,21028,31261,8.215,20.428,-25664,-10.026,20.803,34,40,7500
1997,6223,236,372,136849,139342,31,8.322,32,8.591,11985,3594,8391,2.579,8.601,16858,5411,11447,3.883,12.098,-4873,-3.497,17.202,9,10,2593
1997,6231,7746,14682,1502420,1489804,1211,8.324,943,6.482,177245,72175,105070,4.845,11.897,153115,59670,93445,4.005,10.278,24130,1.620,20.555,530,564,34445
1997,6232,7295,19358,349285,345633,1908,10.164,738,3.931,57671,20216,37455,5.849,16.686,50529,10196,40333,2.950,14.619,7142,2.066,29.239,467,471,5947
1997,6233,11743,14230,399856,391116,2276,16.312,1721,12.335,66074,25876,40198,6.616,16.894,48825,21293,27532,5.444,12.484,17249,4.410,24.967,1108,1134,12155
1997,6239,3394,5637,130723,129708,527,9.386,483,8.602,21567,6877,14690,5.302,16.627,19470,7107,12363,5.479,15.011,2097,1.617,30.021,285,286,4858
1997,6241,28622,40339,652107,631783,4285,10.833,2714,6.862,115834,28939,86895,4.581,18.334,75712,17041,58671,2.697,11.984,40122,6.351,23.968,1580,1613,9181
1997,6242,7699,9554,101940,100200,668,7.016,602,6.323,16112,3262,12850,3.256,16.080,12755,4243,8512,4.235,12.730,3357,3.350,25.459,346,350,2095
1997,6243,5229,7826,284882,283366,630,7.988,751,9.523,47196,7039,40157,2.484,16.656,44321,8072,36249,2.849,15.641,2875,1.015,31.282,303,342,3466
1997,6244,45784,56702,612667,603184,6600,11.734,5689,10.114,107092,39987,67105,6.629,17.754,88055,32025,56030,5.309,14.598,19037,3.156,29.197,4332,4424,23686
1997,7111,7330,7424,108233,105291,1174,15.962,1036,14.086,26706,8628,18078,8.194,25.364,20654,7333,13321,6.965,19.616,6052,5.748,39.232,741,743,4904
1997,7112,2998,3112,85324,84131,559,17.986,551,17.728,17079,6026,11053,7.163,20.301,14757,5698,9059,6.773,17.541,2322,2.760,35.081,397,400,4210
1997,7113,2988,3100,64457,62140,408,13.096,439,14.091,15373,4471,10902,7.195,24.739,11144,4552,6592,7.325,17.934,4229,6.806,35.868,336,336,2892
1997,7114,2143,2198,14053,13693,355,16.477,268,12.439,3839,1320,2519,9.640,28.036,3027,1968,1059,14.372,22.106,812,5.930,44.212,198,198,1498
1997,7115,7839,7857,32535,33600,1694,22.262,1199,15.757,12357,4796,7561,14.274,36.777,14727,5490,9237,16.340,43.831,-2370,-7.054,73.555,766,770,3318
1997,7121,4685,5052,89923,86638,356,7.141,223,4.473,12119,1477,10642,1.705,13.988,5439,878,4561,1.013,6.278,6680,7.710,12.556,139,139,552
1997,7131,1618,2756,129065,128426,284,10.203,339,12.179,19113,9731,9382,7.577,14.883,18722,5610,13112,4.368,14.578,391,0.304,29.156,228,230,4510
1997,7132,1593,1920,159461,150880,294,15.918,148,8.013,31864,11101,20763,7.358,21.119,14426,3070,11356,2.035,9.561,17438,11.558,19.122,100,100,2085
1997,7139,43792,47512,827081,816020,5312,11.223,4948,10.454,147521,53847,93674,6.599,18.078,125526,49847,75679,6.109,15.383,21995,2.695,30.765,3726,3765,34570
1997,7211,32618,40857,1552908,1541743,5455,13.568,4149,10.320,252039,113005,139034,7.330,16.348,229349,94906,134443,6.156,14.876,22690,1.472,29.752,2800,2864,57551
1997,7212,5020,5438,33955,34802,618,11.400,584,10.773,7112,2151,4961,6.181,20.436,8708,3030,5678,8.706,25.022,-1596,-4.586,40.871,322,322,1707
1997,7213,3152,3228,15825,15939,286,8.848,295,9.126,2544,968,1576,6.073,15.961,2791,1092,1699,6.851,17.511,-247,-1.550,31.923,199,201,807
1997,7223,9283,23288,469064,457636,3299,14.176,3267,14.038,114712,53715,60997,11.738,25.066,92388,35969,56419,7.860,20.188,22324,4.878,40.376,2317,2338,21105
1997,7224,47365,47832,317010,319728,5705,11.692,7633,15.643,74179,35517,38662,11.109,23.201,79237,39411,39826,12.326,24.783,-5058,-1.582,46.401,6418,6453,33252
1997,7225,260904,360633,6840554,6774418,53642,15.040,45720,12.818,1423680,790866,632814,11.674,21.016,1285919,522230,763689,7.709,18.982,137761,2.034,37.964,32131,33415,323602
1997,8111,137467,149735,825831,813180,18212,12.264,15746,10.603,166205,69741,96464,8.576,20.439,140731,57949,82782,7.126,17.306,25474,3.133,34.613,11789,12020,43723
1997,8112,13651,16010,135513,138180,2072,12.899,2179,13.565,29976,9043,20933,6.544,21.693,35944,20172,15772,14.598,26.012,-5968,-4.319,43.387,1248,1270,4855
1997,8113,20954,22484,189293,187746,2440,10.863,2395,10.663,32402,10042,22360,5.349,17.258,29350,11121,18229,5.923,15.633,3052,1.626,31.266,1785,1785,7385
1997,8114,24506,26018,146071,146959,3351,12.797,3688,14.084,24079,9479,14600,6.450,16.385,25684,11411,14273,7.765,17.477,-1605,-1.092,32.770,2875,2897,8370
1997,8121,74644,85461,455953,454664,11501,13.402,12210,14.228,95119,44101,51018,9.700,20.921,93791,42375,51416,9.320,20.629,1328,0.292,41.257,9250,9477,29493
1997,8122,15921,21416,156104,152089,1692,7.951,1419,6.668,30680,13486,17194,8.867,20.172,22363,7232,15131,4.755,14.704,8317,5.469,29.408,815,851,4157
1997,8123,34309,40849,387186,386080,4347,10.595,4710,11.479,65530,21358,44172,5.532,16.973,63234,27467,35767,7.114,16.378,2296,0.595,32.757,3384,3552,17244
1997,8129,15577,24573,198572,194814,3391,13.773,3486,14.159,44488,17084,27404,8.769,22.836,37153,15497,21656,7.955,19.071,7335,3.765,38.142,1831,1954,7942
1997,8131,154523,154648,1433888,1406353,8253,5.389,5232,3.417,173116,23322,149794,1.658,12.310,117667,16456,101211,1.170,8.367,55449,3.943,16.734,3242,3242,9902
1997,8132,9414,10979,111886,111993,1031,9.478,829,7.621,17468,4057,13411,3.623,15.597,17554,6165,11389,5.505,15.674,-86,-0.077,31.195,539,546,3144
1997,8133,7837,9393,83356,83063,896,9.611,756,8.109,14036,3355,10681,4.039,16.898,13493,4082,9411,4.914,16.244,543,0.654,32.489,484,487,2593
1997,8134,28003,29724,301369,298123,1421,4.745,1866,6.231,40437,7658,32779,2.569,13.564,34076,6768,27308,2.270,11.430,6361,2.134,22.860,1303,1306,4208
1997,8139,63032,64938,493092,494562,3419,5.214,4681,7.139,66015,13285,52730,2.686,13.348,68996,23907,45089,4.834,13.951,-2981,-0.603,26.696,3281,3303,16372
1998,1131,256,304,2976,3003,46,15.620,27,9.168,493,118,375,3.930,16.420,539,103,436,3.430,17.952,-46,-1.532,32.839,17,17,25
1998,1132,147,213,1806,1659,68,35.696,23,12.073,696,479,217,28.873,41.953,410,126,284,7.595,24.714,286,17.239,49.427,17,17,89
1998,1133,11685,11759,79874,81046,1479,12.497,1630,13.773,15713,5974,9739,7.371,19.388,18093,6370,11723,7.860,22.324,-2380,-2.937,38.776,1229,1229,4651
1998,1141,1288,1300,7447,8499,238,18.407,224,17.324,2219,933,1286,10.978,26.109,4395,2048,2347,24.097,51.712,-2176,-25.603,52.218,168,168,577
1998,1142,244,244,1997,1955,40,16.393,40,16.393,396,146,250,7.468,20.256,295,132,163,6.752,15.090,101,5.166,30.179,29,29,114
1998,1151,4536,4870,66635,66842,549,11.263,558,11.447,14459,4945,9514,7.398,21.632,15005,4582,10423,6.855,22.449,-546,-0.817,43.264,389,389,2698
1998,1152,2789,2837,17421,17232,485,17.412,382,13.714,3565,1792,1773,10.399,20.688,3154,1038,2116,6.024,18.303,411,2.385,36.606,305,305,819
1998,1153,1234,1267,14135,13890,212,17.208,142,11.526,3200,969,2231,6.976,23.038,2700,715,1985,5.148,19.438,500,3.600,38.877,102,102,595
1998,2111,6071,7244,94819,98079,629,8.622,732,10.034,16061,5192,10869,5.294,16.376,22636,4968,17668,5.065,23.079,-6575,-6.704,32.751,460,466,1607
1998,2121,898,1304,80504,82866,156,11.594,239,17.763,11198,4503,6695,5.434,13.513,15892,5826,10066,7.031,19.178,-4694,-5.665,27.027,141,152,3409
1998,2122,316,434,39864,40565,44,9.800,74,16.481,2770,323,2447,0.796,6.829,4136,891,3245,2.197,10.196,-1366,-3.367,13.657,47,47,173
1998,2123,3258,5046,101850,100151,317,6.293,300,5.955,15285,2404,12881,2.400,15.262,11748,2946,8802,2.942,11.730,3537,3.532,23.461,184,186,1364
1998,2131,7054,8129,171352,163477,1049,12.889,1069,13.134,47156,14284,32872,8.738,28.846,31778,15426,16352,9.436,19.439,15378,9.407,38.878,672,708,7366
1998,2211,1561,8138,553443,552193,886,11.225,396,5.017,53471,26891,26580,4.870,9.683,50864,6522,44342,1.181,9.211,2607,0.472,18.423,67,72,903
1998,2212,569,2682,97514,100052,227,8.488,212,7.927,9467,2751,6716,2.750,9.462,14992,2869,12123,2.868,14.984,-5525,-5.522,18.924,43,45,475
1998,2213,4128,4601,34669,34279,282,6.158,239,5.219,4262,2065,2197,6.024,12.433,3443,1011,2432,2.949,10.044,819,2.389,20.088,169,169,663
1998,2361,128523,129197,668405,658099,22046,17.205,19930,15.553,181146,72182,108964,10.968,27.526,160839,66294,94545,10.074,24.440,20307,3.086,48.880,14160,14165,47836
1998,2362,40111,40896,732742,716214,4650,11.416,4324,10.615,156933,34613,122320,4.833,21.911,123709,27686,96023,3.866,17.273,33224,4.639,34.545,3089,3091,18181
1998,2371,15902,16224,378127,372646,1514,9.423,1201,7.475,74497,14125,60372,3.790,19.991,63276,12823,50453,3.441,16.980,11221,3.011,33.960,870,873,7700
1998,2372,8696,8858,55581,55038,1694,19.340,1496,17.080,16534,7809,8725,14.188,30.041,15348,5669,9679,10.300,27.886,1186,2.155,55.772,1088,1088,3481
1998,2373,10768,11175,266207,264937,946,8.491,879,7.889,48797,9705,39092,3.663,18.418,46199,8234,37965,3.108,17.438,2598,0.981,34.875,620,622,5224
1998,2379,4679,4760,66865,66374,551,11.559,565,11.852,15895,3624,12271,5.460,23.948,15065,5359,9706,8.074,22.697,830,1.250,45.394,440,440,2930
1998,2381,89963,90330,868890,856125,11812,13.175,10466,11.673,205755,53343,152412,6.231,24.033,179791,52763,127028,6.163,21.001,25964,3.033,42.001,7753,7753,39586
1998,2382,139931,142194,1593316,1555058,15510,10.993,13301,9.427,313507,78910,234597,5.074,20.160,236613,65108,171505,4.187,15.216,76894,4.945,30.431,9987,9995,49717
1998,2383,93372,93943,744433,728446,14985,16.112,13108,14.094,185564,56237,129327,7.720,25.474,153436,51287,102149,7.041,21.063,32128,4.410,42.127,9888,9899,39523
1998,2389,47952,48207,397255,389075,6631,13.919,5496,11.537,93241,28188,65053,7.245,23.965,76692,24707,51985,6.350,19.711,16549,4.253,39.423,4028,4032,18144
1998,3111,1015,1621,47645,46823,101,6.206,114,7.005,6206,2588,3618,5.527,13.254,4646,1206,3440,2.576,9.923,1560,3.332,19.845,75,75,449
1998,3112,503,863,63232,63263,48,5.572,45,5.223,4514,1286,3228,2.033,7.135,4516,562,3954,0.888,7.138,-2,-0.003,14.271,30,30,208
1998,3113,1452,1638,84326,84521,115,7.027,112,6.844,6620,1063,5557,1.258,7.832,6962,1121,5841,1.326,8.237,-342,-0.405,15.665,79,82,473
1998,3114,1319,1717,167494,168193,133,7.830,96,5.652,16814,5317,11497,3.161,9.997,17914,2065,15849,1.228,10.651,-1100,-0.654,19.994,69,69,786
1998,3115,1193,1713,130456,130945,85,4.964,84,4.905,11303,3140,8163,2.398,8.632,12094,4221,7873,3.223,9.236,-791,-0.604,17.264,44,44,457
1998,3116,3453,4069,462351,459006,262,6.401,310,7.574,35412,6704,28708,1.461,7.715,28663,4956,23707,1.080,6.245,6749,1.470,12.489,230,231,2305
1998,3117,647,762,43900,43011,73,9.605,69,9.079,7796,2110,5686,4.906,18.126,6045,1210,4835,2.813,14.055,1751,4.071,28.109,45,45,733
1998,3118,9511,10339,299610,303647,1273,12.402,1124,10.950,33243,10744,22499,3.538,10.948,40875,12507,28368,4.119,13.461,-7632,-2.513,21.896,853,870,6736
1998,3119,2256,2613,142961,143132,227,8.729,202,7.768,15368,4006,11362,2.799,10.737,15672,3702,11970,2.586,10.949,-304,-0.212,21.474,150,153,2203
1998,3121,1919,2371,139361,139307,229,9.658,229,9.658,12068,2262,9806,1.624,8.663,11867,2488,9379,1.786,8.519,201,0.144,17.037,177,185,1583
1998,3122,83,112,30177,30436,18,16.822,8,7.477,1459,168,1291,0.552,4.794,2023,275,1748,0.904,6.647,-564,-1.853,9.587,4,4,98
1998,3131,334,575,82462,82244,40,6.975,37,6.452,6801,2070,4731,2.517,8.269,6280,2135,4145,2.596,7.636,521,0.633,15.272,23,26,974
1998,3132,1665,1999,209995,212733,150,7.515,144,7.214,14257,3548,10709,1.668,6.702,19670,5975,13695,2.809,9.246,-5413,-2.545,13.404,101,103,2198
1998,3133,2948,3243,107965,110591,180,5.299,488,14.366,10642,2800,7842,2.532,9.623,15898,6209,9689,5.614,14.376,-5256,-4.753,19.246,372,389,3476
1998,3141,2778,3020,122500,124940,229,7.505,292,9.569,11101,2475,8626,1.981,8.885,16076,6095,9981,4.878,12.867,-4975,-3.982,17.770,219,224,2242
1998,3149,4340,4468,108253,109710,482,10.787,483,10.809,14953,4460,10493,4.065,13.630,17883,6346,11537,5.784,16.300,-2930,-2.671,27.259,380,381,4582
1998,3151,1070,1169,94603,99067,88,7.445,114,9.645,9326,2751,6575,2.777,9.414,18123,4526,13597,4.569,18.294,-8797,-8.880,18.828,87,90,3035
1998,3152,10185,10925,484902,504859,1591,14.370,1885,17.025,67765,22988,44777,4.553,13.423,107717,43429,64288,8.602,21.336,-39952,-7.913,26.845,1507,1515,28310
1998,3159,1971,2066,56111,57641,188,8.868,296,13.962,6578,2110,4468,3.661,11.412,9626,2809,6817,4.873,16.700,-3048,-5.288,22.824,216,221,1986
1998,3161,301,330,15706,15849,25,7.519,30,9.023,1183,113,1070,0.713,7.464,1473,386,1087,2.435,9.294,-290,-1.830,14.928,22,22,195
1998,3162,335,389,38046,41169,39,10.052,37,9.536,2181,699,1482,1.698,5.298,8632,4453,4179,10.817,20.967,-6451,-15.670,10.595,21,21,394
1998,3169,953,980,27215,28277,90,9.109,106,10.729,2628,656,1972,2.320,9.294,4716,1468,3248,5.191,16.678,-2088,-7.384,18.588,78,78,476
1998,3211,4075,4541,133242,132711,298,6.534,338,7.411,13790,3111,10679,2.344,10.391,12680,3388,9292,2.553,9.555,1110,0.836,19.109,252,252,1970
1998,3212,1436,1793,113306,112724,125,7.052,84,4.739,11944,3042,8902,2.699,10.596,10572,3447,7125,3.058,9.379,1372,1.217,18.757,62,62,1153
1998,3219,9178,9931,330765,324884,1046,10.611,900,9.130,46550,12507,34043,3.850,14.328,34973,10466,24507,3.221,10.765,11577,3.563,21.530,688,689,6237
1998,3221,221,524,175387,174799,24,4.607,18,3.455,10526,7298,3228,4.175,6.022,9346,2836,6510,1.622,5.347,1180,0.675,10.693,D,D,D
1998,3222,3514,5233,397813,399366,280,5.366,251,4.810,34512,9798,24714,2.453,8.642,36961,14674,22287,3.674,9.255,-2449,-0.613,17.283,146,148,2751
1998,3231,37695,39530,834778,832975,2451,6.138,3249,8.137,92503,19412,73091,2.330,11.105,88662,28630,60032,3.437,10.644,3841,0.461,21.288,2580,2589,18309
1998,3241,1107,2122,106779,107483,179,8.544,125,5.967,11495,2846,8649,2.648,10.695,12532,5245,7287,4.880,11.660,-1037,-0.965,21.390,52,54,521
1998,3251,1102,2343,209913,207712,194,8.415,119,5.162,16856,4283,12573,2.062,8.115,12468,1783,10685,0.858,6.003,4388,2.113,12.005,61,62,807
1998,3252,435,759,120018,120394,41,5.413,38,5.017,8361,4194,4167,3.484,6.945,9293,1402,7891,1.165,7.719,-932,-0.774,13.889,21,21,848
1998,3253,659,883,37187,37123,69,7.814,69,7.814,3345,872,2473,2.349,9.011,3252,976,2276,2.629,8.760,93,0.251,17.520,41,41,313
1998,3254,1353,1682,206496,205609,172,10.424,108,6.545,17938,2914,15024,1.417,8.724,16380,4306,12074,2.094,7.967,1558,0.758,15.933,66,66,870
1998,3255,1626,2075,74891,74448,128,6.170,127,6.122,7847,1808,6039,2.429,10.540,6973,2351,4622,3.158,9.366,874,1.174,18.733,73,73,599
1998,3256,2104,2316,125321,124245,186,8.073,162,7.031,14396,4005,10391,3.223,11.587,12135,3866,8269,3.112,9.767,2261,1.820,19.534,119,121,1854
1998,3259,2131,2793,125951,126353,197,7.057,194,6.950,11049,3301,7748,2.613,8.745,11885,2742,9143,2.170,9.406,-836,-0.662,17.489,128,130,1173
1998,3261,10690,13137,811598,803497,887,6.764,840,6.406,98304,24815,73489,3.088,12.235,82384,27166,55218,3.381,10.253,15920,1.981,20.506,570,584,14246
1998,3262,2075,2601,199732,198001,165,6.347,162,6.232,16731,3478,13253,1.757,8.450,13138,4234,8904,2.138,6.635,3593,1.815,13.271,108,108,1276
1998,3271,1546,1800,78227,79649,143,7.927,151,8.370,7274,2679,4595,3.364,9.133,9950,2345,7605,2.944,12.492,-2676,-3.360,18.265,109,110,573
1998,3272,1834,2107,131455,131683,184,8.779,162,7.729,9435,1925,7510,1.462,7.165,9872,2147,7725,1.630,7.497,-437,-0.332,14.330,113,113,823
1998,3273,5526,8809,193777,190184,540,6.144,499,5.678,28170,6733,21437,3.540,14.812,21078,4910,16168,2.582,11.083,7092,3.729,22.166,257,264,2625
1998,3274,241,374,20082,19743,32,8.684,21,5.699,2018,776,1242,3.931,10.222,1378,258,1120,1.307,6.980,640,3.242,13.960,17,17,196
1998,3279,2002,2393,75967,74449,202,8.507,165,6.949,9479,3043,6436,4.087,12.732,6359,2167,4192,2.911,8.541,3120,4.191,17.083,129,129,1425
1998,3311,209,297,146752,146388,29,10.000,15,5.172,6402,1630,4772,1.113,4.373,5800,621,5179,0.424,3.962,602,0.411,7.924,10,10,142
1998,3312,503,701,66074,65504,46,6.657,26,3.763,4846,755,4091,1.153,7.398,3659,505,3154,0.771,5.586,1187,1.812,11.172,13,13,195
1998,3313,351,514,83786,83467,31,6.025,32,6.220,5238,330,4908,0.395,6.276,4529,952,3577,1.141,5.426,709,0.849,10.852,22,22,270
1998,3314,713,894,83997,83485,66,7.470,45,5.093,6531,1624,4907,1.945,7.823,5395,733,4662,0.878,6.462,1136,1.361,12.925,26,26,138
1998,3315,2383,2694,229100,225339,132,4.914,116,4.319,21468,4892,16576,2.171,9.527,13725,2531,11194,1.123,6.091,7743,3.436,12.182,86,86,1184
1998,3321,2760,2973,148269,144481,158,5.311,162,5.445,18891,4506,14385,3.119,13.075,11216,3911,7305,2.707,7.763,7675,5.312,15.526,108,108,1577
1998,3322,1490,1639,82275,80545,102,6.271,77,4.734,7658,3102,4556,3.851,9.508,4321,712,3609,0.884,5.365,3337,4.143,10.729,60,60,496
1998,3323,11164,12006,389679,380117,919,7.744,641,5.402,51582,13188,38394,3.469,13.570,32853,8225,24628,2.164,8.643,18729,4.927,17.286,476,480,4934
1998,3324,1448,1788,106286,105899,115,6.470,94,5.288,10541,2777,7764,2.622,9.954,9775,1859,7916,1.755,9.230,766,0.723,18.461,72,73,1135
1998,3325,791,869,65824,65980,43,4.914,55,6.286,5282,702,4580,1.064,8.005,5523,1989,3534,3.015,8.371,-241,-0.365,16.011,39,39,737
1998,3326,1617,1794,68951,68964,125,6.999,109,6.103,6708,1197,5511,1.736,9.727,6830,2203,4627,3.194,9.904,-122,-0.177,19.454,74,76,875
1998,3327,25661,26069,444953,429840,2215,8.611,1520,5.909,64300,12931,51369,3.008,14.959,34104,9059,25045,2.108,7.934,30196,7.025,15.868,1164,1166,6142
1998,3328,5600,6116,159264,155509,385,6.317,342,5.612,23020,4870,18150,3.132,14.803,15559,4641,10918,2.984,10.005,7461,4.798,20.010,263,263,3150
1998,3329,5668,6204,316082,313417,561,9.178,378,6.184,29371,6251,23120,1.994,9.371,23864,5622,18242,1.794,7.614,5507,1.757,15.228,276,277,2654
1998,3331,2694,2993,215607,212094,202,6.773,181,6.069,22946,5459,17487,2.574,10.819,16211,5182,11029,2.443,7.643,6735,3.175,15.287,130,130,2258
1998,3332,4134,4388,191908,187082,307,7.013,286,6.533,24309,5424,18885,2.899,12.994,14867,3272,11595,1.749,7.947,9442,5.047,15.894,208,208,1567
1998,3333,2325,2469,132104,132154,173,6.944,218,8.750,12963,2928,10035,2.216,9.809,12972,4342,8630,3.286,9.816,-9,-0.007,19.618,157,158,1990
1998,3334,1471,1774,169904,171106,110,6.204,108,6.091,13961,3090,10871,1.806,8.159,16270,3341,12929,1.953,9.509,-2309,-1.349,16.319,71,72,1391
1998,3335,9523,9897,248150,245243,532,5.373,540,5.454,26897,5672,21225,2.313,10.968,21040,5156,15884,2.102,8.579,5857,2.388,17.159,418,422,3668
1998,3336,753,908,110571,110408,44,4.862,38,4.199,7615,803,6812,0.727,6.897,7397,1921,5476,1.740,6.700,218,0.197,13.399,21,21,115
1998,3339,6034,6690,363349,357867,406,6.076,391,5.851,38371,8346,30025,2.332,10.722,27553,7437,20116,2.078,7.699,10818,3.023,15.398,283,285,3791
1998,3341,1645,1741,234634,226383,220,12.750,189,10.953,34715,4509,30206,1.992,15.335,18791,4456,14335,1.968,8.301,15924,7.034,16.601,144,145,1312
1998,3342,1870,2071,246817,242790,184,8.954,152,7.397,32872,5433,27439,2.238,13.539,25113,8732,16381,3.597,10.344,7759,3.196,20.687,102,102,1550
1998,3343,484,523,32490,32569,53,10.057,61,11.575,4026,1246,2780,3.826,12.362,4097,1887,2210,5.794,12.580,-71,-0.218,24.723,41,41,602
1998,3344,5153,5806,575294,563656,518,8.989,431,7.479,77428,13618,63810,2.416,13.737,54335,13205,41130,2.343,9.640,23093,4.097,19.280,295,300,4790
1998,3345,4602,5235,501069,495011,350,6.705,320,6.130,49069,15475,33594,3.126,9.913,36762,8395,28367,1.696,7.427,12307,2.486,14.853,203,205,2283
1998,3346,758,828,48802,48980,101,12.287,89,10.827,6685,2298,4387,4.692,13.649,6910,1891,5019,3.861,14.108,-225,-0.459,27.297,65,65,795
1998,3351,1156,1271,74430,73691,101,8.019,78,6.193,7262,1369,5893,1.858,9.855,5829,1120,4709,1.520,7.910,1433,1.945,15.820,57,57,481
1998,3352,237,308,100866,99872,26,8.414,28,9.061,8949,752,8197,0.753,8.961,6728,1509,5219,1.511,6.737,2221,2.224,13.473,13,13,113
1998,3353,2387,2819,208170,208637,168,5.982,147,5.234,21175,4355,16820,2.087,10.149,21629,7582,14047,3.634,10.367,-454,-0.218,20.298,89,89,763
1998,3359,1825,2213,199947,197513,183,8.349,141,6.432,19515,4486,15029,2.271,9.880,14599,3369,11230,1.706,7.391,4916,2.489,14.783,74,75,999
1998,3361,282,346,224057,224783,36,10.588,24,7.059,13035,811,12224,0.361,5.799,14714,120,14594,0.053,6.546,-1679,-0.747,11.598,20,20,107
1998,3362,1818,2011,129041,125075,168,8.442,126,6.332,17059,3955,13104,3.162,13.639,9269,2505,6764,2.003,7.411,7790,6.228,14.822,102,102,1342
1998,3363,4565,5706,803727,796404,390,6.865,340,5.985,78777,25287,53490,3.175,9.892,64283,11566,52717,1.452,8.072,14494,1.820,16.143,227,231,4936
1998,3364,1405,1700,472869,459365,140,8.306,111,6.586,38115,5832,32283,1.270,8.297,11026,2590,8436,0.564,2.400,27089,5.897,4.801,82,84,1117
1998,3365,160,222,30590,29677,12,5.393,13,5.843,4352,393,3959,1.324,14.665,2498,265,2233,0.893,8.417,1854,6.247,16.835,9,9,195
1998,3366,1476,1575,140554,140553,163,10.274,186,11.724,14626,2601,12025,1.851,10.406,14838,5798,9040,4.125,10.557,-212,-0.151,20.812,123,124,3426
1998,3369,663,690,39767,38639,88,13.066,55,8.166,5155,2403,2752,6.219,13.342,3022,548,2474,1.418,7.821,2133,5.520,15.642,42,42,399
1998,3371,13175,13683,383775,379761,1567,11.502,1449,10.636,49660,11756,37904,3.096,13.077,41705,16932,24773,4.459,10.982,7955,2.095,21.964,1106,1117,9736
1998,3372,4067,4273,186222,182432,301,7.019,332,7.742,25291,4838,20453,2.652,13.863,17729,4933,12796,2.704,9.718,7562,4.145,19.436,248,249,2893
1998,3379,995,1111,44131,42845,74,6.619,88,7.871,5681,1157,4524,2.700,13.260,3128,775,2353,1.809,7.301,2553,5.959,14.602,68,69,567
1998,3391,10986,11588,284317,279407,877,7.554,919,7.916,37493,9434,28059,3.376,13.419,27850,9743,18107,3.487,9.968,9643,3.451,19.935,679,683,4123
1998,3399,16849,17405,437948,434654,1958,11.331,1709,9.890,59373,16719,42654,3.847,13.660,52690,17864,34826,4.110,12.122,6683,1.538,24.245,1352,1354,9056
1998,4231,17327,21299,290531,286387,2110,9.797,2585,12.003,47342,14880,32462,5.196,16.531,39044,16663,22381,5.818,13.633,8298,2.897,27.267,1829,1882,10543
1998,4232,9687,10840,140029,139273,1152,10.647,1112,10.277,22913,6376,16537,4.578,16.452,21226,8774,12452,6.300,15.241,1687,1.211,30.481,816,833,4545
1998,4233,8466,11341,143168,141438,1367,12.135,1215,10.786,25326,9341,15985,6.604,17.906,21645,8466,13179,5.986,15.304,3681,2.603,30.607,791,814,4634
1998,4234,28625,36475,665676,654341,4116,11.272,4196,11.491,129302,39596,89706,6.051,19.761,104921,40417,64504,6.177,16.035,24381,3.726,32.069,2729,2811,19137
1998,4235,7900,10439,164680,163480,688,6.575,739,7.062,21033,4605,16428,2.817,12.866,18435,6129,12306,3.749,11.277,2598,1.589,22.553,446,480,3546
1998,4236,19836,29075,435762,423700,3416,11.812,3104,10.733,89820,29552,60268,6.975,21.199,65113,25302,39811,5.972,15.368,24707,5.831,30.735,1554,1644,9521
1998,4237,11276,16264,192266,189507,1403,8.681,1199,7.419,29499,9130,20369,4.818,15.566,23917,7585,16332,4.003,12.621,5582,2.946,25.241,777,834,4604
1998,4238,49847,65019,755152,739572,4767,7.331,4778,7.348,112937,29230,83707,3.952,15.271,81877,28997,52880,3.921,11.071,31060,4.200,22.142,3064,3170,16433
1998,4239,28175,30498,318771,317859,3682,12.096,3567,11.718,55198,18293,36905,5.755,17.366,53585,19278,34307,6.065,16.858,1613,0.507,33.716,2751,2775,13329
1998,4241,9833,12972,216509,211461,1236,9.595,1056,8.197,32105,12167,19938,5.754,15.183,22060,7960,14100,3.764,10.432,10045,4.750,20.864,660,671,3716
1998,4242,4978,6438,169634,166590,966,15.243,765,12.071,27991,9397,18594,5.641,16.802,21893,8150,13743,4.892,13.142,6098,3.660,26.284,527,531,4927
1998,4243,13240,14186,171125,169774,1977,14.036,1775,12.602,33571,9692,23879,5.709,19.774,30704,10582,20122,6.233,18.085,2867,1.689,36.171,1354,1369,7087
1998,4244,27530,33146,757347,757272,3026,9.048,3619,10.822,103445,26880,76565,3.550,13.660,102854,35695,67159,4.714,13.582,591,0.078,27.164,2611,2693,17063
1998,4245,5204,8053,71656,71688,431,5.283,642,7.869,9913,2565,7348,3.578,13.828,9985,3489,6496,4.867,13.928,-72,-0.100,27.656,351,393,1995
1998,4246,9737,13654,156245,157216,1092,7.979,1156,8.447,22493,5501,16992,3.499,14.307,24290,9178,15112,5.838,15.450,-1797,-1.143,28.614,636,665,3467
1998,4247,7264,10486,127794,127359,825,7.877,800,7.638,21717,7304,14413,5.735,17.052,20623,6800,13823,5.339,16.193,1094,0.859,32.386,391,402,2445
1998,4248,3231,4113,145932,143666,259,6.260,308,7.444,16867,4600,12267,3.202,11.740,12202,3839,8363,2.672,8.493,4665,3.247,16.987,181,244,2511
1998,4249,22477,26811,350659,346258,3767,14.126,3479,13.046,66401,22707,43694,6.558,19.177,57449,21876,35573,6.318,16.591,8952,2.585,33.183,2522,2590,12785
1998,4251,33771,36133,291814,289458,3419,9.493,3185,8.843,49422,16458,32964,5.686,17.074,44652,16203,28449,5.598,15.426,4770,1.648,30.852,2119,2137,9238
1998,4411,42515,45654,1145659,1141387,4597,10.121,4127,9.087,137530,60202,77328,5.274,12.049,128981,39372,89609,3.449,11.300,8549,0.749,22.601,3224,3255,30728
1998,4412,11712,12594,107120,105273,1158,9.248,1012,8.082,17799,6325,11474,6.008,16.908,14089,4669,9420,4.435,13.383,3710,3.524,26.767,770,784,3347
1998,4413,37140,60576,529265,528678,4219,6.946,4552,7.494,80980,23480,57500,4.441,15.317,78303,27412,50891,5.185,14.811,2677,0.506,29.622,2338,2609,11404
1998,4421,19992,27820,272183,264347,2551,9.181,2481,8.929,51708,18495,33213,6.996,19.561,36176,12959,23217,4.902,13.685,15532,5.876,27.370,1640,1735,7958
1998,4422,24440,32016,240614,236570,3221,9.970,3801,11.766,46798,18315,28483,7.742,19.782,38588,16289,22299,6.886,16.311,8210,3.470,32.623,1922,2049,7238
1998,4431,32635,49490,436005,431638,5660,11.483,5260,10.672,82098,32094,50004,7.435,19.020,73268,28844,44424,6.682,16.974,8830,2.046,33.949,3247,3395,14474
1998,4441,49517,71095,998904,992822,4138,5.816,4255,5.980,130464,37911,92553,3.819,13.141,118116,38246,79870,3.852,11.897,12348,1.244,23.794,2726,2855,15007
1998,4442,16639,20650,176758,175510,1364,6.595,1426,6.895,26034,6348,19686,3.617,14.833,23401,6937,16464,3.952,13.333,2633,1.500,26.666,945,971,3944
1998,4451,59925,87919,2663671,2641784,8652,9.807,9259,10.495,352129,146577,205552,5.548,13.329,304305,109549,194756,4.147,11.519,47824,1.810,23.038,6221,6391,41716
1998,4452,16017,20440,127814,126484,3223,16.019,2583,12.838,27752,12146,15606,9.603,21.941,25238,11184,14054,8.842,19.954,2514,1.988,39.907,1835,1879,7791
1998,4453,23038,26050,130309,130013,2131,8.066,2867,10.852,23116,7193,15923,5.533,17.780,22273,9007,13266,6.928,17.131,843,0.648,34.263,1777,1807,5357
1998,4461,41215,79432,940922,919179,6811,8.618,6007,7.601,171822,64270,107552,6.992,18.693,128840,42925,85915,4.670,14.017,42982,4.676,28.034,3402,3714,20978
1998,4471,65416,117717,938852,925651,9269,7.851,9948,8.426,178913,60938,117975,6.583,19.328,152356,55038,97318,5.946,16.459,26557,2.869,32.919,5715,6339,32395
1998,4481,39215,86639,923992,907010,8496,9.749,9514,10.917,177301,59627,117674,6.574,19.548,143588,51412,92176,5.668,15.831,33713,3.717,31.662,4625,5087,19465
1998,4482,6941,28764,197004,189953,1938,6.744,1887,6.566,36948,14707,22241,7.742,19.451,22872,8135,14737,4.283,12.041,14076,7.410,24.082,667,739,2559
1998,4483,18952,28732,159934,162304,2768,9.660,2612,9.116,28707,11042,17665,6.803,17.687,33866,14041,19825,8.651,20.866,-5159,-3.179,35.374,1359,1498,4718
1998,4511,30795,41794,382253,372572,4478,10.672,4812,11.468,71910,28920,42990,7.762,19.301,52716,22152,30564,5.946,14.149,19194,5.152,28.298,3156,3395,12184
1998,4512,7861,13609,137519,133746,1375,10.064,1482,10.847,28756,15843,12913,11.846,21.500,21460,8275,13185,6.187,16.045,7296,5.455,32.091,823,895,3390
1998,4522,69,6143,1058356,1050441,131,2.133,128,2.084,88902,16377,72525,1.559,8.463,71184,10822,60362,1.030,6.777,17718,1.687,13.553,D,D,D
1998,4523,9079,28231,1462372,1463948,3215,11.478,2773,9.900,147372,76844,70528,5.249,10.067,152476,34006,118470,2.323,10.415,-5104,-0.349,20.134,1053,1194,5398
1998,4531,22333,23463,122813,123295,2246,9.511,2552,10.806,20879,6929,13950,5.620,16.934,21856,7634,14222,6.192,17.727,-977,-0.792,33.868,1998,2021,5872
1998,4532,29961,41305,336859,326402,4834,11.734,4618,11.210,71639,30166,41473,9.242,21.948,50880,18540,32340,5.680,15.588,20759,6.360,31.176,3169,3253,10952
1998,4533,12936,16339,105352,100515,2047,12.652,1728,10.680,23441,8397,15044,8.354,23.321,13590,4982,8608,4.956,13.520,9851,9.801,27.041,1352,1364,3504
1998,4539,30494,37142,235676,229213,5254,14.339,4254,11.610,54612,21808,32804,9.514,23.826,41303,17331,23972,7.561,18.019,13309,5.806,36.039,3053,3150,12336
1998,4541,8353,9118,214445,207264,1426,15.987,1030,11.547,39714,13044,26670,6.293,19.161,25344,6627,18717,3.197,12.228,14370,6.933,24.456,782,790,4317
1998,4542,5138,5725,66405,68648,647,11.120,834,14.334,9017,2880,6137,4.195,13.135,13760,8093,5667,11.789,20.044,-4743,-6.909,26.270,559,566,2509
1998,4543,19250,25333,221822,220483,2664,10.553,2485,9.844,37557,12417,25140,5.632,17.034,35079,13081,21998,5.933,15.910,2478,1.124,31.820,1755,1791,7715
1998,4811,613,3091,505039,497455,344,11.340,229,7.549,44759,7454,37305,1.498,8.998,29844,3431,26413,0.690,5.999,14915,2.998,11.999,62,75,1965
1998,4812,1518,1664,27003,26636,233,14.164,195,11.854,5709,867,4842,3.255,21.434,5239,1695,3544,6.364,19.669,470,1.765,39.338,153,153,892
1998,4831,773,1182,54471,53872,186,16.000,147,12.645,11330,4974,6356,9.233,21.031,10194,5233,4961,9.714,18.923,1136,2.109,37.845,71,88,2296
1998,4832,493,536,18282,18064,54,10.160,45,8.467,2506,689,1817,3.814,13.873,2056,533,1523,2.951,11.382,450,2.491,22.764,32,32,280
1998,4841,33687,41848,890800,873209,7624,18.614,5845,14.271,144237,43189,101048,4.946,16.518,109565,41543,68022,4.758,12.547,34672,3.971,25.095,4272,4421,23737
1998,4842,47862,51272,495477,486786,7223,14.164,6667,13.074,99065,30737,68328,6.314,20.351,81526,29516,52010,6.063,16.748,17539,3.603,33.496,5147,5175,20465
1998,4851,446,560,29397,29040,77,13.762,76,13.584,3523,975,2548,3.357,12.132,2790,826,1964,2.844,9.607,733,2.524,19.215,64,64,522
1998,4852,196,353,17448,17235,27,7.595,32,9.001,2060,444,1616,2.576,11.952,1648,436,1212,2.530,9.562,412,2.390,19.124,19,19,139
1998,4853,5641,5725,60558,59795,927,16.385,792,13.999,13664,6040,7624,10.101,22.851,11986,4321,7665,7.226,20.045,1678,2.806,40.090,650,656,3503
1998,4854,3206,4252,153106,152479,318,7.471,327,7.682,22566,6827,15739,4.477,14.799,21753,5645,16108,3.702,14.266,813,0.533,28.533,224,226,2564
1998,4855,1246,1377,30812,30448,132,9.531,148,10.686,4973,1127,3846,3.701,16.333,4148,1589,2559,5.219,13.623,825,2.710,27.247,117,118,1354
1998,4859,2164,2332,47494,46779,357,15.435,319,13.792,10002,3486,6516,7.452,21.381,8632,3872,4760,8.277,18.453,1370,2.929,36.905,247,265,2786
1998,4861,45,358,7077,7438,42,11.570,52,14.325,809,372,437,5.001,10.877,1530,547,983,7.354,20.570,-721,-9.693,21.753,D,D,D
1998,4862,131,1560,32702,32805,233,15.559,108,7.212,5715,1938,3777,5.908,17.421,5749,1600,4149,4.877,17.525,-34,-0.104,34.842,7,11,154
1998,4869,53,542,6111,5931,99,19.488,31,6.102,1137,814,323,13.724,19.170,793,171,622,2.883,13.370,344,5.800,26.741,D,D,D
1998,4871,329,367,8632,8421,45,12.295,43,11.749,1798,642,1156,7.624,21.351,1334,366,968,4.346,15.841,464,5.510,31.683,34,34,311
1998,4872,1176,1205,12506,12829,172,14.399,151,12.641,2674,1163,1511,9.065,20.843,3375,1598,1777,12.456,26.308,-701,-5.464,41.687,110,111,864
1998,4879,141,145,1764,1705,26,18.246,21,14.737,463,150,313,8.800,27.163,333,83,250,4.869,19.537,130,7.627,39.073,16,16,73
1998,4881,3079,3985,114917,111771,484,12.295,387,9.831,20260,8046,12214,7.199,18.126,14256,5073,9183,4.539,12.755,6004,5.372,25.509,251,253,1834
1998,4882,437,755,19838,19737,93,12.039,128,16.570,3844,1683,2161,8.527,19.476,3600,1727,1873,8.750,18.240,244,1.236,36.480,43,61,482
1998,4883,1750,2252,71379,72338,229,10.232,201,8.981,12815,5043,7772,6.971,17.715,15003,3029,11974,4.187,20.740,-2188,-3.025,35.431,135,137,1607
1998,4884,5679,5918,47015,46159,870,14.924,693,11.888,9683,3730,5953,8.081,20.978,8060,3734,4326,8.090,17.462,1623,3.516,34.923,529,532,2963
1998,4885,11000,14587,148182,143648,1655,11.461,1362,9.432,29378,9090,20288,6.328,20.451,20491,7442,13049,5.181,14.265,8887,6.187,28.529,924,964,4772
1998,4889,796,1578,55275,37269,886,74.958,94,7.953,38695,35220,3475,94.502,103.826,3343,595,2748,1.597,8.970,35352,94.856,17.940,76,77,308
1998,4921,2004,5610,466760,465656,964,17.955,482,8.977,48537,21308,27229,4.576,10.423,42947,7725,35222,1.659,9.223,5590,1.200,18.446,220,223,2760
1998,4922,4417,4796,69427,68663,703,14.686,685,14.310,14366,3551,10815,5.172,20.923,12926,4193,8733,6.107,18.825,1440,2.097,37.651,575,579,3232
1998,4931,6490,11911,512203,508373,1273,10.804,1017,8.631,89370,33308,56062,6.552,17.580,82734,29578,53156,5.818,16.274,6636,1.305,32.549,334,353,3849
1998,5111,15847,19066,709945,697258,1943,10.238,1767,9.311,90939,24340,66599,3.491,13.042,64758,15761,48997,2.260,9.287,26181,3.755,18.575,1339,1348,7896
1998,5112,8531,10723,277189,266613,1390,13.063,1225,11.513,67651,18811,48840,7.056,25.374,45942,17546,28396,6.581,17.232,21709,8.143,34.463,779,801,7734
1998,5121,11853,16047,258409,255106,2277,14.278,2078,13.030,61069,28041,33028,10.992,23.939,54316,23750,30566,9.310,21.292,6753,2.647,42.583,1201,1281,8506
1998,5122,2416,2539,19995,19661,437,17.625,318,12.825,4386,1907,2479,9.700,22.309,3613,1255,2358,6.383,18.377,773,3.932,36.754,243,243,963
1998,5151,5635,7747,239844,241719,797,10.094,1094,13.856,34938,12599,22339,5.212,14.454,38574,20519,18055,8.489,15.958,-3636,-1.504,28.908,744,811,11435
1998,5152,279,621,29994,28707,179,31.879,60,10.686,7744,4026,3718,14.025,26.976,5179,2156,3023,7.510,18.041,2565,8.935,36.082,12,12,572
1998,5173,6986,33711,1185312,1149220,7144,22.351,3647,11.410,282729,128562,154167,11.187,24.602,208566,92456,116110,8.045,18.148,74163,6.453,36.297,914,997,12191
1998,5174,347,554,11137,10182,174,35.116,57,11.504,4523,2540,1983,24.947,44.424,2631,1183,1448,11.619,25.841,1892,18.583,51.682,26,27,361
1998,5179,4568,5221,79674,71405,1617,33.098,946,19.363,33244,15257,17987,21.367,46.557,16563,6328,10235,8.862,23.196,16681,23.361,46.392,662,667,3620
1998,5182,4517,8079,327622,318065,1452,18.745,786,10.147,69278,22822,46456,7.175,21.781,49694,13835,35859,4.350,15.624,19584,6.157,31.248,380,387,3636
1998,5191,2820,3445,51789,49643,372,11.066,205,6.098,9117,3078,6039,6.200,18.365,4934,1368,3566,2.756,9.939,4183,8.426,19.878,138,144,604
1998,5211,15,44,21936,22033,3,6.977,D,D,488,42,446,0.191,2.215,683,D,664,D,3.100,-195,-0.885,4.430,0,0,0
1998,5221,19089,105271,1955756,1945613,8983,8.618,6904,6.624,301776,108195,193581,5.561,15.511,283174,96583,186591,4.964,14.554,18602,0.956,29.109,415,760,13294
1998,5222,17659,44387,586742,557134,6710,15.347,5382,12.309,157352,59549,97803,10.688,28.243,98558,42658,55900,7.657,17.690,58794,10.553,35.380,1601,1719,10308
1998,5223,11715,16266,185585,169590,3508,22.925,1580,10.325,60299,23194,37105,13.677,35.556,28623,12242,16381,7.219,16.878,31676,18.678,33.756,892,938,5642
1998,5231,11163,29905,471064,480475,5642,19.658,3235,11.271,91716,35072,56644,7.299,19.089,113049,33935,79114,7.063,23.529,-21333,-4.440,38.177,872,901,7467
1998,5232,34,46,6184,6077,13,31.707,3,7.317,588,374,214,6.155,9.677,419,3,416,0.049,6.895,169,2.781,13.791,D,D,D
1998,5239,22408,25101,263572,257452,4228,17.248,3053,12.454,63283,21857,41426,8.490,24.581,50760,17077,33683,6.633,19.716,12523,4.864,39.433,2041,2069,8638
1998,5241,4567,38267,1551637,1549517,6923,18.622,4743,12.758,255045,86369,168676,5.574,16.460,254296,71110,183186,4.589,16.411,749,0.048,32.823,281,312,5222
1998,5242,112726,123864,788389,771173,11687,9.478,10567,8.570,144763,47101,97662,6.108,18.772,110130,43732,66398,5.671,14.281,34633,4.491,28.562,7182,7308,24174
1998,5259,224,249,2318,2167,111,52.235,38,17.882,1468,1280,188,59.081,67.759,1190,276,914,12.739,54.927,278,12.832,109.855,25,29,120
1998,5311,88884,99088,507565,506075,10437,10.541,10284,10.387,102718,43951,58767,8.685,20.297,99742,43710,56032,8.637,19.709,2976,0.588,39.418,7528,7696,29487
1998,5312,47045,52624,236220,231041,7689,14.787,6441,12.387,57037,24217,32820,10.482,24.687,46455,19534,26921,8.455,20.107,10582,4.580,40.214,4325,4407,12516
1998,5313,40332,46888,462150,461207,6506,14.114,4924,10.682,97897,37729,60168,8.180,21.226,94878,39004,55874,8.457,20.572,3019,0.655,41.143,2932,3079,21755
1998,5321,4501,10129,172716,164384,1459,14.770,957,9.688,33789,8057,25732,4.901,20.555,17173,7243,9930,4.406,10.447,16616,10.108,20.894,457,532,3446
1998,5322,17333,30745,242382,236182,3409,10.939,4246,13.625,57157,21388,35769,9.056,24.200,45497,19572,25925,8.287,19.264,11660,4.937,38.527,2520,3148,13425
1998,5323,3567,5929,39632,38930,479,8.111,432,7.315,6767,2517,4250,6.465,17.382,5355,2279,3076,5.854,13.755,1412,3.627,27.511,280,291,1528
1998,5324,7347,10684,137354,134341,1520,14.405,1256,11.903,30110,11731,18379,8.732,22.413,23682,9484,14198,7.060,17.628,6428,4.785,35.257,695,821,6073
1998,5331,1672,1790,19147,18933,229,12.844,215,12.058,4171,1453,2718,7.674,22.030,3753,984,2769,5.197,19.823,418,2.208,39.645,143,143,716
1998,5411,155471,162691,1053444,1041202,14697,9.069,13416,8.279,145743,46000,99743,4.418,13.998,121188,37829,83359,3.633,11.639,24555,2.358,23.278,9623,9740,26307
1998,5412,84645,90132,1076257,1017176,9471,10.580,8241,9.206,242546,76903,165643,7.560,23.845,123215,41841,81374,4.113,12.113,119331,11.732,24.227,5636,5665,21227
1998,5413,80368,90060,1173784,1124974,11339,12.800,8390,9.471,242286,96572,145714,8.584,21.537,143045,42874,100171,3.811,12.715,99241,8.822,25.431,5671,5748,23459
1998,5414,22759,22974,123570,119975,3836,17.035,2924,12.985,28305,11058,17247,9.217,23.593,21065,8770,12295,7.310,17.558,7240,6.035,35.116,2239,2248,7046
1998,5415,59927,66484,867101,813383,17712,28.564,8760,14.127,267571,110916,156655,13.636,32.896,159940,60976,98964,7.497,19.664,107631,13.233,39.327,5775,5836,28614
1998,5416,58388,61920,529105,496949,14299,24.151,8872,14.985,154975,62699,92276,12.617,31.185,90608,38872,51736,7.822,18.233,64367,12.952,36.466,6545,6579,27532
1998,5417,8961,11318,513374,498964,1594,14.279,1284,11.502,90086,29637,60449,5.940,18.055,61176,16445,44731,3.296,12.261,28910,5.794,24.521,725,755,4249
1998,5418,32303,35500,446890,437268,5010,14.355,3811,10.920,90043,32214,57829,7.367,20.592,70598,22705,47893,5.192,16.145,19445,4.447,32.290,2783,2799,15018
1998,5419,41263,47943,423283,407153,6552,14.075,3764,8.086,90720,31475,59245,7.731,22.282,57778,20801,36977,5.109,14.191,32942,8.091,28.381,2229,2241,13491
1998,5511,28093,51041,3294237,3259961,5406,10.604,5287,10.370,616732,172761,443971,5.299,18.918,548318,173533,374785,5.323,16.820,68414,2.099,33.640,1115,1186,16463
1998,5611,18771,21727,365867,348754,3543,16.526,2966,13.835,104119,44453,59666,12.746,29.855,69359,28415,40944,8.148,19.888,34760,9.967,39.775,2068,2099,20336
1998,5612,1238,2405,108467,108606,398,16.872,306,12.972,22272,9401,12871,8.656,20.507,22795,8754,14041,8.060,20.989,-523,-0.482,41.014,69,117,2688
1998,5613,24869,40239,3574533,3380921,7081,18.294,4018,10.380,1111358,369749,741609,10.936,32.871,721946,240639,481307,7.118,21.354,389412,11.518,42.707,2388,2510,81449
1998,5614,25709,30485,641264,610366,4801,16.028,3738,12.479,158253,58338,99915,9.558,25.928,96111,40012,56099,6.555,15.746,62142,10.181,31.493,2656,2720,21529
1998,5615,25141,33265,295997,290042,4105,12.453,3504,10.630,58027,23815,34212,8.211,20.006,46700,17376,29324,5.991,16.101,11327,3.905,32.202,2394,2508,12518
1998,5616,15588,19507,685586,665028,2819,14.626,2354,12.213,133943,37252,96691,5.602,20.141,91350,39315,52035,5.912,13.736,42593,6.405,27.473,1661,1704,24622
1998,5617,113346,118792,1391896,1366040,19419,16.548,16537,14.092,299691,97140,202551,7.111,21.939,247070,88574,158496,6.484,18.087,52621,3.852,36.173,12858,12886,60965
1998,5619,21004,22877,352094,342903,3336,14.689,3003,13.223,80141,21232,58909,6.192,23.371,61835,20820,41015,6.072,18.033,18306,5.339,36.066,2197,2216,13623
1998,5621,6429,7674,145424,143750,1013,13.356,834,10.996,22975,10587,12388,7.365,15.983,19993,8832,11161,6.144,13.908,2982,2.074,27.816,648,657,5442
1998,5622,1423,2209,56546,57070,299,13.644,264,12.047,10585,4635,5950,8.122,18.548,11648,5047,6601,8.844,20.410,-1063,-1.863,37.095,165,167,2530
1998,5629,5163,5760,89528,87759,719,12.695,526,9.288,19923,6798,13125,7.746,22.702,16256,4266,11990,4.861,18.524,3667,4.179,37.047,370,374,2265
1998,6111,15681,17838,663366,651407,838,4.726,625,3.525,67490,15886,51604,2.439,10.361,43156,8133,35023,1.249,6.625,24334,3.736,13.250,360,368,4856
1998,6112,533,795,74679,73884,24,2.983,43,5.345,7225,393,6832,0.532,9.779,5572,1298,4274,1.757,7.542,1653,2.237,15.083,30,32,1168
1998,6113,2297,2861,1266829,1245650,162,5.723,101,3.568,90797,6429,84368,0.516,7.289,48539,2418,46121,0.194,3.897,42258,3.392,7.793,67,68,1555
1998,6114,5222,5743,58223,58660,1003,17.710,844,14.902,15256,5225,10031,8.907,26.008,15866,8841,7025,15.072,27.048,-610,-1.040,52.015,605,617,3500
1998,6115,5355,6236,69476,68390,721,11.594,687,11.047,13289,3585,9704,5.242,19.431,10987,3718,7269,5.437,16.065,2302,3.366,32.131,485,499,2653
1998,6116,19789,21192,170263,162784,3161,15.217,2323,11.183,42236,15457,26779,9.495,25.946,27541,10048,17493,6.173,16.919,14695,9.027,33.838,1722,1728,7093
1998,6117,3095,3323,32140,30381,631,19.605,422,13.112,7827,3013,4814,9.917,25.763,4310,1402,2908,4.615,14.186,3517,11.576,28.373,313,313,902
1998,6211,158515,179692,1615851,1598013,14677,8.138,16003,8.873,291776,106207,185569,6.646,18.259,255370,91151,164219,5.704,15.980,36406,2.278,31.961,11681,12056,62462
1998,6212,106184,109791,663511,656532,5657,5.179,4530,4.147,89904,25788,64116,3.928,13.694,76145,20130,56015,3.066,11.598,13759,2.096,23.196,3449,3543,15278
1998,6213,76390,81858,419824,412376,8384,10.298,7496,9.207,81660,30435,51225,7.380,19.802,66448,26217,40231,6.358,16.113,15212,3.689,32.227,5447,5529,18625
1998,6214,10118,21060,523924,510580,2571,12.506,1566,7.618,96639,42651,53988,8.353,18.927,68695,24675,44020,4.833,13.454,27944,5.473,26.909,692,765,9465
1998,6215,5452,8903,151476,149049,984,10.971,1116,12.443,27981,9667,18314,6.486,18.773,23385,11739,11646,7.876,15.690,4596,3.084,31.379,567,582,4393
1998,6216,11070,17921,894320,902565,2126,11.907,1995,11.173,163708,43044,120664,4.769,18.138,180669,55607,125062,6.161,20.017,-16961,-1.879,36.276,1089,1125,26572
1998,6219,4181,6234,174849,172760,801,13.158,508,8.345,25959,9346,16613,5.410,15.026,21859,8693,13166,5.032,12.653,4100,2.373,25.306,330,347,4952
1998,6221,3537,5453,4531383,4497382,158,2.914,95,1.752,276368,66991,209377,1.490,6.145,209765,48799,160966,1.085,4.664,66603,1.481,9.328,40,40,19834
1998,6222,507,788,246882,250575,53,6.642,73,9.148,15020,4102,10918,1.637,5.994,23022,14230,8792,5.679,9.188,-8002,-3.193,11.988,12,12,3846
1998,6223,285,430,152038,149734,44,10.693,7,1.701,10179,3753,6426,2.506,6.798,5533,936,4597,0.625,3.695,4646,3.103,7.390,D,D,D
1998,6231,7975,15508,1546845,1529050,1416,9.339,725,4.782,169434,66030,103404,4.318,11.081,132250,43845,88405,2.867,8.649,37184,2.432,17.298,436,460,25077
1998,6232,7471,20330,376225,364770,1984,9.983,1072,5.394,72452,24318,48134,6.667,19.862,49330,15313,34017,4.198,13.524,23122,6.339,27.047,424,466,6998
1998,6233,12138,14877,430205,414172,2083,14.323,1416,9.736,74595,30158,44437,7.282,18.011,42385,17527,24858,4.232,10.234,32210,7.777,20.467,960,1009,10818
1998,6239,3375,5742,137276,134453,585,10.290,471,8.285,22551,6621,15930,4.924,16.772,16827,5012,11815,3.728,12.515,5724,4.257,25.030,267,299,2979
1998,6241,29440,41315,693478,677401,3762,9.199,2926,7.155,121572,31022,90550,4.580,17.947,89169,20855,68314,3.079,13.163,32403,4.783,26.327,1689,1760,10200
1998,6242,7947,9843,109643,106329,626,6.434,400,4.111,17585,3910,13675,3.677,16.538,10888,2295,8593,2.158,10.240,6697,6.298,20.480,202,204,998
1998,6243,5226,7824,296515,291963,588,7.505,610,7.786,53290,10431,42859,3.573,18.252,44430,7382,37048,2.528,15.218,8860,3.035,30.435,290,298,2885
1998,6244,46851,57848,640925,629178,6596,11.504,5574,9.721,110183,40043,70140,6.364,17.512,86882,31698,55184,5.038,13.809,23301,3.703,27.618,4101,4183,21841
1998,7111,7545,7662,112622,110739,1171,15.483,973,12.865,25945,8350,17595,7.540,23.429,21896,7208,14688,6.509,19.773,4049,3.656,39.545,671,672,4315
1998,7112,3125,3245,88939,88306,525,16.381,445,13.885,15909,5444,10465,6.165,18.016,14490,4997,9493,5.659,16.409,1419,1.607,32.818,335,340,2056
1998,7113,3139,3258,63311,63904,487,15.290,341,10.706,15474,6350,9124,9.937,24.214,16340,5566,10774,8.710,25.570,-866,-1.355,48.429,241,243,2788
1998,7114,2218,2274,14039,14148,345,15.385,282,12.575,3316,1696,1620,11.988,23.438,3544,1185,2359,8.376,25.049,-228,-1.612,46.876,201,202,758
1998,7115,8263,8282,32093,32741,1692,20.899,1320,16.304,11261,4856,6405,14.832,34.395,12438,4365,8073,13.332,37.990,-1177,-3.595,68.789,791,791,2180
1998,7121,4821,5189,95069,93056,335,6.519,235,4.573,11581,1534,10047,1.648,12.445,7510,920,6590,0.989,8.070,4071,4.375,16.141,142,142,635
1998,7131,1716,2799,138475,133334,390,13.994,366,13.132,26522,10925,15597,8.194,19.891,15934,4070,11864,3.052,11.950,10588,7.941,23.901,200,206,2951
1998,7132,1660,1983,163864,159637,229,11.657,192,9.773,22147,5319,16828,3.332,13.873,13635,3940,9695,2.468,8.541,8512,5.332,17.083,131,132,2945
1998,7139,44220,48115,861188,845996,5234,10.941,4681,9.785,153758,53703,100055,6.348,18.175,123526,44980,78546,5.317,14.601,30232,3.574,29.203,3397,3480,30774
1998,7211,33715,42492,1625830,1600759,5198,12.444,3754,8.987,276071,137610,138461,8.597,17.246,223869,91453,132416,5.713,13.985,52202,3.261,27.970,2419,2478,46595
1998,7212,5122,5516,35670,35162,572,10.423,516,9.402,7045,2111,4934,6.004,20.036,5988,1846,4142,5.250,17.030,1057,3.006,34.060,315,343,1250
1998,7213,3088,3162,15549,15446,245,7.674,306,9.585,2723,846,1877,5.477,17.629,2511,985,1526,6.377,16.257,212,1.373,32.513,216,216,633
1998,7223,9546,22979,476424,476435,3763,16.222,4199,18.101,110804,40140,70664,8.425,23.257,110700,61827,48873,12.977,23.235,104,0.022,46.470,1156,1170,6946
1998,7224,46684,47112,319542,318555,5297,11.156,6032,12.704,70435,33684,36751,10.574,22.111,68303,28807,39496,9.043,21.442,2132,0.669,42.883,4756,4766,22686
1998,7225,263415,362820,6980932,6923894,42990,11.871,41665,11.505,1317032,607809,709223,8.778,19.022,1200021,470886,729135,6.801,17.332,117011,1.690,34.663,28907,29898,282119
1998,8111,138820,151212,836768,833832,16503,10.952,15447,10.251,151630,62547,89083,7.501,18.185,145346,55887,89459,6.702,17.431,6284,0.754,34.862,11197,11314,39321
1998,8112,13647,15823,142688,140659,1749,10.957,2029,12.711,28659,8849,19810,6.291,20.375,24804,11024,13780,7.837,17.634,3855,2.741,35.268,1373,1462,5890
1998,8113,21089,22615,193326,191992,2243,9.945,2119,9.396,32049,8808,23241,4.588,16.693,29005,8968,20037,4.671,15.107,3044,1.585,30.215,1569,1581,5739
1998,8114,24558,26022,147597,147166,3251,12.480,3305,12.688,24965,9493,15472,6.451,16.964,24073,9225,14848,6.268,16.358,892,0.606,32.715,2584,2597,7087
1998,8121,75288,86385,476790,467892,11661,13.552,10988,12.770,105688,52176,53512,11.151,22.588,87472,41859,45613,8.946,18.695,18216,3.893,37.390,8113,8483,28206
1998,8122,15773,22087,165908,162016,1936,8.871,1412,6.470,33303,13117,20186,8.096,20.555,24235,7800,16435,4.814,14.958,9068,5.597,29.917,939,1021,5162
1998,8123,34423,40717,391187,391233,4066,9.945,4400,10.762,60750,21702,39048,5.547,15.528,60347,22139,38208,5.659,15.425,403,0.103,30.850,3110,3215,14056
1998,8129,16774,26706,214516,208307,5021,19.525,3041,11.825,50602,22605,27997,10.852,24.292,38416,16897,21519,8.112,18.442,12186,5.850,36.884,1690,1809,9089
1998,8131,156333,156463,1457256,1445589,7521,4.834,5736,3.687,159846,21950,137896,1.518,11.057,136010,16318,119692,1.129,9.409,23836,1.649,18.817,3478,3478,9074
1998,8132,9934,11698,118837,116343,1328,11.692,649,5.714,19555,5847,13708,5.026,16.808,14614,2511,12103,2.158,12.561,4941,4.247,25.122,375,385,1318
1998,8133,8168,9781,90088,88345,929,9.631,659,6.832,15529,3794,11735,4.295,17.578,12009,2625,9384,2.971,13.593,3520,3.984,27.187,419,429,1782
1998,8134,27963,29716,308643,305186,1481,4.981,1510,5.079,40398,7014,33384,2.298,13.237,33381,6015,27366,1.971,10.938,7017,2.299,21.876,1043,1045,4092
1998,8139,63246,65159,497331,498133,3612,5.546,3547,5.446,64824,15010,49814,3.013,13.013,66218,14263,51955,2.863,13.293,-1394,-0.280,26.027,2539,2546,9532
1999,1131,323,366,3132,3189,68,19.346,39,11.095,523,210,313,6.585,16.400,652,296,356,9.282,20.445,-129,-4.045,32.800,13,13,83
1999,1132,142,205,1420,1460,38,18.812,32,15.842,390,180,210,12.329,26.712,445,208,237,14.247,30.479,-55,-3.767,53.425,15,15,56
1999,1133,11409,11481,78862,78915,1328,11.471,1520,13.129,15119,4873,10246,6.175,19.159,15245,5225,10020,6.621,19.318,-126,-0.160,38.317,1176,1176,3957
1999,1141,1344,1351,7596,7645,209,15.551,195,14.509,2118,765,1353,10.007,27.706,2150,1061,1089,13.879,28.125,-32,-0.419,55.412,120,120,472
1999,1142,280,280,2323,2229,56,20.896,32,11.940,444,158,286,7.088,19.919,249,79,170,3.544,11.171,195,8.748,22.342,23,23,68
1999,1151,4515,4842,65614,65028,546,11.276,546,11.276,14642,3754,10888,5.773,22.517,13560,4621,8939,7.106,20.853,1082,1.664,41.705,387,389,3383
1999,1152,2843,2891,17270,16905,463,16.288,366,12.876,3370,1394,1976,8.246,19.936,2662,1107,1555,6.549,15.747,708,4.188,31.495,284,284,851
1999,1153,1199,1236,14129,13901,195,16.169,135,11.194,2680,635,2045,4.568,19.279,2250,560,1690,4.028,16.186,430,3.093,32.372,94,94,413
1999,2111,5670,6845,85822,90497,543,7.708,943,13.385,11926,5342,6584,5.903,13.178,21260,6136,15124,6.780,23.492,-9334,-10.314,26.357,563,574,2827
1999,2121,841,1245,76754,79064,124,9.691,193,15.084,8211,2677,5534,3.386,10.385,12869,4637,8232,5.865,16.277,-4658,-5.891,20.771,119,126,2074
1999,2122,299,413,36817,38577,62,14.797,74,17.661,2162,1205,957,3.124,5.604,5736,663,5073,1.719,14.869,-3574,-9.265,11.209,49,50,250
1999,2123,3221,5073,100711,101111,411,8.125,382,7.552,13147,3617,9530,3.577,13.003,14051,4891,9160,4.837,13.897,-904,-0.894,26.005,201,206,1732
1999,2131,6618,7692,145114,157793,731,9.240,1169,14.777,24165,7575,16590,4.801,15.314,48695,16232,32463,10.287,30.860,-24530,-15.546,30.629,785,800,7463
1999,2211,1565,8693,532003,536196,930,11.016,428,5.070,47679,20354,27325,3.796,8.892,55567,9944,45623,1.855,10.363,-7888,-1.471,17.784,64,71,1025
1999,2212,556,2659,92410,95722,374,14.140,346,13.081,14076,7576,6500,7.915,14.705,20527,8600,11927,8.984,21.445,-6451,-6.739,29.410,47,52,561
1999,2213,4121,4582,36022,35429,242,5.268,265,5.769,4291,1237,3054,3.491,12.112,3166,1177,1989,3.322,8.936,1125,3.175,17.872,170,180,698
1999,2361,132537,133178,724351,696575,22739,17.334,18750,14.293,207963,76124,131839,10.928,29.855,152242,66713,85529,9.577,21.856,55721,7.999,43.712,13458,13463,49113
1999,2362,40758,41572,773046,754091,4607,11.158,4037,9.778,157646,32164,125482,4.265,20.905,120010,25190,94820,3.340,15.915,37636,4.991,31.829,2899,2901,17972
1999,2371,16206,16573,397888,386553,1579,9.632,1219,7.436,81138,15294,65844,3.957,20.990,58306,16505,41801,4.270,15.084,22832,5.907,30.167,915,918,12519
1999,2372,9022,9195,64646,60588,1892,21.178,1370,15.335,20476,9335,11141,15.407,33.795,12335,5625,6710,9.284,20.359,8141,13.437,40.718,1015,1015,3957
1999,2373,10703,11118,280486,272515,894,8.041,894,8.041,58456,9025,49431,3.312,21.451,42335,11032,31303,4.048,15.535,16121,5.916,31.070,645,647,6388
1999,2379,4653,4738,69603,68113,567,11.934,593,12.482,15844,4010,11834,5.887,23.261,12821,3497,9324,5.134,18.823,3023,4.438,37.646,465,466,2238
1999,2381,91923,92306,941456,905179,12170,13.334,10095,11.061,235814,58818,176996,6.498,26.052,163604,50642,112962,5.595,18.074,72210,7.977,36.148,7530,7537,37134
1999,2382,141622,143970,1686863,1635737,15350,10.747,13058,9.143,332521,72291,260230,4.419,20.329,229848,72817,157031,4.452,14.052,102673,6.277,28.103,9795,9810,55579
1999,2383,95517,96145,799218,771208,14687,15.468,12303,12.957,204809,54502,150307,7.067,26.557,148679,52557,96122,6.815,19.279,56130,7.278,38.557,9221,9222,39384
1999,2389,49939,50212,425810,411331,7011,14.215,5228,10.600,101742,28049,73693,6.819,24.735,72764,24401,48363,5.932,17.690,28978,7.045,35.380,3806,3812,17371
1999,3111,1030,1624,49056,48617,90,5.515,106,6.495,5701,1354,4347,2.785,11.726,4862,1730,3132,3.558,10.001,839,1.726,20.001,53,56,634
1999,3112,499,854,62731,62699,33,3.851,39,4.551,4554,869,3685,1.386,7.263,4471,1071,3400,1.708,7.131,83,0.132,14.262,25,25,293
1999,3113,1434,1624,83204,83698,127,7.789,140,8.586,6910,1115,5795,1.332,8.256,8094,1645,6449,1.965,9.671,-1184,-1.415,16.512,118,120,788
1999,3114,1297,1693,170760,170474,111,6.480,151,8.815,19391,3561,15830,2.089,11.375,19124,7063,12061,4.143,11.218,267,0.157,22.436,105,105,2410
1999,3115,1157,1680,129703,130105,82,4.822,123,7.233,11726,1980,9746,1.522,9.013,12481,4608,7873,3.542,9.593,-755,-0.580,18.025,70,70,1807
1999,3116,3282,3909,480365,471709,238,6.034,308,7.809,42294,8157,34137,1.729,8.966,25235,8034,17201,1.703,5.350,17059,3.616,10.699,223,223,2839
1999,3117,647,758,42169,43099,72,9.467,77,10.125,5150,1081,4069,2.508,11.949,7027,2288,4739,5.309,16.305,-1877,-4.355,23.899,48,48,1326
1999,3118,9254,10047,291049,294896,1056,10.410,1250,12.323,34972,9315,25657,3.159,11.859,42971,12934,30037,4.386,14.572,-7999,-2.712,23.718,962,984,7418
1999,3119,2278,2637,144374,144454,196,7.436,194,7.360,13906,3201,10705,2.216,9.627,14070,4469,9601,3.094,9.740,-164,-0.114,19.253,145,145,2289
1999,3121,1934,2399,140329,139634,196,8.185,187,7.810,11782,1563,10219,1.119,8.438,10309,2523,7786,1.807,7.383,1473,1.055,14.766,138,139,1216
1999,3122,80,108,28047,29053,9,8.108,15,13.514,1609,25,1584,0.086,5.538,3655,182,3473,0.626,12.581,-2046,-7.042,11.076,12,12,134
1999,3131,347,586,83065,82802,48,8.269,37,6.374,8812,4572,4240,5.522,10.642,8135,1231,6904,1.487,9.825,677,0.818,19.649,22,22,259
1999,3132,1638,1965,196836,202650,119,5.999,156,7.865,12033,3485,8548,1.720,5.938,23384,4378,19006,2.160,11.539,-11351,-5.601,11.876,118,118,1013
1999,3133,2670,2935,98117,103363,177,5.764,449,14.621,9053,2276,6777,2.202,8.758,19396,6655,12741,6.438,18.765,-10343,-10.006,17.517,363,368,3926
1999,3141,2681,2918,122161,122352,223,7.531,309,10.436,13744,4650,9094,3.801,11.233,13954,4749,9205,3.881,11.405,-210,-0.172,22.466,232,241,3079
1999,3149,4335,4468,104503,106426,421,9.415,428,9.572,14924,5117,9807,4.808,14.023,18853,6049,12804,5.684,17.715,-3929,-3.692,28.046,331,333,3786
1999,3151,988,1085,87184,90743,70,6.211,154,13.665,8354,2151,6203,2.370,9.206,15559,4982,10577,5.490,17.146,-7205,-7.940,18.412,121,122,2341
1999,3152,9556,10178,412952,446333,1393,13.240,2080,19.769,56089,20341,35748,4.557,12.567,123103,56865,66238,12.741,27.581,-67014,-15.014,25.133,1602,1612,27792
1999,3159,1908,1985,50054,52812,193,9.445,310,15.170,5313,2087,3226,3.952,10.060,10825,4041,6784,7.652,20.497,-5512,-10.437,20.120,232,239,2278
1999,3161,284,307,15191,15602,20,6.260,45,14.085,1205,200,1005,1.282,7.723,2092,589,1503,3.775,13.409,-887,-5.685,15.447,31,31,236
1999,3162,308,356,33768,35737,24,6.504,50,13.550,2898,815,2083,2.281,8.109,6760,2148,4612,6.011,18.916,-3862,-10.807,16.218,31,31,340
1999,3169,917,943,24916,25964,69,7.143,115,11.905,2521,567,1954,2.184,9.710,4624,1655,2969,6.374,17.809,-2103,-8.100,19.419,87,87,1320
1999,3211,4103,4577,134258,133953,320,6.972,345,7.517,13461,3575,9886,2.669,10.049,12863,3107,9756,2.319,9.603,598,0.446,19.205,253,253,1880
1999,3212,1427,1801,117773,115618,116,6.452,110,6.118,13260,3134,10126,2.711,11.469,9049,2916,6133,2.522,7.827,4211,3.642,15.653,81,83,1525
1999,3219,9150,9937,340906,335493,942,9.474,955,9.604,45680,10189,35491,3.037,13.616,35082,12351,22731,3.681,10.457,10598,3.159,20.914,741,747,8737
1999,3221,234,531,168373,171818,29,5.472,27,5.094,7981,4594,3387,2.674,4.645,14835,5444,9391,3.168,8.634,-6854,-3.989,9.290,7,7,451
1999,3222,3454,5196,392845,394472,232,4.450,267,5.121,35159,9582,25577,2.429,8.913,38853,15637,23216,3.964,9.849,-3694,-0.936,17.826,156,157,3250
1999,3231,36631,38430,825703,830585,2236,5.741,3270,8.396,80822,18624,62198,2.242,9.731,90467,35093,55374,4.225,10.892,-9645,-1.161,19.461,2555,2571,21447
1999,3241,1091,2146,104703,104390,134,6.266,119,5.565,8690,1846,6844,1.768,8.325,7929,2828,5101,2.709,7.596,761,0.729,15.191,55,58,901
1999,3251,1091,2350,201617,206151,125,5.313,130,5.526,9118,2492,6626,1.209,4.423,18063,3693,14370,1.791,8.762,-8945,-4.339,8.846,59,59,521
1999,3252,452,775,116203,118207,50,6.489,41,5.321,8065,1600,6465,1.354,6.823,11909,1889,10020,1.598,10.075,-3844,-3.252,13.646,22,22,777
1999,3253,652,877,36733,37075,59,6.712,63,7.167,2745,597,2148,1.610,7.404,3453,981,2472,2.646,9.314,-708,-1.910,14.808,33,37,497
1999,3254,1391,1722,211669,208297,149,8.772,102,6.005,21125,3602,17523,1.729,10.142,14545,2281,12264,1.095,6.983,6580,3.159,13.966,60,62,1113
1999,3255,1570,2023,74828,74867,83,4.057,129,6.305,6170,687,5483,0.918,8.241,6349,1650,4699,2.204,8.480,-179,-0.239,16.483,95,95,865
1999,3256,2080,2302,124676,125774,154,6.647,184,7.941,11513,2320,9193,1.845,9.154,13671,5325,8346,4.234,10.869,-2158,-1.716,18.307,125,125,2721
1999,3259,2122,2775,121298,123560,175,6.263,213,7.623,9725,1941,7784,1.571,7.871,14214,5497,8717,4.449,11.504,-4489,-3.633,15.741,129,129,1726
1999,3261,10566,13095,820609,816351,837,6.382,878,6.694,93534,22398,71136,2.744,11.458,84230,25973,58257,3.182,10.318,9304,1.140,20.636,575,581,11130
1999,3262,2023,2578,200912,200701,142,5.484,165,6.372,15699,3117,12582,1.553,7.822,15348,2389,12959,1.190,7.647,351,0.175,15.294,113,114,1212
1999,3271,1513,1764,74663,76435,118,6.611,160,8.964,5876,703,5173,0.920,7.688,9331,2726,6605,3.566,12.208,-3455,-4.520,15.375,130,130,1396
1999,3272,1867,2156,130288,130752,190,8.926,135,6.342,9307,2361,6946,1.806,7.118,10230,1439,8791,1.101,7.824,-923,-0.706,14.236,102,102,537
1999,3273,5452,8901,204206,199299,549,6.200,457,5.161,33005,7196,25809,3.611,16.561,23055,6536,16519,3.280,11.568,9950,4.993,23.136,262,269,3371
1999,3274,242,380,20914,20555,28,7.407,24,6.349,2016,310,1706,1.508,9.808,1285,483,802,2.350,6.252,731,3.556,12.503,15,15,128
1999,3279,1999,2406,75456,75670,177,7.363,173,7.196,7719,1819,5900,2.404,10.201,8041,1771,6270,2.340,10.626,-322,-0.426,20.402,112,112,992
1999,3311,248,341,139087,141964,54,16.463,28,8.537,6157,797,5360,0.561,4.337,12098,1146,10952,0.807,8.522,-5941,-4.185,8.674,14,14,114
1999,3312,531,734,65361,66086,59,8.138,41,5.655,4813,1045,3768,1.581,7.283,6290,1725,4565,2.610,9.518,-1477,-2.235,14.566,23,26,905
1999,3313,374,540,84899,84533,33,6.203,17,3.195,6739,2527,4212,2.989,7.972,5929,1853,4076,2.192,7.014,810,0.958,14.028,5,5,38
1999,3314,716,905,80130,82382,71,7.867,66,7.313,4944,2308,2636,2.802,6.001,9468,2937,6531,3.565,11.493,-4524,-5.491,12.003,44,46,767
1999,3315,2343,2663,220441,224477,115,4.294,145,5.414,14765,2679,12086,1.193,6.578,22959,5272,17687,2.349,10.228,-8194,-3.650,13.155,98,99,1758
1999,3321,2743,2978,147649,148310,128,4.293,135,4.528,12998,2556,10442,1.723,8.764,14389,3273,11116,2.207,9.702,-1391,-0.938,17.528,88,88,1338
1999,3322,1459,1614,82213,82583,76,4.670,103,6.329,7043,2143,4900,2.595,8.528,7778,1744,6034,2.112,9.418,-735,-0.890,17.057,70,71,1255
1999,3323,11173,12038,401976,396522,776,6.462,716,5.963,49982,9588,40394,2.418,12.605,39109,10518,28591,2.653,9.863,10873,2.742,19.726,532,536,7134
1999,3324,1436,1777,104346,105438,80,4.473,103,5.759,9135,1747,7388,1.657,8.664,11347,2931,8416,2.780,10.762,-2212,-2.098,17.328,61,61,784
1999,3325,770,857,64962,65589,44,5.096,57,6.601,5091,1009,4082,1.538,7.762,6305,2604,3701,3.970,9.613,-1214,-1.851,15.524,45,45,901
1999,3326,1631,1815,69069,69269,107,5.908,99,5.467,6454,1231,5223,1.777,9.317,6816,1945,4871,2.808,9.840,-362,-0.523,18.635,75,75,749
1999,3327,25300,25747,426405,435140,1649,6.374,1900,7.344,39542,9373,30169,2.154,9.087,57129,13291,43838,3.054,13.129,-17587,-4.042,18.174,1458,1458,9445
1999,3328,5529,6082,153364,155750,341,5.596,365,5.989,15607,4042,11565,2.595,10.021,20348,4616,15732,2.964,13.065,-4741,-3.044,20.041,272,274,2833
1999,3329,5784,6331,309797,313562,526,8.350,463,7.350,24585,6136,18449,1.957,7.841,31795,8324,23471,2.655,10.140,-7210,-2.299,15.681,338,339,3907
1999,3331,2622,2936,202548,209826,184,6.217,231,7.805,14971,3190,11781,1.520,7.135,29721,6641,23080,3.165,14.165,-14750,-7.030,14.270,174,174,2259
1999,3332,4096,4343,177893,185522,241,5.507,308,7.038,12378,3116,9262,1.680,6.672,27433,5313,22120,2.864,14.787,-15055,-8.115,13.344,214,215,2591
1999,3333,2289,2442,128670,130172,166,6.767,188,7.664,10907,1650,9257,1.268,8.379,13922,3340,10582,2.566,10.695,-3015,-2.316,16.758,131,131,1770
1999,3334,1450,1767,177696,174379,97,5.460,116,6.530,18714,3522,15192,2.020,10.732,11925,4698,7227,2.694,6.839,6789,3.893,13.677,77,79,1736
1999,3335,9407,9774,238177,243007,475,4.835,577,5.873,18650,3766,14884,1.550,7.675,28479,6655,21824,2.739,11.719,-9829,-4.045,15.349,438,442,3245
1999,3336,765,923,109630,110075,54,5.905,37,4.046,6026,904,5122,0.821,5.474,7092,855,6237,0.777,6.443,-1066,-0.968,10.949,27,27,231
1999,3339,5929,6589,348371,357444,345,5.194,452,6.805,24628,5150,19478,1.441,6.890,42917,9299,33618,2.602,12.007,-18289,-5.117,13.780,314,314,3937
1999,3341,1600,1703,209293,221230,192,11.137,234,13.573,27648,15426,12222,6.973,12.497,50332,10561,39771,4.774,22.751,-22684,-10.254,24.995,170,171,2766
1999,3342,1838,2033,241057,244206,145,7.071,180,8.778,24017,3205,20812,1.312,9.835,30322,8181,22141,3.350,12.417,-6305,-2.582,19.669,114,117,2509
1999,3343,482,516,29365,31106,58,11.143,67,12.872,2734,464,2270,1.492,8.789,6410,2826,3584,9.085,20.607,-3676,-11.818,17.579,46,46,330
1999,3344,5003,5675,545123,561173,414,7.230,517,9.028,50328,13626,36702,2.428,8.968,82676,23921,58755,4.263,14.733,-32348,-5.764,17.937,366,369,8115
1999,3345,4533,5184,498797,498294,348,6.685,391,7.511,52382,11528,40854,2.313,10.512,50336,12740,37596,2.557,10.102,2046,0.411,20.203,251,254,3971
1999,3346,743,812,46613,48260,80,9.780,92,11.247,6084,1554,4530,3.220,12.607,9532,4036,5496,8.363,19.752,-3448,-7.145,25.214,61,61,1412
1999,3351,1154,1265,73821,73912,94,7.416,99,7.811,7271,1959,5312,2.650,9.837,7373,3884,3489,5.255,9.975,-102,-0.138,19.675,67,70,1335
1999,3352,243,316,101550,102086,32,10.191,28,8.917,7385,2055,5330,2.013,7.234,8499,2370,6129,2.322,8.325,-1114,-1.091,14.468,16,16,191
1999,3353,2327,2757,196359,201869,127,4.554,190,6.814,13216,2049,11167,1.015,6.547,23975,4397,19578,2.178,11.877,-10759,-5.330,13.094,122,124,1609
1999,3359,1847,2230,196172,198737,157,7.048,152,6.824,15513,3229,12284,1.625,7.806,20568,6924,13644,3.484,10.349,-5055,-2.544,15.612,92,93,1610
1999,3361,284,348,226992,227257,36,10.375,34,9.798,11441,1169,10272,0.514,5.034,12691,846,11845,0.372,5.584,-1250,-0.550,10.069,22,22,426
1999,3362,1795,2006,142009,136009,145,7.205,158,7.851,20996,3302,17694,2.428,15.437,9090,2572,6518,1.891,6.683,11906,8.754,13.367,123,123,1958
1999,3363,4478,5633,802380,803380,345,6.084,420,7.407,70625,13828,56797,1.721,8.791,71834,17203,54631,2.141,8.941,-1209,-0.150,17.582,275,279,6246
1999,3364,1391,1699,460426,467310,108,6.342,116,6.812,19831,2320,17511,0.496,4.244,32972,7521,25451,1.609,7.056,-13141,-2.812,8.487,68,68,770
1999,3365,156,218,31241,30749,15,6.865,16,7.323,3919,750,3169,2.439,12.745,2903,1120,1783,3.642,9.441,1016,3.304,18.882,9,9,1017
1999,3366,1479,1589,143200,142355,187,11.783,183,11.531,14118,2686,11432,1.887,9.917,12372,3537,8835,2.485,8.691,1746,1.227,17.382,136,136,3157
1999,3369,675,706,38101,39138,82,11.631,80,11.348,3716,641,3075,1.638,9.495,5711,2655,3056,6.784,14.592,-1995,-5.097,18.989,61,61,677
1999,3371,13207,13703,393702,388894,1369,10.008,1322,9.664,46313,7973,38340,2.050,11.909,36371,12685,23686,3.262,9.352,9942,2.556,18.705,1014,1020,7054
1999,3372,4003,4217,186013,185877,257,6.063,300,7.078,19725,3726,15999,2.005,10.612,19288,5335,13953,2.870,10.377,437,0.235,20.754,226,227,2777
1999,3379,988,1108,46191,45162,79,7.127,80,7.217,6211,1618,4593,3.583,13.753,4073,1543,2530,3.417,9.019,2138,4.734,18.037,63,65,879
1999,3391,10783,11414,286372,285688,775,6.742,937,8.151,36831,9165,27666,3.208,12.892,35115,8906,26209,3.117,12.291,1716,0.601,24.583,700,702,4452
1999,3399,16958,17533,429174,433752,1866,10.672,1771,10.128,51646,14249,37397,3.285,11.907,60455,16621,43834,3.832,13.938,-8809,-2.031,23.814,1386,1392,9920
1999,4231,16809,20894,298544,296181,2019,9.551,2508,11.865,45148,14545,30603,4.911,15.243,40205,16841,23364,5.686,13.574,4943,1.669,27.149,1701,1864,10174
1999,4232,9732,10936,144728,142463,1202,11.031,1123,10.306,23899,6509,17390,4.569,16.776,19328,7033,12295,4.937,13.567,4571,3.209,27.134,839,856,4616
1999,4233,8725,11685,152756,147901,1351,11.740,997,8.664,28585,8512,20073,5.755,19.327,18690,6225,12465,4.209,12.637,9895,6.690,25.274,717,727,3779
1999,4234,28351,36289,693162,681098,4025,11.053,4276,11.743,131527,42700,88827,6.269,19.311,107677,42965,64712,6.308,15.809,23850,3.502,31.619,2784,2988,23377
1999,4235,7774,10403,163101,163409,701,6.732,721,6.924,19121,4871,14250,2.981,11.701,19587,5511,14076,3.373,11.986,-466,-0.285,23.403,468,487,3200
1999,4236,19589,29218,438957,435668,2736,9.343,2865,9.784,72913,25629,47284,5.883,16.736,67035,25291,41744,5.805,15.387,5878,1.349,30.773,1703,1792,11707
1999,4237,11069,16425,200906,197478,1201,7.324,1149,7.007,27808,8095,19713,4.099,14.082,20797,7667,13130,3.882,10.531,7011,3.550,21.063,775,825,5463
1999,4238,49045,64783,758751,756237,4531,6.980,4801,7.395,97779,27559,70220,3.644,12.930,92512,32370,60142,4.280,12.233,5267,0.696,24.466,3160,3317,18828
1999,4239,28134,30455,309203,314057,3623,11.887,3668,12.035,49551,15159,34392,4.827,15.778,58904,23566,35338,7.504,18.756,-9353,-2.978,31.555,2744,2783,14406
1999,4241,9694,12764,218699,219200,964,7.494,1164,9.049,34363,7386,26977,3.370,15.677,35452,15019,20433,6.852,16.173,-1089,-0.497,31.353,676,732,4271
1999,4242,4912,6172,175613,172911,739,11.746,978,15.545,27039,7334,19705,4.242,15.638,21646,8096,13550,4.682,12.519,5393,3.119,25.037,536,543,3182
1999,4243,13283,14255,171259,172024,1809,12.696,1796,12.605,30869,8551,22318,4.971,17.945,32668,10662,22006,6.198,18.990,-1799,-1.046,35.889,1380,1390,7028
1999,4244,27054,32709,774275,766406,2845,8.633,3334,10.117,96692,25602,71090,3.341,12.616,80557,29898,50659,3.901,10.511,16135,2.105,21.022,2505,2544,17642
1999,4245,4965,7762,69067,70595,340,4.295,648,8.186,7683,1984,5699,2.810,10.883,10735,4251,6484,6.022,15.207,-3052,-4.323,21.767,418,457,2648
1999,4246,9636,13507,151514,153160,875,6.446,1011,7.448,18253,4286,13967,2.798,11.918,21676,6709,14967,4.380,14.153,-3423,-2.235,23.835,603,632,3291
1999,4247,7062,10346,127246,127432,617,5.922,762,7.314,18289,5681,12608,4.458,14.352,18636,7094,11542,5.567,14.624,-347,-0.272,28.704,406,431,3126
1999,4248,3196,4069,147667,147110,251,6.120,315,7.681,16003,5245,10758,3.565,10.878,14964,5679,9285,3.860,10.172,1039,0.706,20.344,205,220,2711
1999,4249,22476,26948,354852,353541,3382,12.566,3312,12.306,57582,18481,39101,5.227,16.287,54785,21645,33140,6.122,15.496,2797,0.791,30.992,2477,2539,12331
1999,4251,33568,35878,286813,289431,2925,8.132,3108,8.641,39100,11838,27262,4.090,13.509,44162,16295,27867,5.630,15.258,-5062,-1.749,27.019,2145,2165,9748
1999,4411,42398,45786,1168422,1155629,4377,9.568,4294,9.387,136548,43256,93292,3.743,11.816,110879,44588,66291,3.858,9.595,25669,2.221,19.189,3330,3363,33985
1999,4412,11847,12797,114114,110572,1224,9.631,1047,8.239,20101,5665,14436,5.123,18.179,13091,5559,7532,5.028,11.839,7010,6.340,23.679,800,807,4185
1999,4413,36305,60070,541974,534484,4168,6.916,4565,7.574,86889,28686,58203,5.367,16.257,72540,25482,47058,4.768,13.572,14349,2.685,27.144,2522,2879,13176
1999,4421,19941,27847,274131,271570,2378,8.546,2339,8.405,43047,13451,29596,4.953,15.851,38264,14676,23588,5.404,14.090,4783,1.761,28.180,1513,1673,7680
1999,4422,24423,32203,255352,250371,3120,9.712,2965,9.229,47111,18750,28361,7.489,18.816,37346,13124,24222,5.242,14.916,9765,3.900,29.833,1867,1995,6791
1999,4431,32792,49856,459842,447430,5485,11.039,5147,10.359,91309,34152,57157,7.633,20.407,66509,30988,35521,6.926,14.865,24800,5.543,29.729,3410,3578,17313
1999,4441,48958,70621,1046300,1019128,4200,5.942,4326,6.120,149630,56469,93161,5.541,14.682,97060,32628,64432,3.202,9.524,52570,5.158,19.048,2974,3108,17695
1999,4442,16542,20578,180673,179436,1300,6.291,1473,7.128,26151,7254,18897,4.043,14.574,23675,7527,16148,4.195,13.194,2476,1.380,26.388,1014,1079,5318
1999,4451,59681,88941,2781482,2722922,9871,11.153,8993,10.161,411768,223285,188483,8.200,15.122,290085,101826,188259,3.740,10.653,121683,4.469,21.307,6028,6139,39738
1999,4452,16649,21215,141597,135440,3753,17.911,3231,15.419,36999,20958,16041,15.474,27.318,24874,11380,13494,8.402,18.365,12125,8.952,36.731,1736,1791,6913
1999,4453,22969,26156,131618,130984,2308,8.841,2206,8.450,20422,7545,12877,5.760,15.591,19316,6660,12656,5.085,14.747,1106,0.844,29.494,1692,1711,4959
1999,4461,40346,78334,943573,942491,6034,7.654,7033,8.921,155644,51172,104472,5.429,16.514,153889,57151,96738,6.064,16.328,1755,0.186,32.656,3560,3974,23562
1999,4471,63347,115334,927186,932011,8616,7.400,10799,9.275,159298,58487,100811,6.275,17.092,169663,61199,108464,6.566,18.204,-10365,-1.112,34.184,6109,6522,32981
1999,4481,37750,84480,934001,930281,7090,8.285,9275,10.839,162771,53335,109436,5.733,17.497,152128,52465,99663,5.640,16.353,10643,1.144,32.706,4578,4935,19553
1999,4482,6649,29136,193450,196367,2660,9.191,2270,7.844,34965,17634,17331,8.980,17.806,40757,11828,28929,6.023,20.756,-5792,-2.950,35.612,684,903,4652
1999,4483,18899,28823,163007,161476,2432,8.454,2318,8.058,25802,8839,16963,5.474,15.979,22719,7988,14731,4.947,14.070,3083,1.909,28.139,1391,1549,4637
1999,4511,30207,40964,386282,384353,3960,9.574,4753,11.492,60845,27274,33571,7.096,15.830,56781,23131,33650,6.018,14.773,4064,1.057,29.546,3084,3356,12500
1999,4512,7562,13387,140834,139238,1166,8.647,1361,10.093,21204,9029,12175,6.485,15.229,17907,7271,10636,5.222,12.861,3297,2.368,25.722,881,929,3619
1999,4522,59,6064,1020470,1036320,144,2.377,134,2.212,71995,16804,55191,1.622,6.947,103859,12502,91357,1.206,10.022,-31864,-3.075,13.894,3,3,142
1999,4523,9181,29595,1464151,1466194,3176,10.964,1919,6.625,153203,47592,105611,3.246,10.449,158330,21634,136696,1.476,10.799,-5127,-0.350,20.898,1040,1124,4861
1999,4531,21709,22794,121238,122228,1799,7.781,2451,10.601,18719,5636,13083,4.611,15.315,20822,7669,13153,6.274,17.035,-2103,-1.721,30.630,1899,1938,5700
1999,4532,29720,40871,350420,343619,4782,11.665,5027,12.263,67366,30278,37088,8.812,19.605,53882,22218,31664,6.466,15.681,13484,3.924,31.362,3180,3262,11704
1999,4533,13057,16607,110059,107924,1949,11.826,1697,10.297,18670,7525,11145,6.973,17.299,14495,4739,9756,4.391,13.431,4175,3.868,26.862,1360,1381,3399
1999,4539,31198,38525,247177,243178,5543,14.579,4532,11.920,55796,24907,30889,10.242,22.945,47427,19173,28254,7.884,19.503,8369,3.442,39.006,3225,3458,14614
1999,4541,8536,9469,235167,226291,1569,16.912,1186,12.784,51255,19230,32025,8.498,22.650,33330,11011,22319,4.866,14.729,17925,7.921,29.458,832,835,6463
1999,4542,5046,5626,66666,66580,592,10.422,701,12.340,8867,3169,5698,4.760,13.318,8627,4080,4547,6.128,12.957,240,0.360,25.915,535,540,2989
1999,4543,19148,25306,224524,222821,2493,9.859,2454,9.705,36244,10644,25600,4.777,16.266,32827,11898,20929,5.340,14.732,3417,1.534,29.465,1801,1855,8643
1999,4811,634,3043,519916,511055,342,11.147,392,12.777,44216,6894,37322,1.349,8.652,26664,9675,16989,1.893,5.217,17552,3.434,10.435,80,82,1405
1999,4812,1615,1782,32751,31604,230,13.027,197,11.158,5649,1870,3779,5.917,17.874,3374,982,2392,3.107,10.676,2275,7.198,21.352,128,130,438
1999,4831,786,1186,50048,52307,147,12.452,136,11.521,8496,2676,5820,5.116,16.243,12402,7744,4658,14.805,23.710,-3906,-7.468,32.485,59,61,1372
1999,4832,479,516,18784,18551,44,8.341,67,12.701,2298,234,2064,1.261,12.388,1824,804,1020,4.334,9.833,474,2.555,19.665,47,49,328
1999,4841,36886,45442,953937,924245,9247,21.104,5997,13.686,193938,84571,109367,9.150,20.983,132131,48444,83687,5.241,14.296,61807,6.687,28.592,4375,4514,25828
1999,4842,47163,50642,496221,496037,6481,12.747,6880,13.532,93880,32470,61410,6.546,18.926,93127,34423,58704,6.940,18.774,753,0.152,37.548,5328,5367,23832
1999,4851,439,662,35301,32473,174,28.478,72,11.784,8065,5600,2465,17.245,24.836,2263,880,1383,2.710,6.969,5802,17.867,13.938,57,57,594
1999,4852,200,376,17978,18199,44,11.957,28,7.609,1307,542,765,2.978,7.182,1697,712,985,3.912,9.325,-390,-2.143,14.363,16,16,508
1999,4853,5686,5776,63718,62373,843,14.624,820,14.225,12227,4049,8178,6.492,19.603,9557,4086,5471,6.551,15.322,2670,4.281,30.645,666,668,3194
1999,4854,3154,4225,161021,157134,270,6.366,302,7.121,25686,6551,19135,4.169,16.347,17603,7424,10179,4.725,11.203,8083,5.144,22.405,209,212,3308
1999,4855,1218,1359,32934,32520,110,7.983,148,10.740,5154,1089,4065,3.349,15.849,4368,1587,2781,4.880,13.432,786,2.417,26.864,114,120,1248
1999,4859,2198,2385,49467,48435,400,16.931,355,15.026,9882,3415,6467,7.051,20.403,7862,4013,3849,8.285,16.232,2020,4.171,32.464,281,282,2614
1999,4861,44,326,6491,6768,17,4.993,46,13.510,918,241,677,3.561,13.564,1428,616,812,9.102,21.099,-510,-7.535,27.128,D,D,D
1999,4862,125,1592,30764,31796,169,10.706,142,8.996,3493,1416,2077,4.453,10.986,5587,1175,4412,3.695,17.571,-2094,-6.586,21.971,11,11,36
1999,4869,60,503,6111,6088,51,9.808,85,16.346,1285,646,639,10.612,21.109,1234,604,630,9.922,20.271,51,0.838,40.542,D,D,D
1999,4871,361,399,8738,8783,68,17.778,35,9.150,1076,321,755,3.655,12.252,1189,242,947,2.755,13.538,-113,-1.287,24.503,26,26,211
1999,4872,1176,1206,12534,12550,158,13.096,159,13.179,2445,793,1652,6.319,19.483,2467,1066,1401,8.494,19.658,-22,-0.175,38.966,116,116,955
1999,4879,139,143,1965,1874,17,11.684,22,15.120,492,46,446,2.455,26.261,329,111,218,5.925,17.561,163,8.700,35.121,19,19,104
1999,4881,3111,4064,119880,117418,495,12.301,415,10.313,20310,7512,12798,6.398,17.297,15251,5925,9326,5.046,12.989,5059,4.309,25.977,281,301,3633
1999,4882,445,795,20729,20173,84,10.728,60,7.663,4224,1647,2577,8.165,20.939,3048,1086,1962,5.384,15.110,1176,5.830,30.219,25,26,180
1999,4883,1750,2266,69396,70583,206,9.085,209,9.217,11755,4446,7309,6.299,16.654,13895,3773,10122,5.346,19.686,-2140,-3.032,33.309,139,141,2083
1999,4884,5933,6216,50084,49045,975,16.010,723,11.872,11073,4736,6337,9.656,22.577,8876,4307,4569,8.782,18.098,2197,4.480,36.195,554,562,3335
1999,4885,10979,14654,156423,152220,1578,10.803,1483,10.153,30752,11858,18894,7.790,20.202,22311,8890,13421,5.840,14.657,8441,5.545,29.314,1001,1068,5696
1999,4889,879,943,22596,23286,195,20.624,200,21.153,3230,960,2270,4.123,13.871,4516,2158,2358,9.268,19.394,-1286,-5.523,27.743,89,89,317
1999,4921,2268,5900,506854,486872,656,11.378,387,6.712,56430,7776,48654,1.597,11.590,18582,4366,14216,0.897,3.817,37848,7.774,7.633,241,243,1771
1999,4922,4384,4834,67654,68449,783,16.270,740,15.377,15455,8246,7209,12.047,22.579,16608,9595,7013,14.018,24.263,-1153,-1.684,45.158,603,618,4877
1999,4931,6612,12234,535462,524086,1253,10.352,992,8.196,102900,42800,60100,8.167,19.634,80712,28885,51827,5.512,15.401,22188,4.234,30.801,315,342,4849
1999,5111,15555,19035,680832,689882,1954,10.271,1932,10.156,67396,18854,48542,2.733,9.769,86091,29128,56963,4.222,12.479,-18695,-2.710,19.538,1442,1465,13439
1999,5112,8057,10208,297349,286049,1038,9.964,1457,13.986,64626,16875,47751,5.899,22.593,41734,18288,23446,6.393,14.590,22892,8.003,29.180,916,947,9409
1999,5121,11889,16161,252445,255351,2348,14.587,2219,13.786,60258,27356,32902,10.713,23.598,64640,17052,47588,6.678,25.314,-4382,-1.716,47.196,1249,1320,7347
1999,5122,2523,2668,21244,20782,454,17.338,355,13.557,4860,2380,2480,11.452,23.386,3956,1837,2119,8.839,19.036,904,4.350,38.071,249,254,903
1999,5151,5402,7744,247089,243670,938,12.081,978,12.597,43416,25443,17973,10.442,17.818,37579,19206,18373,7.882,15.422,5837,2.395,30.844,701,759,10773
1999,5152,305,581,31880,31346,102,16.846,151,24.938,8170,2028,6142,6.470,26.064,7099,5072,2027,16.181,22.647,1071,3.417,45.294,27,30,928
1999,5173,7470,35170,1217744,1203890,7043,20.410,5717,16.568,299041,137705,161336,11.438,24.840,276234,130537,145697,10.843,22.945,22807,1.894,45.890,933,1028,14133
1999,5174,377,857,19822,16882,364,51.195,72,10.127,8360,4501,3859,26.662,49.522,2690,1228,1462,7.274,15.935,5670,33.587,31.869,34,35,375
1999,5179,5282,6309,91745,84828,2108,36.229,1127,19.369,36905,15195,21710,17.913,43.506,23045,12661,10384,14.925,27.167,13860,16.339,54.333,780,794,6433
1999,5182,4956,8987,343242,335509,1577,18.468,681,7.975,68643,26722,41921,7.965,20.459,54035,19937,34098,5.942,16.105,14608,4.354,32.211,419,425,3263
1999,5191,3007,3671,57765,54583,429,12.051,207,5.815,11982,5027,6955,9.210,21.952,5619,1800,3819,3.298,10.295,6363,11.658,20.589,125,125,730
1999,5211,14,43,22876,22385,D,D,0,0.000,1109,D,1007,D,4.954,113,0,113,0.000,0.505,996,4.449,1.010,0,0,0
1999,5221,18666,102615,1916139,1937198,9285,8.934,11916,11.465,300324,105259,195065,5.434,15.503,348564,194395,154169,10.035,17.993,-48240,-2.490,31.006,628,1143,19809
1999,5222,18205,44890,634841,611914,7520,16.800,7262,16.224,178199,81591,96608,13.334,29.122,134747,64655,70092,10.566,22.021,43452,7.101,44.041,1838,2354,20256
1999,5223,13412,18587,207894,198871,4300,24.595,2093,11.971,59711,26182,33529,13.165,30.025,41483,19297,22186,9.703,20.859,18228,9.166,41.719,1278,1369,9816
1999,5231,11311,31854,484012,470763,5418,17.579,3353,10.879,103367,29501,73866,6.267,21.957,78782,37021,41761,7.864,16.735,24585,5.222,33.470,1000,1092,9880
1999,5232,51,62,6538,6364,22,40.000,8,14.545,1006,433,573,6.804,15.809,628,445,183,6.993,9.869,378,5.940,19.738,4,4,102
1999,5239,23460,26150,273308,265585,4245,16.539,3279,12.775,55208,19127,36081,7.202,20.787,39529,17344,22185,6.530,14.884,15679,5.904,29.767,2139,2169,7780
1999,5241,4820,41007,1543372,1555945,7738,19.507,5058,12.751,259877,110800,149077,7.121,16.702,285980,98795,187185,6.350,18.380,-26103,-1.678,33.404,267,312,6855
1999,5242,112997,124253,830527,824059,11662,9.401,11255,9.073,149629,57111,92518,6.930,18.158,138860,65833,73027,7.989,16.851,10769,1.307,33.701,7678,7905,28533
1999,5259,395,420,4458,3685,180,50.633,51,14.346,2016,908,1108,24.640,54.708,499,204,295,5.536,13.541,1517,41.167,27.083,26,26,79
1999,5311,87933,99274,517759,514580,10781,10.856,10858,10.933,105908,47816,58092,9.292,20.581,99428,47672,51756,9.264,19.322,6480,1.259,38.644,8352,8631,35820
1999,5312,48832,54992,257060,246830,8652,16.060,6413,11.904,66995,30995,36000,12.557,27.142,46923,19832,27091,8.035,19.010,20072,8.132,38.020,4338,4497,12358
1999,5313,43260,50453,469981,466303,7812,15.962,4791,9.789,92263,40474,51789,8.680,19.786,85866,33799,52067,7.248,18.414,6397,1.372,36.828,3074,3187,16795
1999,5321,4418,10261,174999,173908,1187,11.636,1067,10.460,26263,12429,13834,7.147,15.102,23432,10431,13001,5.998,13.474,2831,1.628,26.948,487,536,2827
1999,5322,16166,31539,253894,251412,4179,13.370,3614,11.562,53380,24040,29340,9.562,21.232,48246,17144,31102,6.819,19.190,5134,2.042,38.380,2360,2602,11545
1999,5323,3497,5822,40144,40014,533,9.128,567,9.711,7596,3180,4416,7.947,18.983,7196,3159,4037,7.895,17.984,400,1.000,35.967,269,331,2038
1999,5324,7218,11333,146992,142822,1933,17.534,1316,11.937,34904,16753,18151,11.730,24.439,26242,11256,14986,7.881,18.374,8662,6.065,36.748,771,878,7563
1999,5331,1684,1800,21617,20491,227,12.639,219,12.194,5104,2598,2506,12.679,24.908,2888,1100,1788,5.368,14.094,2216,10.815,28.188,148,148,697
1999,5411,155278,162592,1086647,1071338,13877,8.533,13936,8.570,146524,41409,105115,3.865,13.677,115932,40959,74973,3.823,10.821,30592,2.855,21.642,10176,10272,29372
1999,5412,85051,91264,1122995,1104217,9791,10.795,8660,9.548,227110,64644,162466,5.854,20.568,188064,63246,124818,5.728,17.031,39046,3.536,34.063,5765,5825,25436
1999,5413,81858,92331,1210017,1194782,10601,11.620,8404,9.212,207334,60858,146476,5.094,17.353,177562,48009,129553,4.018,14.861,29772,2.492,29.723,5815,5897,27044
1999,5414,23685,23908,129982,127560,3692,15.721,2846,12.118,27965,10019,17946,7.854,21.923,23116,9426,13690,7.389,18.122,4849,3.801,36.243,2169,2174,7343
1999,5415,68568,76928,1014022,948816,20379,28.307,10507,14.595,313672,129066,184606,13.603,33.059,182770,74572,108198,7.859,19.263,130902,13.796,38.526,7063,7232,40412
1999,5416,61128,65066,573267,548892,13363,21.054,10170,16.023,158533,66695,91838,12.151,28.882,109766,53093,56673,9.673,19.998,48767,8.885,39.996,7311,7375,29563
1999,5417,9382,12038,547451,529830,1823,15.588,1137,9.722,91036,33785,57251,6.377,17.182,55683,15454,40229,2.917,10.510,35353,6.673,21.019,700,705,3965
1999,5418,32298,35594,450873,449636,4257,11.979,4141,11.653,78731,23421,55310,5.209,17.510,75625,31045,44580,6.904,16.819,3106,0.691,33.638,3030,3086,18071
1999,5419,44342,51124,444667,435477,6602,13.277,3803,7.648,89824,32625,57199,7.492,20.627,71904,23390,48514,5.371,16.512,17920,4.115,33.023,2409,2425,13955
1999,5511,28058,51653,3261450,3285743,6645,12.943,6017,11.720,564429,202058,362371,6.150,17.178,610265,214781,395484,6.537,18.573,-45836,-1.395,34.356,1264,1335,25114
1999,5611,19145,21333,391496,375896,3312,15.522,3321,15.564,113592,39329,74263,10.463,30.219,80843,37694,43149,10.028,21.507,32749,8.712,43.014,2054,2083,20176
1999,5612,1330,2617,120774,115206,657,26.407,399,16.037,30338,14758,15580,12.810,26.334,19285,8663,10622,7.520,16.740,11053,9.594,33.479,99,111,3667
1999,5613,25630,43005,3910009,3749411,7397,17.747,4747,11.389,1179171,349698,829473,9.327,31.450,849948,238892,611056,6.371,22.669,329223,8.781,45.338,2651,2774,120654
1999,5614,25720,30758,680649,664964,4369,14.281,4038,13.199,160759,64703,96056,9.730,24.176,129327,45744,83583,6.879,19.449,31432,4.727,38.897,2976,3041,24026
1999,5615,23954,31886,296191,296663,2417,7.425,3745,11.505,47485,15839,31646,5.339,16.006,48502,18577,29925,6.262,16.349,-1017,-0.343,32.013,2639,2743,11899
1999,5616,15489,19531,697579,690939,2498,12.812,2430,12.463,143281,51995,91286,7.525,20.737,129202,44765,84437,6.479,18.699,14079,2.038,37.399,1653,1663,16023
1999,5617,114503,120590,1443929,1419408,18133,15.144,16421,13.715,293941,86122,207819,6.067,20.709,244673,92077,152596,6.487,17.238,49268,3.471,34.475,12718,12757,66057
1999,5619,20747,22684,378971,365576,2879,12.669,2961,13.030,92109,22889,69220,6.261,25.196,67692,27073,40619,7.406,18.517,24417,6.679,37.033,2248,2296,19650
1999,5621,6091,7404,150714,151169,887,11.745,1183,15.665,27092,9746,17346,6.447,17.922,27473,17968,9505,11.886,18.174,-381,-0.252,35.843,851,874,7752
1999,5622,1421,2147,50627,51870,258,11.816,331,15.159,8826,2792,6034,5.383,17.016,11183,6630,4553,12.782,21.560,-2357,-4.544,34.031,173,181,1959
1999,5629,5301,5871,89286,88904,762,13.130,627,10.804,19765,6684,13081,7.518,22.232,18752,6193,12559,6.966,21.092,1013,1.139,42.185,433,437,3448
1999,6111,16103,18240,692853,675810,1017,5.645,566,3.142,70282,17623,52659,2.608,10.400,36576,6979,29597,1.033,5.412,33706,4.988,10.824,359,372,3998
1999,6112,529,794,74758,74692,34,4.285,33,4.159,6080,942,5138,1.261,8.140,5884,1869,4015,2.502,7.878,196,0.262,15.755,19,20,1270
1999,6113,2312,2907,1304559,1287224,141,4.894,89,3.089,82955,6924,76031,0.538,6.444,48195,2095,46100,0.163,3.744,34760,2.700,7.488,53,53,859
1999,6114,5350,5870,59860,59377,951,16.415,798,13.774,14374,4812,9562,8.104,24.208,13538,6314,7224,10.634,22.800,836,1.408,45.600,574,590,3881
1999,6115,5274,6165,73101,70567,688,11.163,684,11.098,15054,4260,10794,6.037,21.333,10125,3713,6412,5.262,14.348,4929,6.985,28.696,494,507,2571
1999,6116,20399,22076,188147,178436,3240,14.991,2315,10.711,45774,17872,27902,10.016,25.653,26760,10282,16478,5.762,14.997,19014,10.656,29.994,1722,1747,6870
1999,6117,3192,3421,33266,36390,576,17.089,475,14.093,7023,2416,4607,6.639,19.299,13684,1904,11780,5.232,37.604,-6661,-18.304,38.599,349,352,1331
1999,6211,157245,178565,1673203,1646085,14777,8.252,15806,8.826,297217,103400,193817,6.282,18.056,243367,102345,141022,6.217,14.785,53850,3.271,29.569,11064,11538,60076
1999,6212,106022,109657,678882,671259,5017,4.575,5020,4.578,89108,22142,66966,3.299,13.275,74000,21953,52047,3.270,11.024,15108,2.251,22.048,3812,3877,16436
1999,6213,77099,82766,419326,420747,8758,10.641,7838,9.523,76449,28735,47714,6.830,18.170,78863,36513,42350,8.678,18.744,-2414,-0.574,36.340,5596,5745,22851
1999,6214,10234,21830,545679,537522,2418,11.230,1823,8.466,96144,38613,57531,7.184,17.887,78994,31925,47069,5.939,14.696,17150,3.191,29.392,827,925,12257
1999,6215,5357,8393,149236,151009,1133,13.108,1634,18.904,28304,13102,15202,8.676,18.743,32286,17769,14517,11.767,21.380,-3982,-2.637,37.487,592,644,5991
1999,6216,10279,16215,793343,842424,2024,11.946,3481,20.545,141552,40644,100908,4.825,16.803,238116,99827,138289,11.850,28.266,-96564,-11.463,33.606,1951,2124,49737
1999,6219,4334,6472,176418,175194,856,13.451,640,10.057,35455,11785,23670,6.727,20.238,33761,13795,19966,7.874,19.271,1694,0.967,38.541,353,365,4064
1999,6221,3451,5402,4534438,4535801,116,2.139,159,2.932,256077,58433,197644,1.288,5.646,260309,87716,172593,1.934,5.739,-4232,-0.093,11.291,49,49,13046
1999,6222,497,783,244388,245126,39,4.949,49,6.218,12421,1674,10747,0.683,5.067,14003,5777,8226,2.357,5.713,-1582,-0.645,10.134,16,18,2592
1999,6223,271,442,150187,151485,45,10.262,38,8.666,8946,3262,5684,2.153,5.906,11593,5605,5988,3.700,7.653,-2647,-1.747,11.811,16,16,3336
1999,6231,7829,15517,1532924,1545228,1045,6.744,1000,6.454,151244,52457,98787,3.395,9.788,177642,65825,111817,4.260,11.496,-26398,-1.708,19.576,542,598,37215
1999,6232,7459,21063,385235,379520,1921,9.314,1043,5.057,60614,20975,39639,5.527,15.971,49176,15422,33754,4.064,12.957,11438,3.014,25.915,472,579,8893
1999,6233,12465,16100,473915,453425,2679,17.237,1564,10.063,88090,44330,43760,9.777,19.428,46670,18490,28180,4.078,10.293,41420,9.135,20.586,1135,1169,13073
1999,6239,3392,5848,144825,141706,474,8.153,405,6.967,22086,5202,16884,3.671,15.586,16044,4748,11296,3.351,11.322,6042,4.264,22.644,223,235,2874
1999,6241,29861,42286,732879,716390,3586,8.563,2766,6.605,111132,27606,83526,3.853,15.513,77931,19270,58661,2.690,10.878,33201,4.634,21.757,1663,1714,10289
1999,6242,8133,10101,114485,111569,691,6.928,436,4.372,16485,3821,12664,3.425,14.776,10650,2235,8415,2.003,9.546,5835,5.230,19.091,241,250,1071
1999,6243,5208,7864,302522,301349,561,7.153,518,6.605,41353,10285,31068,3.413,13.723,39299,4527,34772,1.502,13.041,2054,0.682,26.082,265,270,1916
1999,6244,47245,58925,663612,653033,6784,11.614,5759,9.859,110512,43181,67331,6.612,16.923,89366,33703,55663,5.161,13.685,21146,3.238,27.370,4265,4375,24388
1999,7111,7625,7708,116644,114405,1055,13.767,966,12.605,25015,7584,17431,6.629,21.865,20644,6800,13844,5.944,18.045,4371,3.821,36.089,679,681,4939
1999,7112,3220,3365,91675,90265,564,16.917,502,15.057,15526,5936,9590,6.576,17.201,12542,3746,8796,4.150,13.895,2984,3.306,27.789,390,390,2866
1999,7113,3268,3411,66482,64949,499,14.974,342,10.263,12760,3994,8766,6.149,19.646,9495,2353,7142,3.623,14.619,3265,5.027,29.239,222,228,1213
1999,7114,2286,2339,14841,14387,366,15.875,299,12.969,3775,1400,2375,9.731,26.240,2917,1247,1670,8.668,20.276,858,5.964,40.552,221,222,816
1999,7115,8651,8669,37300,34732,1695,19.933,1364,16.040,15321,5495,9826,15.821,44.112,10090,4063,6027,11.698,29.051,5231,15.061,58.102,823,825,2363
1999,7121,4984,5372,100299,97672,358,6.762,202,3.816,11075,1263,9812,1.293,11.339,5730,824,4906,0.844,5.867,5345,5.472,11.733,123,123,676
1999,7131,1649,2640,123747,131414,264,9.713,420,15.453,13564,2693,10871,2.049,10.322,28519,5821,22698,4.430,21.702,-14955,-11.380,20.643,245,248,2552
1999,7132,1662,2008,162142,161464,236,11.797,221,11.047,15294,5579,9715,3.455,9.472,13840,3547,10293,2.197,8.572,1454,0.901,17.143,169,172,2211
1999,7139,44546,48781,904001,880824,5075,10.472,4440,9.162,163378,48746,114632,5.534,18.548,115595,40480,75115,4.596,13.124,47783,5.425,26.247,3365,3418,29982
1999,7211,34153,43555,1665723,1651354,4867,11.301,3889,9.030,234442,109768,124674,6.647,14.197,206357,84610,121747,5.124,12.496,28085,1.701,24.992,2678,2743,45698
1999,7212,5041,5432,37400,36629,462,8.482,492,9.032,6959,1881,5078,5.135,18.999,5456,1701,3755,4.644,14.895,1503,4.103,29.791,338,347,1248
1999,7213,2898,2962,14669,15055,158,5.194,318,10.454,1990,491,1499,3.261,13.219,2794,1068,1726,7.094,18.559,-804,-5.341,26.437,214,218,704
1999,7223,10110,23587,473492,474840,3407,14.579,2973,12.721,85690,42682,43008,8.989,18.046,88101,38958,49143,8.204,18.554,-2411,-0.508,36.092,1117,1233,8988
1999,7224,45754,46208,324917,323334,5174,11.082,6133,13.136,72648,35404,37244,10.950,22.468,69550,30220,39330,9.346,21.510,3098,0.958,43.021,4758,4774,23229
1999,7225,263583,362676,7095576,7036994,42383,11.686,42364,11.681,1312719,657642,655077,9.345,18.655,1199880,490619,709261,6.972,17.051,112839,1.604,34.102,27848,29564,289426
1999,8111,138978,151897,854729,846780,15814,10.434,15134,9.986,154624,61122,93502,7.218,18.260,138689,57192,81497,6.754,16.378,15935,1.882,32.757,11104,11337,40999
1999,8112,13069,15061,142202,142449,1477,9.561,2250,14.565,28161,10007,18154,7.025,19.769,28959,11874,17085,8.336,20.329,-798,-0.560,39.538,1453,1522,6751
1999,8113,21211,22726,197270,194799,2183,9.629,2073,9.144,33200,8634,24566,4.432,17.043,28194,9274,18920,4.761,14.473,5006,2.570,28.947,1483,1514,6278
1999,8114,24197,25490,140720,143480,2917,11.337,3399,13.210,21776,7869,13907,5.484,15.177,27776,12834,14942,8.945,19.359,-6000,-4.182,30.354,2526,2551,6673
1999,8121,74484,85655,484652,481985,10067,11.716,10612,12.350,94527,40763,53764,8.457,19.612,88969,39902,49067,8.279,18.459,5558,1.153,36.918,7972,8213,26705
1999,8122,15068,21186,155997,162195,964,4.489,1537,7.158,13750,4062,9688,2.504,8.477,25751,8764,16987,5.403,15.877,-12001,-7.399,16.955,852,916,4032
1999,8123,33795,40305,391140,391643,3810,9.415,4135,10.218,54733,21312,33421,5.442,13.975,55891,21308,34583,5.441,14.271,-1158,-0.296,27.950,3057,3161,15027
1999,8129,18534,28242,227473,220775,4994,18.145,3555,12.917,55938,26148,29790,11.844,25.337,43193,17982,25211,8.145,19.564,12745,5.773,39.129,1845,1901,9663
1999,8131,158700,158828,1511230,1487722,7858,4.981,5706,3.617,167539,24198,143341,1.627,11.261,120475,17894,102581,1.203,8.098,47064,3.163,16.196,3321,3321,8669
1999,8132,10305,12099,124029,122274,1164,9.788,750,6.307,17963,4903,13060,4.010,14.691,14413,5937,8476,4.855,11.787,3550,2.903,23.575,445,459,2557
1999,8133,8505,10203,95226,92416,1145,11.461,720,7.207,15765,3992,11773,4.320,17.059,10171,3417,6754,3.697,11.006,5594,6.053,22.011,391,397,1365
1999,8134,27807,29578,308456,306492,1362,4.597,1463,4.938,35825,5764,30061,1.881,11.689,31786,5806,25980,1.894,10.371,4039,1.318,20.742,1019,1019,3839
1999,8139,62237,64237,501192,499176,3239,5.013,3981,6.162,65545,13401,52144,2.685,13.131,61581,16072,45509,3.220,12.337,3964,0.794,24.673,2840,2850,11467
2000,1131,346,390,3184,3299,69,18.134,50,13.141,525,243,282,7.367,15.916,761,143,618,4.335,23.071,-236,-7.155,31.833,29,29,79
2000,1132,160,223,1748,1610,32,14.815,18,8.333,544,93,451,5.778,33.799,280,96,184,5.965,17.397,264,16.403,34.793,14,14,49
2000,1133,10963,11034,77682,78201,1097,9.745,1544,13.715,14380,3803,10577,4.863,18.389,15494,6185,9309,7.909,19.813,-1114,-1.425,36.777,1177,1177,4278
2000,1141,1381,1392,7955,7751,227,16.509,193,14.036,2154,1284,870,16.566,27.790,1822,705,1117,9.096,23.507,332,4.283,47.013,126,126,473
2000,1142,294,294,2502,2396,42,14.711,25,8.757,458,160,298,6.679,19.119,232,63,169,2.630,9.685,226,9.434,19.370,19,19,37
2000,1151,4064,4361,63557,62367,531,12.136,560,12.799,13839,4644,9195,7.446,22.190,11507,3412,8095,5.471,18.450,2332,3.739,36.901,385,386,2354
2000,1152,2987,3035,18443,17985,455,15.210,368,12.302,3869,1709,2160,9.502,21.512,2912,1259,1653,7.000,16.191,957,5.321,32.383,272,272,854
2000,1153,1239,1273,14918,14599,171,13.620,136,10.832,3144,728,2416,4.987,21.536,2563,853,1710,5.843,17.557,581,3.980,35.113,81,81,680
2000,2111,5623,6855,79406,82060,677,9.878,674,9.834,13809,5390,8419,6.568,16.828,19532,6284,13248,7.658,23.802,-5723,-6.974,33.656,408,410,1471
2000,2121,800,1163,70764,73847,121,10.113,188,15.712,8539,3779,4760,5.117,11.563,14503,5984,8519,8.103,19.639,-5964,-8.076,23.126,109,115,2456
2000,2122,307,408,33941,36407,61,14.681,76,18.291,2139,577,1562,1.585,5.875,7148,1843,5305,5.062,19.634,-5009,-13.758,11.750,44,51,617
2000,2123,3225,5164,100562,100615,400,7.803,325,6.340,13644,4491,9153,4.464,13.561,14007,3040,10967,3.021,13.921,-363,-0.361,27.121,213,214,1547
2000,2131,6485,7685,165363,157845,865,11.227,904,11.733,42690,10893,31797,6.901,27.046,27912,7417,20495,4.699,17.683,14778,9.362,35.366,591,606,3256
2000,2211,1574,9115,525960,528824,829,9.306,416,4.670,53186,23628,29558,4.468,10.057,59633,9044,50589,1.710,11.277,-6447,-1.219,20.115,70,74,926
2000,2212,545,2549,89398,90345,199,7.721,256,9.932,11625,5229,6396,5.788,12.867,13631,3493,10138,3.866,15.088,-2006,-2.220,25.735,47,58,463
2000,2213,4363,4884,38357,37627,547,11.524,272,5.731,5739,2676,3063,7.112,15.252,4221,1276,2945,3.391,11.218,1518,4.034,22.436,195,196,755
2000,2361,133478,134143,760292,741911,19954,14.947,18668,13.984,195045,64141,130904,8.645,26.290,157909,64095,93814,8.639,21.284,37136,5.005,42.568,13380,13409,48430
2000,2362,40719,41583,806916,788880,4137,9.946,4160,10.001,167073,26701,140372,3.385,21.179,130465,29851,100614,3.784,16.538,36608,4.641,33.076,2957,2959,17977
2000,2371,16562,17082,449988,423656,1805,10.734,1272,7.564,110471,30506,79965,7.201,26.076,57461,11892,45569,2.807,13.563,53010,12.513,27.126,921,921,8039
2000,2372,9801,9979,73080,70190,2101,21.815,1405,14.588,20414,8777,11637,12.505,29.084,14730,5857,8873,8.345,20.986,5684,8.098,41.972,1023,1025,4117
2000,2373,10563,11012,297405,286996,786,7.118,847,7.670,59405,7567,51838,2.637,20.699,38544,7023,31521,2.447,13.430,20861,7.269,26.860,624,624,5343
2000,2379,4561,4662,75309,72245,566,12.031,651,13.838,18064,4428,13636,6.129,25.004,12016,3847,8169,5.325,16.632,6048,8.372,33.265,515,518,3179
2000,2381,93839,94266,1006833,974016,12188,13.064,10247,10.983,244477,58556,185921,6.012,25.100,178710,51983,126727,5.337,18.348,65767,6.752,36.695,7472,7472,37960
2000,2382,143208,146032,1818061,1756735,15222,10.497,13175,9.086,368365,84962,283403,4.836,20.969,246171,78573,167598,4.473,14.013,122194,6.956,28.026,9812,9834,58620
2000,2383,96802,97521,837191,818334,14371,14.857,12781,13.214,200171,56018,144153,6.845,24.461,162617,52788,109829,6.451,19.872,37554,4.589,39.743,9434,9437,40697
2000,2389,51421,51739,457208,441347,7179,14.049,5901,11.548,111876,31501,80375,7.137,25.349,80094,26384,53710,5.978,18.148,31782,7.201,36.295,4313,4314,19032
2000,3111,1071,1639,49415,48898,105,6.434,91,5.576,5582,1530,4052,3.129,11.416,4551,1335,3216,2.730,9.307,1031,2.108,18.614,50,51,620
2000,3112,493,858,61009,61938,43,5.003,46,5.352,4066,735,3331,1.187,6.565,5915,1396,4519,2.254,9.550,-1849,-2.985,13.129,25,25,418
2000,3113,1397,1578,83436,83256,110,6.892,146,9.148,9454,1278,8176,1.535,11.355,8883,2946,5937,3.538,10.670,571,0.686,21.339,95,96,1222
2000,3114,1285,1682,168176,170065,120,7.103,135,7.991,16799,3848,12951,2.263,9.878,20410,5783,14627,3.400,12.001,-3611,-2.123,19.756,90,94,2068
2000,3115,1128,1641,132122,131308,75,4.519,112,6.749,11255,2048,9207,1.560,8.571,9708,3284,6424,2.501,7.393,1547,1.178,14.787,74,76,1568
2000,3116,3203,3834,489871,485650,234,6.092,248,6.457,38581,5303,33278,1.092,7.944,30010,7763,22247,1.598,6.179,8571,1.765,12.359,183,184,2393
2000,3117,639,753,40316,41013,61,8.053,70,9.241,5212,1430,3782,3.487,12.708,6584,1519,5065,3.704,16.053,-1372,-3.345,25.416,47,47,671
2000,3118,9057,9856,298340,294869,938,9.449,1081,10.889,40921,9834,31087,3.335,13.878,34348,12962,21386,4.396,11.649,6573,2.229,23.297,826,832,5433
2000,3119,2267,2633,143741,144252,207,7.844,219,8.299,14726,4168,10558,2.889,10.209,15626,3997,11629,2.771,10.832,-900,-0.624,20.417,154,154,1900
2000,3121,1995,2466,138522,139557,242,9.904,197,8.062,14477,4429,10048,3.174,10.374,16471,3831,12640,2.745,11.802,-1994,-1.429,20.747,147,147,1579
2000,3122,74,104,27173,27592,11,10.377,15,14.151,1912,210,1702,0.761,6.930,2760,927,1833,3.360,10.003,-848,-3.073,13.859,10,10,305
2000,3131,357,589,80300,81650,49,8.348,45,7.666,6931,2481,4450,3.039,8.489,9669,2844,6825,3.483,11.842,-2738,-3.353,16.977,26,26,631
2000,3132,1575,1887,181951,189367,113,5.882,181,9.422,11462,2043,9419,1.079,6.053,26203,8940,17263,4.721,13.837,-14741,-7.784,12.106,128,128,2310
2000,3133,2433,2660,90854,93753,130,4.680,365,13.141,9139,2298,6841,2.451,9.748,15044,5466,9578,5.830,16.047,-5905,-6.298,19.496,276,288,3550
2000,3141,2600,2848,119674,121054,229,7.949,295,10.240,14409,4854,9555,4.010,11.903,17146,3384,13762,2.795,14.164,-2737,-2.261,23.806,243,245,2038
2000,3149,4305,4442,102913,103831,442,9.923,467,10.484,14479,3802,10677,3.662,13.945,16007,5359,10648,5.161,15.416,-1528,-1.472,27.890,365,365,3774
2000,3151,921,1007,77222,81516,75,7.239,133,12.838,6705,1866,4839,2.289,8.225,15255,5480,9775,6.723,18.714,-8550,-10.489,16.451,100,101,1459
2000,3152,9452,9960,361362,385524,1580,15.611,1902,18.793,54528,21603,32925,5.604,14.144,102082,46857,55225,12.154,26.479,-47554,-12.335,28.288,1477,1502,26018
2000,3159,1770,1842,46450,47868,169,8.885,289,15.195,6711,2511,4200,5.246,14.020,9649,3706,5943,7.742,20.158,-2938,-6.138,28.040,221,226,2357
2000,3161,276,297,13939,14695,21,6.897,36,11.823,1118,436,682,2.967,7.608,2599,650,1949,4.423,17.687,-1481,-10.079,15.217,29,29,258
2000,3162,312,351,29016,31193,32,9.001,41,11.533,1603,375,1228,1.202,5.139,5858,2036,3822,6.527,18.780,-4255,-13.641,10.278,21,22,466
2000,3169,893,916,23688,24336,70,7.515,101,10.843,2365,256,2109,1.052,9.718,3703,1190,2513,4.890,15.216,-1338,-5.498,19.436,75,75,727
2000,3211,3994,4466,133564,133811,280,6.187,399,8.817,13179,2711,10468,2.026,9.849,13638,4100,9538,3.064,10.192,-459,-0.343,19.698,304,306,2119
2000,3212,1437,1817,121274,119455,108,5.973,90,4.978,11182,2084,9098,1.745,9.361,7563,1833,5730,1.534,6.331,3619,3.030,12.663,63,63,945
2000,3219,9213,10017,343979,343406,937,9.387,867,8.686,44146,11465,32681,3.339,12.855,42904,11569,31335,3.369,12.494,1242,0.362,24.987,664,669,6708
2000,3221,247,541,167535,167718,25,4.647,19,3.532,8197,4986,3211,2.973,4.887,8910,881,8029,0.525,5.312,-713,-0.425,9.775,8,8,85
2000,3222,3387,5144,393821,393888,225,4.358,262,5.075,31986,8184,23802,2.078,8.121,31982,12787,19195,3.246,8.120,4,0.001,16.239,162,164,2599
2000,3231,35169,36978,811309,816967,2035,5.410,3317,8.817,77444,17336,60108,2.122,9.479,89112,31468,57644,3.852,10.908,-11668,-1.428,18.959,2641,2658,20236
2000,3241,1055,2106,105663,105110,122,5.755,150,7.075,9551,1792,7759,1.705,9.087,8429,2259,6170,2.149,8.019,1122,1.067,16.039,58,58,758
2000,3251,1103,2345,196857,198752,113,4.837,95,4.067,10991,2889,8102,1.454,5.530,14740,2381,12359,1.198,7.416,-3749,-1.886,11.060,42,42,541
2000,3252,474,802,117497,117280,62,7.853,37,4.687,8780,1965,6815,1.675,7.486,8460,1363,7097,1.162,7.214,320,0.273,14.427,20,20,169
2000,3253,642,867,35772,36182,49,5.629,56,6.433,2695,556,2139,1.537,7.448,3547,724,2823,2.001,9.803,-852,-2.355,14.897,37,37,195
2000,3254,1379,1719,222557,217759,121,7.014,133,7.710,21636,3345,18291,1.536,9.936,12502,3073,9429,1.411,5.741,9134,4.195,11.482,87,87,1530
2000,3255,1561,2012,74795,74796,100,4.947,119,5.887,6819,1677,5142,2.242,9.117,6806,1997,4809,2.670,9.099,13,0.017,18.199,68,68,457
2000,3256,2051,2280,123614,123701,137,5.981,158,6.898,11319,1782,9537,1.441,9.150,11526,2732,8794,2.209,9.318,-207,-0.167,18.301,109,111,1963
2000,3259,2139,2793,119263,120745,190,6.817,178,6.387,10725,3033,7692,2.512,8.882,13723,3323,10400,2.752,11.365,-2998,-2.483,17.765,112,123,2337
2000,3261,10325,12915,835241,828294,706,5.432,870,6.694,97561,21307,76254,2.572,11.779,83434,24543,58891,2.963,10.073,14127,1.706,20.146,562,567,9428
2000,3262,1973,2570,206572,204710,149,5.791,155,6.024,16043,2501,13542,1.222,7.837,12290,2078,10212,1.015,6.004,3753,1.833,12.007,114,114,814
2000,3271,1435,1682,74974,74537,111,6.465,181,10.542,7566,1389,6177,1.864,10.151,6708,1825,4883,2.448,9.000,858,1.151,17.999,139,139,982
2000,3272,1885,2178,130923,130430,172,7.928,155,7.145,11038,1485,9553,1.139,8.463,9705,2469,7236,1.893,7.441,1333,1.022,14.882,108,108,798
2000,3273,5335,9026,216091,210318,572,6.380,451,5.030,33213,7680,25533,3.652,15.792,21381,5773,15608,2.745,10.166,11832,5.626,20.332,273,285,3889
2000,3274,242,380,20827,20827,31,8.190,28,7.398,1639,637,1002,3.059,7.870,1637,317,1320,1.522,7.860,2,0.010,15.720,19,19,86
2000,3279,2031,2451,75904,75692,198,8.130,167,6.857,7501,2035,5466,2.689,9.910,7152,2272,4880,3.002,9.449,349,0.461,18.898,110,113,1111
2000,3311,365,471,141482,140295,110,25.641,26,6.061,9203,2985,6218,2.128,6.560,6886,1145,5741,0.816,4.908,2317,1.652,9.816,15,15,136
2000,3312,584,791,66203,65650,80,10.423,33,4.300,5915,2053,3862,3.127,9.010,4742,1006,3736,1.532,7.223,1173,1.787,14.446,18,18,334
2000,3313,389,555,85685,85563,33,6.016,20,3.646,4751,820,3931,0.958,5.553,4746,339,4407,0.396,5.547,5,0.006,11.094,11,11,145
2000,3314,725,920,76960,78566,65,7.104,55,6.011,5419,960,4459,1.222,6.897,8774,1892,6882,2.408,11.168,-3355,-4.270,13.795,33,33,367
2000,3315,2290,2612,220550,220802,94,3.557,156,5.902,18437,1938,16499,0.878,8.350,19108,3489,15619,1.580,8.654,-671,-0.304,16.700,122,123,1763
2000,3321,2655,2895,148551,148399,95,3.231,185,6.293,13274,1528,11746,1.030,8.945,12996,3780,9216,2.547,8.758,278,0.187,17.515,138,138,1596
2000,3322,1445,1597,80424,80585,94,5.862,107,6.673,6288,1284,5004,1.593,7.803,6753,1508,5245,1.871,8.380,-465,-0.577,15.606,76,76,505
2000,3323,11042,11988,413535,407009,777,6.484,769,6.417,52997,12519,40478,3.076,13.021,39761,11213,28548,2.755,9.769,13236,3.252,19.538,558,568,7696
2000,3324,1390,1730,101189,102655,69,3.939,112,6.395,9019,1018,8001,0.992,8.786,11887,2948,8939,2.872,11.580,-2868,-2.794,17.572,81,81,1319
2000,3325,768,857,67705,66780,44,5.125,47,5.475,6467,1109,5358,1.661,9.684,4709,946,3763,1.417,7.052,1758,2.633,14.103,33,33,398
2000,3326,1628,1815,71285,70678,121,6.669,120,6.613,7480,1537,5943,2.175,10.583,6287,1428,4859,2.020,8.895,1193,1.688,17.791,86,87,804
2000,3327,25017,25483,430740,429134,1595,6.226,1866,7.284,50725,11532,39193,2.687,11.820,47743,11851,35892,2.762,11.125,2982,0.695,22.251,1437,1439,7919
2000,3328,5418,5995,154986,154245,311,5.155,386,6.399,18011,3319,14692,2.152,11.677,16509,4469,12040,2.897,10.703,1502,0.974,21.406,306,308,2907
2000,3329,5797,6366,312073,311492,466,7.316,473,7.426,28366,6549,21817,2.102,9.107,27361,7403,19958,2.377,8.784,1005,0.323,17.568,343,343,3652
2000,3331,2559,2881,198069,200480,154,5.299,204,7.020,17078,3107,13971,1.550,8.519,22018,6264,15754,3.125,10.983,-4940,-2.464,17.037,139,139,1892
2000,3332,4029,4269,183513,180960,288,6.694,355,8.251,23966,7268,16698,4.016,13.244,19280,7106,12174,3.927,10.654,4686,2.590,21.309,250,251,2273
2000,3333,2228,2397,131143,132106,155,6.412,196,8.108,12202,2400,9802,1.817,9.237,14172,3326,10846,2.518,10.728,-1970,-1.491,18.473,152,153,1892
2000,3334,1414,1740,180437,179392,90,5.137,114,6.507,16080,3230,12850,1.801,8.964,14041,3770,10271,2.102,7.827,2039,1.137,15.654,69,69,1378
2000,3335,9182,9575,234541,236499,425,4.403,581,6.019,21251,5511,15740,2.330,8.986,24955,5430,19525,2.296,10.552,-3704,-1.566,17.971,459,460,3882
2000,3336,751,913,111153,111203,38,4.146,45,4.910,7746,554,7192,0.498,6.966,7649,1724,5925,1.550,6.878,97,0.087,13.757,27,27,680
2000,3339,5774,6455,341958,344101,308,4.734,411,6.317,29989,8777,21212,2.551,8.715,34515,7537,26978,2.190,10.030,-4526,-1.315,17.430,289,291,3873
2000,3341,1596,1698,197018,202436,208,12.304,193,11.417,22684,6645,16039,3.283,11.206,32000,10093,21907,4.986,15.808,-9316,-4.602,22.411,138,138,1646
2000,3342,1794,2004,227450,233259,164,8.143,184,9.136,26095,6046,20049,2.592,11.187,36896,7687,29209,3.295,15.818,-10801,-4.630,22.374,126,126,1901
2000,3343,497,523,30869,29937,62,11.958,53,10.222,4732,1220,3512,4.075,15.807,2813,891,1922,2.976,9.396,1919,6.410,18.793,33,35,400
2000,3344,4876,5594,564944,554798,389,6.904,470,8.341,81105,14976,66129,2.699,14.619,60458,17834,42624,3.215,10.897,20647,3.722,21.795,314,317,5312
2000,3345,4371,5046,481310,489750,285,5.583,402,7.875,42833,7725,35108,1.577,8.746,58186,23512,34674,4.801,11.881,-15353,-3.135,17.492,247,250,3866
2000,3346,763,825,41999,43674,112,13.853,79,9.771,4408,742,3666,1.699,10.093,7594,2383,5211,5.456,17.388,-3186,-7.295,20.186,59,60,765
2000,3351,1143,1256,74471,74490,89,7.063,97,7.698,7189,1518,5671,2.038,9.651,7059,2536,4523,3.405,9.477,130,0.175,18.953,77,77,942
2000,3352,247,317,103188,101972,28,8.805,30,9.434,9515,1754,7761,1.720,9.331,6821,2052,4769,2.012,6.689,2694,2.642,13.378,19,19,309
2000,3353,2277,2705,197142,197272,109,3.984,171,6.250,16773,3211,13562,1.628,8.502,17194,3919,13275,1.987,8.716,-421,-0.213,17.005,107,108,718
2000,3359,1868,2264,203925,200718,191,8.485,165,7.330,24636,5826,18810,2.903,12.274,18285,5421,12864,2.701,9.110,6351,3.164,18.220,106,106,1479
2000,3361,288,351,225860,225100,47,13.506,41,11.782,20791,6426,14365,2.855,9.236,19343,12034,7309,5.346,8.593,1448,0.643,17.186,25,25,372
2000,3362,1759,1981,151876,146440,153,7.719,155,7.820,19853,5119,14734,3.496,13.557,8899,2470,6429,1.687,6.077,10954,7.480,12.154,117,117,1574
2000,3363,4361,5513,824441,813365,304,5.464,406,7.297,83905,16496,67409,2.028,10.316,61534,18027,43507,2.216,7.565,22371,2.750,15.131,275,277,5715
2000,3364,1372,1706,417338,439145,128,7.518,121,7.107,27961,6181,21780,1.408,6.367,72990,5032,67958,1.146,16.621,-45029,-10.254,12.734,82,82,1385
2000,3365,148,212,29269,30174,13,6.061,18,8.392,2433,319,2114,1.057,8.063,4317,286,4031,0.948,14.307,-1884,-6.244,16.127,12,12,83
2000,3366,1500,1620,145380,144771,173,10.789,140,8.731,14447,2975,11472,2.055,9.979,13205,2222,10983,1.535,9.121,1242,0.858,18.243,104,104,1253
2000,3369,666,691,37951,37924,81,11.739,79,11.449,4831,885,3946,2.334,12.739,4836,1450,3386,3.823,12.752,-5,-0.013,25.478,59,59,418
2000,3371,13260,13768,410468,402412,1387,10.097,1324,9.639,50972,9897,41075,2.459,12.667,34757,11270,23487,2.801,8.637,16215,4.029,17.274,1004,1013,7957
2000,3372,3915,4138,188907,186816,256,6.151,304,7.304,21388,3876,17512,2.075,11.449,17334,5047,12287,2.702,9.279,4054,2.170,18.557,228,228,3185
2000,3379,958,1085,48455,47082,52,4.760,67,6.133,6477,1083,5394,2.300,13.757,3690,733,2957,1.557,7.837,2787,5.920,15.675,51,52,626
2000,3391,10666,11295,291298,289591,771,6.802,851,7.508,37313,8874,28439,3.064,12.885,33776,10940,22836,3.778,11.663,3537,1.221,23.327,606,607,3471
2000,3399,17062,17628,430346,427735,1851,10.550,1684,9.598,54970,14775,40195,3.454,12.851,49712,15716,33996,3.674,11.622,5258,1.229,23.244,1342,1346,9142
2000,4231,16506,21002,309054,306012,2178,10.352,2254,10.713,45812,18599,27213,6.078,14.971,39645,14967,24678,4.891,12.955,6167,2.015,25.911,1628,1697,10055
2000,4232,9942,11204,153264,149068,1281,11.567,1022,9.228,26910,7908,19002,5.305,18.052,18497,7228,11269,4.849,12.408,8413,5.644,24.817,746,767,5123
2000,4233,8996,12143,167969,161517,1431,11.980,1035,8.665,32428,12577,19851,7.787,20.077,19375,6386,12989,3.954,11.996,13053,8.082,23.991,687,703,3822
2000,4234,28174,36434,713085,706039,4411,12.122,4320,11.872,144244,52112,92132,7.381,20.430,129728,51272,78456,7.262,18.374,14516,2.056,36.748,2776,2875,17656
2000,4235,7632,10364,167724,165955,745,7.181,765,7.374,20616,5131,15485,3.092,12.423,17133,5557,11576,3.348,10.324,3483,2.099,20.648,502,517,3144
2000,4236,19657,29792,472154,457996,3320,11.211,2963,10.006,96011,37047,58964,8.089,20.963,68418,25162,43256,5.494,14.939,27593,6.025,29.877,1570,1692,10355
2000,4237,10886,16511,212151,207119,1152,6.989,1096,6.649,32283,7706,24577,3.721,15.587,22101,7043,15058,3.400,10.671,10182,4.916,21.341,728,764,4854
2000,4238,48258,64143,762916,760450,4338,6.730,4962,7.698,98411,29027,69384,3.817,12.941,93597,33213,60384,4.368,12.308,4814,0.633,24.616,3199,3504,19996
2000,4239,28731,31071,324055,318675,3870,12.548,3413,11.066,56212,18104,38108,5.681,17.639,45843,17398,28445,5.459,14.386,10369,3.254,28.771,2580,2620,12563
2000,4241,9602,12508,223700,221544,873,6.905,1144,9.048,33790,8061,25729,3.639,15.252,30046,15026,15020,6.782,13.562,3744,1.690,27.124,604,623,3081
2000,4242,4969,6350,194461,186477,934,14.912,761,12.150,40030,15610,24420,8.371,21.467,23576,10523,13053,5.643,12.643,16454,8.824,25.286,498,502,4264
2000,4243,13440,14455,184510,181967,1865,12.969,1716,11.933,32821,9857,22964,5.417,18.037,27771,9649,18122,5.303,15.262,5050,2.775,30.523,1321,1334,5682
2000,4244,26617,32280,777237,776521,2819,8.674,3261,10.034,101975,25550,76425,3.290,13.132,101295,34403,66892,4.430,13.045,680,0.088,26.089,2387,2460,19523
2000,4245,4821,7572,68651,68842,332,4.330,524,6.834,8371,1959,6412,2.846,12.160,8778,2830,5948,4.111,12.751,-407,-0.591,24.319,320,358,1948
2000,4246,9505,13601,160745,156563,1173,8.652,1087,8.017,28139,9574,18565,6.115,17.973,19782,7210,12572,4.605,12.635,8357,5.338,25.270,645,662,3458
2000,4247,6891,9945,126389,127025,483,4.752,922,9.071,17572,3567,14005,2.808,13.833,18945,7648,11297,6.021,14.914,-1373,-1.081,27.667,353,375,2950
2000,4248,3140,3991,153830,151085,242,5.996,332,8.226,16765,2879,13886,1.906,11.096,11265,5054,6211,3.345,7.456,5500,3.640,14.912,228,235,2631
2000,4249,22565,27141,367193,362335,3248,11.990,3146,11.613,62392,19984,42408,5.515,17.219,52657,20629,32028,5.693,14.533,9735,2.687,29.065,2317,2357,11556
2000,4251,33392,35680,288933,288231,2932,8.206,3036,8.497,43103,11287,31816,3.916,14.954,41691,15889,25802,5.513,14.464,1412,0.490,28.929,2050,2075,9706
2000,4411,42854,46415,1215892,1194143,4501,9.744,4053,8.774,151852,47451,104401,3.974,12.716,108056,45546,62510,3.814,9.049,43796,3.668,18.098,3068,3126,30761
2000,4412,12173,13182,125468,120273,1326,10.177,1020,7.829,24241,7387,16854,6.142,20.155,13787,5298,8489,4.405,11.463,10454,8.692,22.926,787,799,3941
2000,4413,35512,59563,546847,542857,4386,7.338,4795,8.023,73973,25729,48244,4.740,13.627,65908,26635,39273,4.906,12.141,8065,1.486,24.282,2559,2992,14390
2000,4421,19808,27774,287500,281307,2212,7.951,2307,8.292,45565,13453,32112,4.782,16.198,33154,12487,20667,4.439,11.786,12411,4.412,23.571,1529,1667,7148
2000,4422,24717,32881,269875,262909,3611,11.091,2965,9.107,55736,27481,28255,10.453,21.200,41828,15530,26298,5.907,15.910,13908,5.290,31.819,1889,2169,10656
2000,4431,32455,50208,486542,473455,5368,10.722,5086,10.158,92591,34136,58455,7.210,19.556,66056,25148,40908,5.312,13.952,26535,5.605,27.904,3601,3756,16651
2000,4441,48304,69786,1092701,1067691,4005,5.715,4598,6.561,157161,48541,108620,4.546,14.720,107111,56897,50214,5.329,10.032,50050,4.688,20.064,2954,3143,18542
2000,4442,16471,20524,189806,185710,1357,6.589,1496,7.264,29944,7628,22316,4.107,16.124,21852,7276,14576,3.918,11.767,8092,4.357,23.533,1070,1084,5019
2000,4451,60160,87949,2700943,2743147,8919,10.063,10289,11.608,329186,141501,187685,5.158,12.000,416577,207792,208785,7.575,15.186,-87391,-3.186,24.001,5866,6042,42393
2000,4452,17493,22007,149195,146787,3033,13.898,2665,12.212,31939,14533,17406,9.901,21.759,27145,11566,15579,7.879,18.493,4794,3.266,36.986,1807,1903,8220
2000,4453,22911,26069,134319,133224,2141,8.196,2246,8.598,20836,6947,13889,5.215,15.640,18707,7143,11564,5.362,14.042,2129,1.598,28.084,1634,1656,5270
2000,4461,40059,77546,905164,926280,6202,7.956,7018,9.003,131908,51154,80754,5.523,14.241,172889,66252,106637,7.152,18.665,-40981,-4.424,28.481,3216,3495,19186
2000,4471,61609,113764,936179,931295,8184,7.152,9520,8.319,159096,55829,103267,5.995,17.083,148833,53916,94917,5.789,15.981,10263,1.102,31.963,5628,6050,32956
2000,4481,36848,83894,1006123,971264,8637,10.260,9219,10.951,208149,80301,127848,8.268,21.431,137364,58466,78898,6.020,14.143,70785,7.288,28.286,4132,4522,17312
2000,4482,6459,28420,194242,193837,2060,7.158,2774,9.640,38772,11644,27128,6.007,20.002,38168,11710,26458,6.041,19.691,604,0.312,39.382,598,690,2554
2000,4483,19010,29281,170416,166992,2577,8.852,2240,7.694,28699,9882,18817,5.918,17.186,21754,8296,13458,4.968,13.027,6945,4.159,26.054,1302,1384,4772
2000,4511,29539,40300,392432,390098,3899,9.605,4486,11.051,69672,31201,38471,7.998,17.860,64746,24295,40451,6.228,16.597,4926,1.263,33.195,2921,3132,12255
2000,4512,7216,12910,150160,145653,966,7.356,1410,10.737,28160,9684,18476,6.649,19.334,19208,8421,10787,5.782,13.188,8952,6.146,26.375,805,958,4616
2000,4522,60,5940,1024259,1019511,183,3.072,217,3.643,86898,21257,65641,2.085,8.523,74295,24832,49463,2.436,7.287,12603,1.236,14.575,D,D,D
2000,4523,9116,31507,1537410,1503834,3709,12.125,1873,6.123,181237,79706,101531,5.300,12.052,112656,31268,81388,2.079,7.491,68581,4.560,14.983,1001,1078,10499
2000,4531,20992,22038,121081,121000,1792,8.004,2494,11.139,20101,5569,14532,4.602,16.612,19956,8931,11025,7.381,16.493,145,0.120,32.985,1919,1976,6964
2000,4532,29330,40991,360287,356391,4218,10.315,4023,9.838,61938,27560,34378,7.733,17.379,53941,16831,37110,4.723,15.135,7997,2.244,30.271,2933,3015,10266
2000,4533,12688,16382,114136,112083,1697,10.304,1872,11.366,19305,7298,12007,6.511,17.224,15151,5476,9675,4.886,13.518,4154,3.706,27.035,1490,1505,4121
2000,4539,31438,39473,253332,250031,5475,14.017,4650,11.905,53221,23552,29669,9.420,21.286,46394,19772,26622,7.908,18.555,6827,2.730,37.111,3339,3474,13991
2000,4541,10045,10976,267320,252061,2594,25.347,1110,10.846,63681,27489,36192,10.906,25.264,33342,9767,23575,3.875,13.228,30339,12.036,26.456,790,793,4811
2000,4542,4951,5537,66661,66470,593,10.637,669,12.000,8834,2336,6498,3.514,13.290,8521,3675,4846,5.529,12.819,313,0.471,25.639,541,545,3008
2000,4543,19451,25487,228644,226241,2673,10.536,2441,9.621,37586,11029,26557,4.875,16.613,33084,12597,20487,5.568,14.623,4502,1.990,29.247,1608,1661,8273
2000,4811,661,3139,522704,508434,301,9.741,203,6.570,47852,4945,42907,0.973,9.412,18883,6286,12597,1.236,3.714,28969,5.698,7.428,70,84,1955
2000,4812,1657,1811,34567,33441,277,15.466,237,13.233,6541,1792,4749,5.359,19.560,4241,2003,2238,5.990,12.682,2300,6.878,25.364,150,152,831
2000,4831,796,1179,50997,50633,143,12.098,149,12.606,9393,2334,7059,4.610,18.551,8868,1795,7073,3.545,17.514,525,1.037,35.029,72,80,1102
2000,4832,483,526,19016,18973,63,12.023,59,11.260,1997,410,1587,2.161,10.526,1909,422,1487,2.224,10.062,88,0.464,20.124,42,42,182
2000,4841,38734,47589,988459,972576,9006,19.297,7169,15.361,190969,66305,124664,6.817,19.635,162708,60895,101813,6.261,16.730,28261,2.906,33.459,5298,5435,27621
2000,4842,45859,49353,503792,500156,5806,11.635,6906,13.839,91521,26148,65373,5.228,18.298,84386,31722,52664,6.342,16.872,7135,1.427,33.744,5295,5337,21740
2000,4851,459,694,39587,38005,102,14.967,77,11.299,5792,2822,2970,7.425,15.240,2723,1632,1091,4.294,7.165,3069,8.075,14.330,37,37,701
2000,4852,210,379,21194,19798,33,8.639,39,10.209,4399,297,4102,1.500,22.219,1530,722,808,3.647,7.728,2869,14.491,15.456,23,23,190
2000,4853,5810,5910,68353,65983,965,16.491,848,14.492,13874,4946,8928,7.496,21.027,9131,4384,4747,6.644,13.838,4743,7.188,27.677,677,679,3313
2000,4854,3079,4138,161844,161511,249,5.958,331,7.921,17178,4507,12671,2.791,10.636,16557,7463,9094,4.621,10.251,621,0.384,20.503,216,228,3529
2000,4855,1191,1330,33558,33143,122,9.067,153,11.371,5327,928,4399,2.800,16.073,4496,1729,2767,5.217,13.565,831,2.507,27.131,120,120,999
2000,4859,2252,2441,52243,50728,360,14.898,311,12.870,10665,3032,7633,5.977,21.024,7637,3269,4368,6.444,15.055,3028,5.969,30.110,224,227,1836
2000,4861,40,305,6543,6514,29,9.221,48,15.262,1470,478,992,7.338,22.567,1433,808,625,12.404,21.999,37,0.568,43.998,3,3,5
2000,4862,125,2012,36610,35367,619,33.770,261,14.239,11567,8443,3124,23.873,32.706,9225,3807,5418,10.764,26.084,2342,6.622,52.167,11,11,190
2000,4869,56,512,6528,6297,80,15.795,69,13.623,1392,510,882,8.100,22.108,982,393,589,6.242,15.596,410,6.512,31.192,3,3,13
2000,4871,365,407,8789,8653,51,12.639,44,10.905,1352,232,1120,2.681,15.625,1072,262,810,3.028,12.389,280,3.236,24.778,32,32,166
2000,4872,1172,1203,13339,12924,142,11.779,147,12.194,2711,512,2199,3.962,20.976,1921,405,1516,3.134,14.864,790,6.113,29.728,112,112,356
2000,4879,141,145,2064,2011,16,11.111,14,9.722,343,58,285,2.885,17.060,241,108,133,5.372,11.987,102,5.073,23.974,12,12,99
2000,4881,3136,4117,129397,125453,418,10.204,377,9.203,22617,5134,17483,4.092,18.028,14900,7704,7196,6.141,11.877,7717,6.151,23.754,238,242,1802
2000,4882,422,765,22770,21721,64,8.253,85,10.961,5786,2424,3362,11.160,26.638,3865,1576,2289,7.256,17.794,1921,8.844,35.588,32,34,403
2000,4883,1717,2243,79331,74686,198,8.763,231,10.224,19514,4963,14551,6.645,26.128,10200,2154,8046,2.884,13.657,9314,12.471,27.314,143,156,1073
2000,4884,6002,6285,54220,52012,861,13.768,798,12.761,13091,4510,8581,8.671,25.169,8706,3865,4841,7.431,16.738,4385,8.431,33.477,601,604,2773
2000,4885,10863,14552,164247,160079,1427,9.777,1514,10.373,31603,10116,21487,6.319,19.742,23384,9764,13620,6.099,14.608,8219,5.134,29.216,962,1056,6461
2000,4889,1021,1116,24927,23773,278,26.705,128,12.296,4208,1585,2623,6.667,17.701,1933,690,1243,2.903,8.131,2275,9.570,16.262,94,94,322
2000,4921,2399,6370,551743,530124,1138,18.537,676,11.012,91642,23202,68440,4.377,17.287,46715,23007,23708,4.340,8.812,44927,8.475,17.624,298,333,2544
2000,4922,4341,4782,68488,67999,665,13.818,726,15.086,11769,3524,8245,5.182,17.308,10522,4568,5954,6.718,15.474,1247,1.834,30.948,600,616,3594
2000,4931,6693,12598,558627,546944,1280,10.290,962,7.734,103364,40894,62470,7.477,18.898,80332,27021,53311,4.940,14.687,23032,4.211,29.375,350,367,4523
2000,5111,15380,19314,689224,731801,2105,10.961,1886,9.821,75952,26428,49524,3.611,10.379,160408,20907,139501,2.857,21.920,-84456,-11.541,20.758,1388,1393,10170
2000,5112,7634,10066,335727,317945,1382,13.649,1500,14.815,89871,29695,60176,9.340,28.266,54090,24822,29268,7.807,17.012,35781,11.254,34.025,938,1001,11748
2000,5121,11945,16066,270771,265996,2081,12.917,2169,13.464,60940,20294,40646,7.629,22.910,50590,22706,27884,8.536,19.019,10350,3.891,38.038,1257,1299,6393
2000,5122,2541,2734,23481,22474,434,16.038,378,13.969,6033,2925,3108,13.015,26.845,4185,1952,2233,8.686,18.622,1848,8.223,37.244,304,304,1530
2000,5151,5219,7639,247139,246454,803,10.441,907,11.793,34682,14822,19860,6.014,14.072,33344,15434,17910,6.262,13.530,1338,0.543,27.059,594,669,10053
2000,5152,309,558,33620,32815,101,17.719,125,21.930,5339,1813,3526,5.525,16.270,3605,1923,1682,5.860,10.986,1734,5.284,21.972,45,85,1352
2000,5173,7994,39699,1364170,1293065,7719,20.564,3393,9.039,300004,151818,148186,11.741,23.201,158216,52491,105725,4.059,12.236,141788,10.965,24.471,1054,1470,18053
2000,5174,427,649,19195,17945,138,20.384,194,28.656,6330,2152,4178,11.992,35.274,3827,1344,2483,7.490,21.326,2503,13.948,42.653,45,46,473
2000,5179,6717,8011,136610,115541,2894,40.061,1320,18.272,67783,33513,34270,29.005,58.666,25414,13382,12032,11.582,21.996,42369,36.670,43.992,1002,1024,9142
2000,5182,5512,9551,373188,358844,2134,23.025,1568,16.918,89081,38613,50468,10.760,24.824,59631,16600,43031,4.626,16.618,29450,8.207,33.235,427,429,4231
2000,5191,3683,4387,82293,72670,797,19.404,238,5.794,25217,12865,12352,17.703,34.701,5577,1971,3606,2.712,7.674,19640,27.026,15.349,126,129,1036
2000,5211,15,44,22286,22578,D,D,0,0.000,341,D,328,D,1.510,918,0,918,0.000,4.066,-577,-2.556,3.021,0,0,0
2000,5221,18378,106861,1984214,1952504,9628,9.190,5435,5.188,333225,150409,182816,7.703,17.067,274408,68903,205505,3.529,14.054,58817,3.012,28.108,603,969,11751
2000,5222,17904,45306,619317,626891,6428,14.265,5937,13.176,135134,64120,71014,10.228,21.556,151035,50726,100309,8.092,24.093,-15901,-2.536,43.112,2130,2376,15731
2000,5223,13974,20588,211345,210463,4960,25.288,3012,15.356,56460,27512,28948,13.072,26.827,54089,24680,29409,11.727,25.700,2371,1.127,51.400,1727,1907,12390
2000,5231,11658,36803,534469,509423,7617,22.203,2623,7.646,105960,40699,65261,7.989,20.800,55624,18550,37074,3.641,10.919,50336,9.881,21.838,945,980,5518
2000,5232,81,92,6869,6717,35,44.025,10,12.579,522,180,342,2.680,7.771,237,33,204,0.491,3.528,285,4.243,7.057,9,9,32
2000,5239,25044,28450,318347,297493,5502,20.113,3314,12.114,80583,37319,43264,12.545,27.087,39428,18444,20984,6.200,13.253,41155,13.834,26.507,2203,2240,8329
2000,5241,5010,36304,1492857,1518664,5226,13.513,9964,25.765,234131,69126,165005,4.552,15.417,286419,106866,179553,7.037,18.860,-52288,-3.443,30.834,341,419,8139
2000,5242,112182,123584,819264,817976,11343,9.157,11916,9.620,144476,47843,96633,5.849,17.663,141542,65488,76054,8.006,17.304,2934,0.359,34.608,7893,8141,32043
2000,5259,589,629,5562,5389,245,44.995,76,13.958,3045,2384,661,44.238,56.504,2769,739,2030,13.713,51.382,276,5.122,102.765,50,50,239
2000,5311,87449,99715,528774,523272,10222,10.265,9963,10.004,100428,44864,55564,8.574,19.192,89196,35785,53411,6.839,17.046,11232,2.146,34.092,7534,7694,25293
2000,5312,49488,55910,270185,266072,7571,13.650,6680,12.044,60638,23349,37289,8.775,22.790,51663,22564,29099,8.480,19.417,8975,3.373,38.834,4365,4471,12343
2000,5313,44953,52393,494893,484317,7176,13.912,5553,10.765,95498,34977,60521,7.222,19.718,73819,28489,45330,5.882,15.242,21679,4.476,30.484,3466,3535,15754
2000,5321,4457,10405,179227,177115,1087,10.509,964,9.320,24541,7816,16725,4.413,13.856,20415,12687,7728,7.163,11.526,4126,2.330,23.053,467,497,2623
2000,5322,14694,30692,252215,252645,3044,9.804,3755,12.094,47712,19437,28275,7.693,18.885,47575,18016,29559,7.131,18.831,137,0.054,37.662,2423,2879,12488
2000,5323,3401,5796,39553,39576,403,6.957,396,6.836,5714,1570,4144,3.967,14.438,5646,2924,2722,7.388,14.266,68,0.172,28.532,302,319,2571
2000,5324,7174,11419,158148,153036,1405,12.344,1332,11.702,37068,15001,22067,9.802,24.222,27227,11673,15554,7.628,17.791,9841,6.431,35.583,732,834,5949
2000,5331,1688,1828,22120,21571,231,12.710,210,11.554,5249,1871,3378,8.674,24.334,4234,1516,2718,7.028,19.628,1015,4.705,39.256,147,150,1274
2000,5411,154304,161772,1092900,1090165,13198,8.142,13853,8.546,135169,41121,94048,3.772,12.399,129779,40720,89059,3.735,11.905,5390,0.494,23.809,9822,9917,28805
2000,5412,85298,92377,1179656,1135963,9699,10.574,8393,9.150,252861,72499,180362,6.382,22.260,162689,57267,105422,5.041,14.322,90172,7.938,28.643,5736,5812,33609
2000,5413,82411,93097,1236952,1217852,10095,10.919,8809,9.528,211594,67440,144154,5.538,17.374,173242,60962,112280,5.006,14.225,38352,3.149,28.450,5737,5853,27202
2000,5414,24028,24270,137438,134003,3540,14.697,3173,13.173,29957,10653,19304,7.950,22.356,22894,9811,13083,7.322,17.085,7063,5.271,34.170,2400,2404,7574
2000,5415,73201,82588,1169029,1097626,18489,23.146,13074,16.367,360328,143807,216521,13.102,32.828,216967,83902,133065,7.644,19.767,143361,13.061,39.534,9188,9288,45244
2000,5416,64975,69376,631465,605022,14384,21.367,10271,15.257,163127,66230,96897,10.947,26.962,109918,45250,64668,7.479,18.168,53209,8.795,36.335,7474,7545,27068
2000,5417,9685,12473,580203,565060,1764,14.371,1367,11.137,98626,32267,66359,5.710,17.454,69191,18525,50666,3.278,12.245,29435,5.209,24.490,742,756,5580
2000,5418,32003,35525,486647,471209,4233,11.921,4200,11.828,105713,31713,74000,6.730,22.434,74356,32598,41758,6.918,15.780,31357,6.655,31.560,3122,3180,17357
2000,5419,47382,54379,482694,467138,6998,13.192,4337,8.176,96607,32335,64272,6.922,20.681,66267,21269,44998,4.553,14.186,30340,6.495,28.371,2933,2957,13379
2000,5511,28262,53041,3341031,3308102,6447,12.312,5089,9.719,624073,211257,412816,6.386,18.865,564064,152131,411933,4.599,17.051,60009,1.814,34.102,1237,1396,20698
2000,5611,19717,21727,434574,416820,3292,15.233,3059,14.155,109497,42509,66988,10.198,26.270,74095,33563,40532,8.052,17.776,35402,8.493,35.553,2023,2087,21846
2000,5612,1461,3147,129669,126716,761,26.309,252,8.712,28593,10625,17968,8.385,22.565,22667,9633,13034,7.602,17.888,5926,4.677,35.776,98,100,3191
2000,5613,26400,45127,4476419,4224340,7271,16.443,5454,12.334,1312422,338515,973907,8.013,31.068,811015,290959,520056,6.888,19.199,501407,11.869,38.397,2733,2863,90371
2000,5614,25413,30601,714277,698227,4177,13.636,4240,13.842,170240,59266,110974,8.488,24.382,137195,52130,85065,7.466,19.649,33045,4.733,39.298,2984,3080,27401
2000,5615,22426,30361,302707,300377,2718,8.750,4122,13.270,59745,21708,38037,7.227,19.890,54882,25094,29788,8.354,18.271,4863,1.619,36.542,2629,2704,13725
2000,5616,15524,19782,705635,702297,2496,12.697,2249,11.440,112561,38057,74504,5.419,16.028,107712,30224,77488,4.304,15.337,4849,0.690,30.674,1548,1563,16570
2000,5617,115660,121624,1507152,1477367,17548,14.473,16796,13.853,321990,100195,221795,6.782,21.795,262727,102201,160526,6.918,17.783,59263,4.011,35.567,12666,12689,68799
2000,5619,20024,22112,464299,424638,2222,9.934,2733,12.219,135768,18299,117469,4.309,31.973,59683,17823,41860,4.197,14.055,76085,17.918,28.110,2032,2059,10976
2000,5621,5794,7207,152483,151309,838,11.515,979,13.452,30659,12217,18442,8.074,20.263,28145,14005,14140,9.256,18.601,2514,1.662,37.202,737,750,7929
2000,5622,1416,2339,52729,51646,441,19.626,257,11.437,12842,7182,5660,13.906,24.866,10771,5746,5025,11.126,20.856,2071,4.010,41.711,159,162,2413
2000,5629,5280,5852,93337,91189,661,11.289,667,11.392,21350,4653,16697,5.103,23.413,16945,6472,10473,7.097,18.582,4405,4.831,37.165,453,467,3170
2000,6111,16521,18844,740897,720790,1023,5.484,642,3.442,79523,20686,58837,2.870,11.033,39794,8526,31268,1.183,5.521,39729,5.512,11.042,397,403,5035
2000,6112,527,789,80128,78405,30,3.783,38,4.792,8498,345,8153,0.440,10.839,4806,1001,3805,1.277,6.130,3692,4.709,12.259,24,28,566
2000,6113,2355,2990,1336910,1321894,160,5.407,98,3.312,86224,4729,81495,0.358,6.523,56329,876,55453,0.066,4.261,29895,2.262,8.522,67,67,676
2000,6114,5486,6041,64440,62545,976,16.370,818,13.720,15429,6019,9410,9.624,24.669,11694,4094,7600,6.546,18.697,3735,5.972,37.394,595,615,2795
2000,6115,5303,6236,79777,76891,711,11.459,649,10.459,16226,5724,10502,7.444,21.103,10300,4154,6146,5.402,13.396,5926,7.707,26.791,442,461,2730
2000,6116,21173,22993,203407,194500,3300,14.638,2401,10.651,46644,16146,30498,8.301,23.982,28539,10429,18110,5.362,14.673,18105,9.309,29.346,1762,1783,7870
2000,6117,3267,3539,39145,36488,569,16.348,452,12.987,10763,5308,5455,14.547,29.498,5315,1413,3902,3.873,14.567,5448,14.931,29.133,324,327,1020
2000,6211,157543,178382,1747433,1710179,14774,8.275,15076,8.444,303706,107963,195743,6.313,17.759,229504,101408,128096,5.930,13.420,74202,4.339,26.840,9890,10429,53277
2000,6212,106218,110267,705444,692327,5391,4.902,4823,4.385,98217,26451,71766,3.821,14.187,71988,19944,52044,2.881,10.398,26229,3.789,20.796,3689,3749,15212
2000,6213,78449,84248,418744,420003,9105,10.904,7619,9.124,85441,31514,53927,7.503,20.343,87272,47041,40231,11.200,20.779,-1831,-0.436,40.686,5197,5293,17622
2000,6214,10433,21912,558299,551761,2353,10.747,2317,10.583,93493,29842,63651,5.409,16.944,80293,34374,45919,6.230,14.552,13200,2.392,29.104,724,775,8281
2000,6215,5467,8600,150693,149980,1447,17.016,1255,14.758,31237,13903,17334,9.270,20.828,30461,13289,17172,8.861,20.310,776,0.517,40.620,490,644,5481
2000,6216,10142,15017,783552,788806,1890,12.089,3124,19.982,149605,37827,111778,4.795,18.966,160641,75036,85605,9.513,20.365,-11036,-1.399,37.932,1364,1540,27997
2000,6219,4472,6726,182864,179886,853,12.919,606,9.178,37140,13697,23443,7.614,20.646,30944,11849,19095,6.587,17.202,6196,3.444,34.404,321,349,4818
2000,6221,3412,5469,4557133,4550194,216,3.973,152,2.796,239223,57549,181674,1.265,5.257,224933,60995,163938,1.340,4.943,14290,0.314,9.887,59,59,29610
2000,6222,510,754,239813,242394,38,4.935,70,9.091,11640,4440,7200,1.832,4.802,16597,7802,8795,3.219,6.847,-4957,-2.045,9.604,17,32,5103
2000,6223,290,437,145487,147934,44,9.932,56,12.641,11102,3873,7229,2.618,7.505,16036,7745,8291,5.235,10.840,-4934,-3.335,15.009,14,14,1122
2000,6231,7895,15737,1520684,1527669,1274,8.143,1091,6.973,158512,58387,100125,3.822,10.376,170896,64138,106758,4.198,11.187,-12384,-0.811,20.752,473,551,29294
2000,6232,7452,22485,404465,394967,2438,11.200,1005,4.617,65376,26712,38664,6.763,16.552,46408,11669,34739,2.954,11.750,18968,4.802,23.500,396,437,4747
2000,6233,12496,16491,512345,493599,2049,12.579,1644,10.093,85703,34214,51489,6.932,17.363,48431,20015,28416,4.055,9.812,37272,7.551,19.624,1139,1180,11065
2000,6239,3433,6020,149587,147468,508,8.564,332,5.597,20532,5459,15073,3.702,13.923,16421,3912,12509,2.653,11.135,4111,2.788,22.271,191,201,1766
2000,6241,30559,43464,793124,768475,3594,8.362,2622,6.101,123424,29995,93429,3.903,16.061,74427,18229,56198,2.372,9.685,48997,6.376,19.370,1597,1641,9872
2000,6242,8298,10331,122569,118998,626,6.114,440,4.298,17909,3648,14261,3.066,15.050,10694,2946,7748,2.476,8.987,7215,6.063,17.973,238,253,1810
2000,6243,5169,7961,315894,310262,567,7.152,501,6.319,44565,7212,37353,2.324,14.364,33428,4619,28809,1.489,10.774,11137,3.590,21.548,241,245,1855
2000,6244,47777,60026,699981,683138,6908,11.607,5889,9.895,120585,45623,74962,6.678,17.652,87485,32920,54565,4.819,12.806,33100,4.845,25.613,4251,4329,22953
2000,7111,7572,7650,122251,119367,921,12.002,968,12.615,26331,6520,19811,5.462,22.059,20564,6131,14433,5.136,17.228,5767,4.831,34.455,657,660,4289
2000,7112,3261,3411,98162,96259,536,15.783,506,14.900,18100,3890,14210,4.041,18.804,14174,5155,9019,5.355,14.725,3926,4.079,29.450,365,365,2959
2000,7113,3469,3651,76680,71017,572,16.115,369,10.396,19112,5633,13479,7.932,26.912,7777,2256,5521,3.177,10.951,11335,15.961,21.902,263,263,1621
2000,7114,2463,2516,16000,15315,406,16.650,251,10.293,4215,1782,2433,11.636,27.523,2795,1217,1578,7.947,18.251,1420,9.272,36.501,184,184,750
2000,7115,9025,9046,39695,38873,1728,19.451,1404,15.804,14616,5688,8928,14.632,37.600,12959,4609,8350,11.857,33.337,1657,4.263,66.674,856,857,2586
2000,7121,5096,5494,108232,105741,339,6.214,262,4.802,12433,1924,10509,1.820,11.758,7446,1056,6390,0.999,7.042,4987,4.716,14.083,156,157,610
2000,7131,1627,2411,130276,124922,318,12.547,565,22.292,26191,4719,21472,3.778,20.966,16132,7112,9020,5.693,12.914,10059,8.052,25.827,234,427,6012
2000,7132,1652,2049,186888,176229,253,12.457,217,10.684,33994,11776,22218,6.682,19.290,11709,2830,8879,1.606,6.644,22285,12.646,13.288,161,162,1697
2000,7139,44724,49117,952322,925559,4817,9.832,4572,9.332,164896,47192,117704,5.099,17.816,111448,38064,73384,4.113,12.041,53448,5.775,24.082,3411,3434,26862
2000,7211,34479,44308,1713671,1697247,4648,10.577,3922,8.925,235092,103983,131109,6.127,13.851,202133,77398,124735,4.560,11.909,32959,1.942,23.819,2554,2608,37993
2000,7212,5025,5436,38518,37875,436,8.040,410,7.560,6655,1619,5036,4.275,17.571,5311,1620,3691,4.277,14.023,1344,3.549,28.045,286,290,1262
2000,7213,2771,2830,14813,14821,141,4.860,284,9.788,2346,515,1831,3.475,15.829,2372,930,1442,6.275,16.005,-26,-0.175,31.659,205,205,664
2000,7223,10645,24675,503485,489177,3413,14.090,2509,10.358,90653,39536,51117,8.082,18.532,61950,27450,34500,5.611,12.664,28703,5.868,25.328,1170,1194,8204
2000,7224,44742,45230,327267,327293,4899,10.707,5952,13.008,69576,32333,37243,9.879,21.258,69556,31466,38090,9.614,21.252,20,0.006,42.504,4614,4628,23631
2000,7225,262662,363111,7293995,7192954,40131,11.065,39286,10.832,1315221,602881,712340,8.382,18.285,1111811,421198,690613,5.856,15.457,203410,2.828,30.914,27214,28951,271527
2000,8111,138175,150307,868833,862929,14402,9.534,15909,10.532,153815,56467,97348,6.544,17.825,142115,61337,80778,7.108,16.469,11700,1.356,32.938,10889,11221,40932
2000,8112,12420,14315,146040,144366,1354,9.243,2021,13.797,28168,11587,16581,8.026,19.512,24523,10087,14436,6.987,16.987,3645,2.525,33.973,1461,1494,6117
2000,8113,20833,22412,197097,196170,1873,8.314,2107,9.352,31467,7870,23597,4.012,16.041,29408,8616,20792,4.392,14.991,2059,1.050,29.982,1555,1564,5819
2000,8114,23664,24783,139180,139753,2657,10.594,3250,12.959,20905,7397,13508,5.293,14.959,22242,11358,10884,8.127,15.915,-1337,-0.957,29.917,2379,2467,7764
2000,8121,73940,85291,501496,493471,10237,11.981,10545,12.341,97708,40595,57113,8.226,19.800,81801,37525,44276,7.604,16.577,15907,3.223,33.153,7709,8072,26607
2000,8122,14943,21297,162127,159150,1093,5.145,987,4.646,19469,6623,12846,4.161,12.233,13955,4403,9552,2.767,8.768,5514,3.465,17.537,658,685,3298
2000,8123,33002,39441,392169,392176,3487,8.748,4327,10.855,57641,19032,38609,4.853,14.698,57267,22098,35169,5.635,14.602,374,0.095,29.205,3150,3278,14799
2000,8129,19965,30740,230919,230638,5766,19.495,3441,11.634,53353,28344,25009,12.289,23.133,52922,17702,35220,7.675,22.946,431,0.187,45.892,2130,2159,8628
2000,8131,160538,160658,1564513,1536062,7891,4.940,6039,3.781,181304,27868,153436,1.814,11.803,124644,20868,103776,1.359,8.115,56660,3.689,16.229,3179,3179,9168
2000,8132,10616,12463,132722,128785,1121,9.107,813,6.605,21603,5144,16459,3.994,16.774,13601,5127,8474,3.981,10.561,8002,6.213,21.122,444,445,1572
2000,8133,8962,10745,105692,102941,1023,9.696,635,6.018,16135,3440,12695,3.342,15.674,10614,2829,7785,2.748,10.311,5521,5.363,20.622,383,384,1632
2000,8134,27552,29352,320328,315551,1262,4.282,1503,5.100,39165,5194,33971,1.646,12.412,29657,5823,23834,1.845,9.398,9508,3.013,18.797,952,952,3093
2000,8139,61972,63998,519908,513142,3206,4.994,3608,5.620,68725,12893,55832,2.513,13.393,55429,13080,42349,2.549,10.802,13296,2.591,21.604,2499,2511,8967
2001,1131,346,384,3032,3057,53,13.893,48,12.582,511,203,308,6.640,16.716,583,168,415,5.496,19.071,-72,-2.355,33.431,24,24,86
2001,1132,163,226,2056,1873,29,13.093,20,9.029,686,129,557,6.887,36.626,314,86,228,4.592,16.765,372,19.861,33.529,14,14,57
2001,1133,10662,10726,72144,75508,983,8.963,1466,13.367,10602,2934,7668,3.886,14.041,17352,5515,11837,7.304,22.980,-6750,-8.939,28.082,1074,1075,3885
2001,1141,1391,1402,7334,7684,226,16.114,227,16.185,1382,525,857,6.832,17.985,2009,843,1166,10.971,26.145,-627,-8.160,35.971,141,141,308
2001,1142,324,324,2603,2516,49,15.630,28,8.931,394,167,227,6.638,15.660,226,50,176,1.987,8.983,168,6.677,17.965,19,19,33
2001,1151,4182,4504,59346,60843,571,12.696,558,12.407,13234,4234,9000,6.959,21.751,15991,7928,8063,13.030,26.283,-2757,-4.531,43.502,362,362,4501
2001,1152,3518,3574,20808,20362,566,16.288,368,10.590,4072,1718,2354,8.437,19.999,3167,1071,2096,5.260,15.554,905,4.445,31.108,265,265,726
2001,1153,1282,1321,15345,15283,172,13.090,158,12.024,2659,585,2074,3.828,17.399,2558,564,1994,3.690,16.738,101,0.661,33.476,106,106,444
2001,2111,5688,6906,85116,82528,694,10.091,637,9.262,19141,7878,11263,9.546,23.193,13695,5867,7828,7.109,16.594,5446,6.599,33.189,365,372,2488
2001,2121,758,1128,70083,70329,128,11.164,165,14.392,11223,3899,7324,5.544,15.958,11902,4522,7380,6.430,16.923,-679,-0.965,31.916,99,100,1728
2001,2122,279,379,32299,33264,35,8.827,70,17.654,1724,455,1269,1.368,5.183,3656,358,3298,1.076,10.991,-1932,-5.808,10.366,49,53,195
2001,2123,3269,5261,98291,99909,430,8.202,393,7.496,10956,3152,7804,3.155,10.966,14215,3404,10811,3.407,14.228,-3259,-3.262,21.932,225,226,1804
2001,2131,6860,8135,195237,180752,1067,13.383,743,9.319,46783,10064,36719,5.568,25.882,18040,6998,11042,3.872,9.981,28743,15.902,19.961,486,506,3846
2001,2211,1577,9090,523573,526115,755,8.274,824,9.031,59837,29974,29863,5.697,11.373,65379,16341,49038,3.106,12.427,-5542,-1.053,22.747,73,87,1386
2001,2212,523,2481,89579,90165,241,9.575,313,12.435,16230,2784,13446,3.088,18.000,17451,5041,12410,5.591,19.355,-1221,-1.354,36.001,52,77,800
2001,2213,4516,5170,39789,39196,497,9.832,267,5.282,6043,3041,3002,7.759,15.418,4926,2116,2810,5.399,12.568,1117,2.850,25.136,176,177,1073
2001,2361,132868,133570,729002,728210,20020,15.072,18531,13.951,167481,63705,103776,8.748,22.999,165898,66292,99606,9.103,22.782,1583,0.217,45.563,12613,12618,46075
2001,2362,43362,44242,832542,827189,4173,9.426,4230,9.555,151856,29142,122714,3.523,18.358,140477,30102,110375,3.639,16.982,11379,1.376,33.965,2973,2978,20909
2001,2371,18645,19236,477831,467991,1963,10.372,1343,7.096,97918,18750,79168,4.006,20.923,79038,17720,61318,3.786,16.889,18880,4.034,33.778,955,955,11872
2001,2372,10158,10313,79215,79657,1733,16.849,1678,16.314,17100,6264,10836,7.864,21.467,17747,7244,10503,9.094,22.279,-647,-0.812,42.934,1242,1242,5034
2001,2373,10836,11331,305079,309213,851,7.497,890,7.841,49901,11324,38577,3.662,16.138,58024,12248,45776,3.961,18.765,-8123,-2.627,32.276,603,603,5659
2001,2379,4359,4483,69960,70196,554,12.242,639,14.120,15343,4027,11316,5.737,21.857,15903,4213,11690,6.002,22.655,-560,-0.798,43.715,497,497,2832
2001,2381,92169,92597,976741,975568,11356,12.291,10949,11.850,206826,54955,151871,5.633,21.201,204082,56573,147509,5.799,20.919,2744,0.281,41.839,7802,7804,41214
2001,2382,142291,145169,1822411,1805770,14643,10.120,13700,9.468,338066,80340,257726,4.449,18.721,304576,103600,200976,5.737,16.867,33490,1.855,33.734,9688,9695,61134
2001,2383,95663,96391,811670,805824,14162,14.797,12798,13.372,178766,52870,125896,6.561,22.184,167459,54478,112981,6.761,20.781,11307,1.403,41.562,9269,9285,38502
2001,2389,48005,48338,403371,410751,5761,11.829,6489,13.324,76937,23443,53494,5.707,18.731,91693,29862,61831,7.270,22.323,-14756,-3.592,37.462,4643,4646,21402
2001,3111,1104,1676,48308,49009,113,6.710,129,7.660,5336,1801,3535,3.675,10.888,6649,2029,4620,4.140,13.567,-1313,-2.679,21.776,58,58,412
2001,3112,487,844,58560,59606,36,4.220,54,6.331,3678,678,3000,1.137,6.171,5781,1062,4719,1.782,9.699,-2103,-3.528,12.341,29,30,347
2001,3113,1447,1624,84617,84125,139,8.639,109,6.774,8328,1878,6450,2.232,9.900,7280,1914,5366,2.275,8.654,1048,1.246,17.308,78,81,605
2001,3114,1257,1658,166111,167283,108,6.446,143,8.535,18366,4484,13882,2.680,10.979,20647,6943,13704,4.150,12.343,-2281,-1.364,21.958,94,96,1655
2001,3115,1127,1630,131214,131749,82,4.995,105,6.397,11230,2687,8543,2.039,8.524,12023,4446,7577,3.375,9.126,-793,-0.602,17.048,67,68,1378
2001,3116,3148,3779,492292,491770,234,6.121,322,8.423,35406,5454,29952,1.109,7.200,34085,7225,26860,1.469,6.931,1321,0.269,13.862,245,248,3791
2001,3117,610,723,39123,39803,54,7.312,85,11.510,4691,914,3777,2.296,11.786,6010,1797,4213,4.515,15.100,-1319,-3.314,23.571,62,62,1131
2001,3118,9042,9857,301469,300079,1004,10.171,1033,10.464,36670,9476,27194,3.158,12.220,34110,13102,21008,4.366,11.367,2560,0.853,22.734,789,798,7300
2001,3119,2290,2664,139114,142351,210,7.878,213,7.991,13879,2893,10986,2.032,9.750,20202,7367,12835,5.175,14.192,-6323,-4.442,19.500,143,145,2411
2001,3121,2192,2665,143447,141949,252,9.513,220,8.305,17739,3994,13745,2.814,12.497,14786,5223,9563,3.680,10.416,2953,2.080,20.833,150,152,2137
2001,3122,95,124,23114,25180,24,20.779,7,6.061,747,189,558,0.751,2.967,4856,431,4425,1.712,19.286,-4109,-16.319,5.933,4,4,48
2001,3131,364,580,69053,74405,51,8.688,65,11.073,5044,2352,2692,3.161,6.779,15907,5910,9997,7.943,21.379,-10863,-14.600,13.558,26,29,714
2001,3132,1549,1844,166103,174173,110,5.857,178,9.478,9657,1942,7715,1.115,5.544,25900,6313,19587,3.625,14.870,-16243,-9.326,11.089,127,128,1454
2001,3133,2174,2379,83134,86649,153,6.098,413,16.461,7065,1975,5090,2.279,8.154,14115,5161,8954,5.956,16.290,-7050,-8.136,16.307,308,325,3173
2001,3141,2555,2792,112521,116638,203,7.168,283,9.993,7907,2018,5889,1.730,6.779,16035,4699,11336,4.029,13.748,-8128,-6.969,13.558,217,219,1872
2001,3149,4339,4480,94790,98823,451,10.011,501,11.121,11129,4323,6806,4.375,11.262,19258,7550,11708,7.640,19.487,-8129,-8.226,22.523,399,399,5424
2001,3151,857,934,67758,72466,64,6.598,136,14.021,5042,1098,3944,1.515,6.958,14319,4366,9953,6.025,19.760,-9277,-12.802,13.916,108,109,1791
2001,3152,9167,9592,311602,336891,1446,14.709,1923,19.562,40827,17728,23099,5.262,12.119,91088,42691,48397,12.672,27.038,-50261,-14.919,24.238,1524,1541,24943
2001,3159,1576,1631,40907,43390,122,7.143,276,16.159,4366,1148,3218,2.646,10.062,9220,4129,5091,9.516,21.249,-4854,-11.187,20.125,206,219,1780
2001,3161,269,283,11320,12671,18,6.218,31,10.708,499,139,360,1.097,3.938,3139,1223,1916,9.652,24.774,-2640,-20.836,7.877,17,21,954
2001,3162,312,347,24966,26427,34,9.827,32,9.249,2254,303,1951,1.147,8.529,5076,2045,3031,7.738,19.208,-2822,-10.678,17.058,22,22,504
2001,3169,892,915,21462,22526,92,10.033,96,10.469,2539,971,1568,4.311,11.272,4682,977,3705,4.337,20.785,-2143,-9.514,22.543,78,78,780
2001,3211,3870,4342,123788,128944,262,5.945,392,8.895,8861,2362,6499,1.832,6.872,19041,5641,13400,4.375,14.767,-10180,-7.895,13.744,285,291,3264
2001,3212,1468,1861,117264,120189,104,5.591,102,5.484,8405,2493,5912,2.074,6.993,14268,4122,10146,3.430,11.871,-5863,-4.878,13.986,66,66,1693
2001,3219,9305,10107,319066,333057,922,9.099,974,9.612,33432,12235,21197,3.674,10.038,61618,18417,43201,5.530,18.501,-28186,-8.463,20.076,688,699,9946
2001,3221,266,545,160024,163996,23,4.209,26,4.758,4774,1954,2820,1.191,2.911,12731,5471,7260,3.336,7.763,-7957,-4.852,5.822,9,9,316
2001,3222,3344,5054,378129,386257,187,3.663,289,5.661,24913,4856,20057,1.257,6.450,41305,16067,25238,4.160,10.694,-16392,-4.244,12.900,151,164,4448
2001,3231,34221,36007,782167,795013,2079,5.697,3048,8.353,66779,16449,50330,2.069,8.400,92582,29539,63043,3.716,11.645,-25803,-3.246,16.799,2423,2432,19428
2001,3241,1035,2149,101017,103440,187,8.761,158,7.402,8295,3726,4569,3.602,8.019,13135,3718,9417,3.594,12.698,-4840,-4.679,16.038,58,60,859
2001,3251,1115,2280,185910,191534,94,4.050,176,7.583,9515,2313,7202,1.208,4.968,20397,7100,13297,3.707,10.649,-10882,-5.681,9.936,50,50,1114
2001,3252,486,810,111856,114995,47,5.763,58,7.112,5182,1786,3396,1.553,4.506,11472,2299,9173,1.999,9.976,-6290,-5.470,9.013,34,34,564
2001,3253,649,872,34288,35019,75,8.537,88,10.017,3573,1023,2550,2.921,10.203,5023,2278,2745,6.505,14.344,-1450,-4.141,20.406,55,56,883
2001,3254,1378,1731,230607,226971,131,7.596,118,6.843,24634,5105,19529,2.249,10.853,17129,3902,13227,1.719,7.547,7505,3.307,15.094,76,77,1146
2001,3255,1578,2016,72402,74080,107,5.283,126,6.221,6272,1644,4628,2.219,8.467,9689,2341,7348,3.160,13.079,-3417,-4.613,16.933,67,67,509
2001,3256,2020,2264,121465,123010,164,7.217,181,7.965,14206,5394,8812,4.385,11.549,16653,6653,10000,5.409,13.538,-2447,-1.989,23.097,122,124,1289
2001,3259,2138,2791,121307,120831,177,6.308,207,7.377,13551,3923,9628,3.247,11.215,12746,4427,8319,3.664,10.549,805,0.666,21.097,128,129,1556
2001,3261,10155,12741,794749,815415,647,5.037,853,6.641,68248,18784,49464,2.304,8.370,109613,29899,79714,3.667,13.443,-41365,-5.073,16.739,556,565,11868
2001,3262,1908,2497,194086,199961,110,4.338,187,7.375,11142,2858,8284,1.429,5.572,22806,5619,17187,2.810,11.405,-11664,-5.833,11.144,116,118,2350
2001,3271,1424,1663,72731,74222,132,7.811,186,11.006,8632,4025,4607,5.423,11.630,11307,5153,6154,6.943,15.234,-2675,-3.604,23.260,135,142,3435
2001,3272,1891,2192,128338,129768,168,7.642,181,8.233,7691,1437,6254,1.107,5.927,10395,2270,8125,1.749,8.010,-2704,-2.084,11.854,119,119,782
2001,3273,5269,9109,219046,218489,592,6.500,589,6.467,29333,7911,21422,3.621,13.425,28184,8131,20053,3.721,12.900,1149,0.526,25.799,296,315,3735
2001,3274,240,381,19694,20284,29,7.612,29,7.612,1588,642,946,3.165,7.829,2721,703,2018,3.466,13.415,-1133,-5.586,15.658,19,19,103
2001,3279,2255,2664,77861,77314,257,9.826,160,6.117,8835,2270,6565,2.936,11.427,7728,2129,5599,2.754,9.996,1107,1.432,19.991,111,113,1472
2001,3311,448,550,141817,143451,98,18.352,66,12.360,7817,3123,4694,2.177,5.449,11115,2366,8749,1.649,7.748,-3298,-2.299,10.899,48,48,1805
2001,3312,588,792,62919,64500,72,9.190,55,7.020,4938,1898,3040,2.943,7.656,7893,2089,5804,3.239,12.237,-2955,-4.581,15.312,29,30,660
2001,3313,417,582,79374,82638,47,8.188,31,5.401,3866,1539,2327,1.862,4.678,10522,2964,7558,3.587,12.733,-6656,-8.054,9.356,12,12,200
2001,3314,712,904,75569,76324,62,6.802,77,8.448,5949,831,5118,1.089,7.794,7461,1906,5555,2.497,9.775,-1512,-1.981,15.589,46,49,785
2001,3315,2269,2590,205478,213513,103,3.931,163,6.221,12794,2514,10280,1.177,5.992,28932,5100,23832,2.389,13.550,-16138,-7.558,11.984,118,121,2282
2001,3321,2576,2808,143896,146485,89,3.120,179,6.274,14186,3641,10545,2.486,9.684,19310,6938,12372,4.736,13.182,-5124,-3.498,19.369,115,123,3999
2001,3322,1394,1543,73398,76866,64,4.073,121,7.700,4061,722,3339,0.939,5.283,11062,3455,7607,4.495,14.391,-7001,-9.108,10.566,87,87,580
2001,3323,11706,12688,425126,425886,908,7.203,744,5.902,51472,15395,36077,3.615,12.086,53207,16223,36984,3.809,12.493,-1735,-0.407,24.172,512,517,7952
2001,3324,1340,1671,97830,99782,47,2.759,112,6.575,7485,1199,6286,1.202,7.501,11416,2265,9151,2.270,11.441,-3931,-3.940,15.003,76,77,1106
2001,3325,748,833,62410,65099,32,3.791,54,6.398,3103,762,2341,1.171,4.767,8488,1233,7255,1.894,13.039,-5385,-8.272,9.533,36,37,549
2001,3326,1632,1812,69501,70566,109,5.996,121,6.656,6177,1184,4993,1.678,8.754,8210,1993,6217,2.824,11.634,-2033,-2.881,17.507,86,88,979
2001,3327,25167,25648,427531,429471,1699,6.629,1662,6.485,48234,10518,37716,2.449,11.231,52154,13191,38963,3.071,12.144,-3920,-0.913,22.462,1279,1282,8820
2001,3328,5455,6045,153546,155266,359,5.914,410,6.754,16435,4581,11854,2.950,10.585,19895,5155,14740,3.320,12.814,-3460,-2.228,21.170,304,304,3207
2001,3329,5652,6223,304159,308518,462,7.384,530,8.471,26093,7774,18319,2.520,8.458,34981,11128,23853,3.607,11.338,-8888,-2.881,16.915,388,390,5221
2001,3331,2537,2861,193825,196249,167,5.798,206,7.152,16387,2515,13872,1.282,8.350,21322,4883,16439,2.488,10.865,-4935,-2.515,16.700,144,145,2233
2001,3332,3957,4200,175212,179702,273,6.438,354,8.348,20263,4981,15282,2.772,11.276,28716,7707,21009,4.289,15.980,-8453,-4.704,22.552,249,251,3825
2001,3333,2164,2338,127809,130150,124,5.210,208,8.739,16473,2321,14152,1.783,12.657,21277,8308,12969,6.383,16.348,-4804,-3.691,25.314,138,138,1879
2001,3334,1421,1748,179119,179741,90,5.130,103,5.871,15573,2321,13252,1.291,8.664,16848,3513,13335,1.954,9.373,-1275,-0.709,17.328,75,75,1197
2001,3335,9094,9487,222488,228678,436,4.553,616,6.432,16693,3678,13015,1.608,7.300,28958,6730,22228,2.943,12.663,-12265,-5.363,14.600,459,460,3499
2001,3336,733,899,103641,107453,44,4.875,51,5.651,6856,1572,5284,1.463,6.380,14588,3100,11488,2.885,13.576,-7732,-7.196,12.761,33,33,260
2001,3339,5711,6402,336097,339916,340,5.259,467,7.223,32397,10353,22044,3.046,9.531,40146,11470,28676,3.374,11.811,-7749,-2.280,19.062,320,323,3321
2001,3341,1511,1611,187775,191317,178,10.821,246,14.954,33856,16931,16925,8.850,17.696,41231,26042,15189,13.612,21.551,-7375,-3.855,35.393,178,178,2622
2001,3342,1804,2026,246864,236804,214,10.573,210,10.375,49122,10169,38953,4.294,20.744,28370,13215,15155,5.581,11.980,20752,8.763,23.961,124,127,2867
2001,3343,517,542,28954,29933,63,11.699,56,10.399,2224,523,1701,1.747,7.430,4253,1010,3243,3.374,14.208,-2029,-6.778,14.860,42,42,548
2001,3344,4847,5576,594437,579702,450,8.037,496,8.859,91212,21958,69254,3.788,15.734,62357,21514,40843,3.711,10.757,28855,4.978,21.513,335,336,7657
2001,3345,4416,5086,472211,476831,362,7.115,366,7.193,48939,17084,31855,3.583,10.263,58547,25298,33249,5.305,12.278,-9608,-2.015,20.527,207,207,3381
2001,3346,791,862,38584,40269,121,14.152,107,12.515,5070,1567,3503,3.891,12.590,8136,3643,4493,9.047,20.204,-3066,-7.614,25.181,70,71,689
2001,3351,1109,1219,72559,73493,61,4.927,99,7.997,5346,1742,3604,2.370,7.274,7345,1316,6029,1.791,9.994,-1999,-2.720,14.548,78,78,1040
2001,3352,248,315,96143,99739,28,8.819,33,10.394,4546,871,3675,0.873,4.558,11612,2228,9384,2.234,11.642,-7066,-7.084,9.116,21,21,216
2001,3353,2226,2654,193193,195513,141,5.240,215,7.990,17102,3931,13171,2.011,8.747,21642,5462,16180,2.794,11.069,-4540,-2.322,17.494,146,146,1319
2001,3359,1812,2217,204887,204682,152,6.804,186,8.326,19795,4079,15716,1.993,9.671,19234,4264,14970,2.083,9.397,561,0.274,18.794,127,128,2065
2001,3361,281,345,204562,214718,37,10.694,39,11.272,4865,910,3955,0.424,2.266,25185,792,24393,0.369,11.729,-20320,-9.464,4.532,27,27,301
2001,3362,1759,1992,134597,144161,154,7.713,163,8.164,11071,4749,6322,3.294,7.680,30093,4247,25846,2.946,20.875,-19022,-13.195,15.359,111,113,1712
2001,3363,4309,5467,759877,793686,303,5.493,402,7.287,48638,11201,37437,1.411,6.128,116043,16779,99264,2.114,14.621,-67405,-8.493,12.256,272,279,7611
2001,3364,1357,1675,408181,412866,104,6.141,141,8.326,23458,1811,21647,0.439,5.682,33014,16627,16387,4.027,7.996,-9556,-2.315,11.363,99,99,1253
2001,3365,143,205,26278,27881,15,7.160,24,11.456,1690,824,866,2.955,6.062,4929,1486,3443,5.330,17.679,-3239,-11.617,12.123,13,13,408
2001,3366,1539,1662,137762,142237,164,9.885,158,9.524,8938,2269,6669,1.595,6.284,17730,2409,15321,1.694,12.465,-8792,-6.181,12.568,111,111,953
2001,3369,679,705,38493,38582,81,11.530,76,10.819,4875,1085,3790,2.812,12.636,5034,748,4286,1.939,13.048,-159,-0.412,25.271,59,59,430
2001,3371,13959,14450,399043,408102,1466,10.187,1347,9.360,37186,9936,27250,2.435,9.112,55029,17679,37350,4.332,13.484,-17843,-4.372,18.224,985,991,10808
2001,3372,3999,4226,183842,187742,241,5.651,319,7.479,14998,2666,12332,1.420,7.989,22616,6284,16332,3.347,12.046,-7618,-4.058,15.977,229,232,3198
2001,3379,941,1068,47020,47825,61,5.672,76,7.066,3325,531,2794,1.110,6.952,4929,1089,3840,2.277,10.306,-1604,-3.354,13.905,60,61,733
2001,3391,10669,11321,291158,291087,835,7.358,888,7.826,31868,6915,24953,2.376,10.948,31709,12115,19594,4.162,10.893,159,0.055,21.787,664,666,5635
2001,3399,16923,17485,412947,421533,1618,9.224,1731,9.868,43347,10876,32471,2.580,10.283,60082,16838,43244,3.994,14.253,-16735,-3.970,20.566,1314,1320,10048
2001,4231,16130,20854,303735,307070,2220,10.603,2388,11.405,43518,19164,24354,6.241,14.172,50097,20869,29228,6.796,16.315,-6579,-2.143,28.344,1578,1689,11439
2001,4232,10017,11304,155329,155305,1211,10.750,1133,10.058,22554,6553,16001,4.219,14.522,22400,8612,13788,5.545,14.423,154,0.099,28.847,816,839,4158
2001,4233,9221,12709,170737,169841,1752,14.048,1277,10.239,30146,14006,16140,8.247,17.750,28053,9215,18838,5.426,16.517,2093,1.232,33.035,672,906,5745
2001,4234,27561,35529,733080,725680,3974,11.039,4917,13.658,157671,62279,95392,8.582,21.727,143020,71361,71659,9.834,19.708,14651,2.019,39.417,2838,3115,28894
2001,4235,7581,10297,161187,164311,694,6.716,767,7.422,16269,4382,11887,2.667,9.901,22587,7395,15192,4.501,13.747,-6318,-3.845,19.803,457,486,2937
2001,4236,19626,30113,507567,494581,3739,12.453,3563,11.867,115640,49116,66524,9.931,23.381,89643,37807,51836,7.644,18.125,25997,5.256,36.250,1695,1816,13640
2001,4237,10738,16532,210047,211777,1275,7.699,1331,8.037,27228,9476,17752,4.475,12.857,30836,9792,21044,4.624,14.561,-3608,-1.704,25.714,723,771,4309
2001,4238,47156,63494,760384,763964,4404,6.898,5107,7.999,94736,27239,67497,3.565,12.401,102198,37914,64284,4.963,13.377,-7462,-0.977,24.801,3178,3408,19866
2001,4239,28635,31018,324973,324686,3610,11.647,3565,11.502,53252,16668,36584,5.134,16.401,53046,19352,33694,5.960,16.338,206,0.063,32.675,2690,2728,14059
2001,4241,9380,12298,219448,221302,861,6.950,1042,8.411,25913,6521,19392,2.947,11.709,29440,11019,18421,4.979,13.303,-3527,-1.594,23.419,628,636,3420
2001,4242,5010,6400,220535,208524,760,11.925,706,11.078,51000,15484,35516,7.426,24.458,25908,11641,14267,5.583,12.424,25092,12.033,24.849,466,481,4043
2001,4243,13460,14536,185504,186672,1858,12.827,1756,12.123,30556,11161,19395,5.979,16.369,32545,9718,22827,5.206,17.434,-1989,-1.066,32.738,1338,1348,6206
2001,4244,26298,32095,779250,782636,3066,9.511,3351,10.395,98876,29159,69717,3.726,12.634,105315,40599,64716,5.187,13.456,-6439,-0.823,25.267,2344,2440,20953
2001,4245,4664,7329,66509,67838,407,5.440,713,9.530,9258,3081,6177,4.542,13.647,11843,4697,7146,6.924,17.458,-2585,-3.811,27.294,370,407,2121
2001,4246,9409,14375,160300,160620,1933,13.817,1163,8.313,25253,11493,13760,7.155,15.722,25911,8525,17386,5.308,16.132,-658,-0.410,31.444,599,629,2885
2001,4247,6645,9686,124046,125221,576,5.874,815,8.312,19549,7167,12382,5.724,15.612,21335,7217,14118,5.763,17.038,-1786,-1.426,31.223,373,386,2551
2001,4248,3105,3944,156465,155015,302,7.604,357,8.989,16266,3995,12271,2.577,10.493,13165,6695,6470,4.319,8.493,3101,2.000,16.986,230,243,3517
2001,4249,22821,27387,380522,380329,3436,12.518,3557,12.959,64058,23997,40061,6.310,16.843,63436,24681,38755,6.489,16.679,622,0.164,33.358,2336,2401,13291
2001,4251,32962,35102,274573,282167,2740,7.757,3183,9.011,42150,15959,26191,5.656,14.938,56945,19131,37814,6.780,20.181,-14795,-5.243,29.876,2009,2041,9115
2001,4411,43108,46772,1218816,1219181,4329,9.254,4341,9.280,127138,43092,84046,3.535,10.428,127938,44199,83739,3.625,10.494,-800,-0.066,20.856,3331,3382,32034
2001,4412,12425,13461,129858,128048,1340,10.016,1175,8.783,21598,7097,14501,5.542,16.867,18127,6526,11601,5.097,14.156,3471,2.711,28.313,870,901,5036
2001,4413,34921,59093,517887,532194,3659,6.163,4214,7.098,58664,20978,37686,3.942,11.023,88022,26482,61540,4.976,16.539,-29358,-5.516,22.046,2446,2740,14049
2001,4421,19757,27597,277540,282715,2530,9.118,2829,10.196,40425,13868,26557,4.905,14.299,49722,19808,29914,7.006,17.587,-9297,-3.288,28.598,1586,1908,9251
2001,4422,25278,33526,294525,283514,3377,10.109,3138,9.393,59698,21729,37969,7.664,21.056,38746,14112,24634,4.978,13.666,20952,7.390,27.333,1925,2049,8112
2001,4431,32214,50533,489601,489737,5394,10.662,5508,10.888,83194,33633,49561,6.868,16.988,83766,29779,53987,6.081,17.104,-572,-0.117,33.975,3851,4017,19740
2001,4441,48363,70225,1088389,1093605,4473,6.361,4653,6.617,142560,77894,64666,7.123,13.036,155516,39029,116487,3.569,14.220,-12956,-1.185,26.072,3063,3250,20466
2001,4442,17510,21434,194730,198058,1433,6.645,1692,7.847,25469,8185,17284,4.133,12.859,32139,10640,21499,5.372,16.227,-6670,-3.368,25.719,1077,1124,5728
2001,4451,59780,86977,2627915,2663431,8727,9.977,9723,11.115,303967,126995,176972,4.768,11.413,376726,147967,228759,5.556,14.144,-72759,-2.732,22.825,6207,6340,45001
2001,4452,17288,21697,148419,147867,2799,12.836,3016,13.831,30568,12249,18319,8.284,20.673,29892,13605,16287,9.201,20.215,676,0.457,40.431,2020,2142,9485
2001,4453,22902,26036,135551,134922,2122,8.129,2258,8.650,20680,6763,13917,5.013,15.327,19314,7438,11876,5.513,14.315,1366,1.012,28.630,1677,1693,5625
2001,4461,39719,77436,947237,928524,5529,7.129,5773,7.443,141442,37026,104416,3.988,15.233,104829,37457,67372,4.034,11.290,36613,3.943,22.580,3200,3454,18223
2001,4471,60324,112717,930009,934753,8492,7.496,9618,8.490,151832,55240,96592,5.910,16.243,161441,53118,108323,5.683,17.271,-9609,-1.028,32.486,5687,6222,32465
2001,4481,36141,83966,1019792,1013344,8918,10.619,8948,10.655,187335,78776,108559,7.774,18.487,175737,62687,113050,6.186,17.342,11598,1.145,34.685,3955,4726,21336
2001,4482,6224,26938,191646,193374,2062,7.448,3554,12.838,36762,14306,22456,7.398,19.011,40377,20655,19722,10.681,20.880,-3615,-1.869,38.022,612,1917,9923
2001,4483,18991,29343,172562,171909,2683,9.137,2725,9.280,27550,11742,15808,6.830,16.026,26046,9583,16463,5.574,15.151,1504,0.875,30.302,1394,1528,4547
2001,4511,28977,39714,413512,403647,3638,9.084,4305,10.750,79365,27777,51588,6.882,19.662,60290,25607,34683,6.344,14.936,19075,4.726,29.873,2928,3096,15132
2001,4512,6950,12668,141661,146078,988,7.727,1226,9.588,18904,7417,11487,5.077,12.941,26941,6497,20444,4.448,18.443,-8037,-5.502,25.882,760,782,3112
2001,4522,58,5609,953324,982329,177,3.114,326,5.736,59662,17330,42332,1.764,6.074,117062,38526,78536,3.922,11.917,-57400,-5.843,12.147,5,5,174
2001,4523,8892,32366,1608957,1580229,2791,8.727,2019,6.313,181137,79758,101379,5.047,11.463,124220,37456,86764,2.370,7.861,56917,3.602,15.722,1081,1105,4458
2001,4531,20720,21753,124045,123911,1822,8.269,2386,10.828,20783,5984,14799,4.829,16.773,20599,7990,12609,6.448,16.624,184,0.148,33.248,1885,1915,6081
2001,4532,28974,40761,345546,353091,4228,10.344,4453,10.895,50572,23035,27537,6.524,14.323,65656,23538,42118,6.666,18.595,-15084,-4.272,28.645,3114,3271,13307
2001,4533,12437,16254,115741,115318,1635,10.007,1804,11.041,17387,6448,10939,5.591,15.077,16677,5722,10955,4.962,14.462,710,0.616,28.923,1391,1427,3933
2001,4539,30832,38787,246943,250041,4629,11.864,5088,13.041,45786,17180,28606,6.871,18.311,51597,20951,30646,8.379,20.635,-5811,-2.324,36.623,3496,3636,13909
2001,4541,10470,11395,268344,270127,2136,19.108,1703,15.235,55167,20452,34715,7.571,20.423,59428,21207,38221,7.851,22.000,-4261,-1.577,40.845,1263,1296,11477
2001,4542,4853,5457,64011,65370,566,10.295,648,11.786,6872,3102,3770,4.745,10.513,9637,4127,5510,6.313,14.742,-2765,-4.230,21.025,524,525,2204
2001,4543,19453,25516,230838,229553,2886,11.355,2684,10.561,37614,12720,24894,5.541,16.386,34704,13149,21555,5.728,15.118,2910,1.268,30.236,1728,1764,7397
2001,4811,623,3120,521768,522427,324,10.401,314,10.080,49847,6649,43198,1.273,9.541,52884,8160,44724,1.562,10.123,-3037,-0.581,19.083,78,86,950
2001,4812,1713,1866,36246,35783,283,15.389,229,12.452,5954,1858,4096,5.192,16.639,5115,1265,3850,3.535,14.294,839,2.345,28.589,169,173,986
2001,4831,764,1167,52374,52438,138,11.815,140,11.986,8862,3187,5675,6.078,16.900,8928,2565,6363,4.892,17.026,-66,-0.126,33.800,77,86,1700
2001,4832,481,528,19332,19281,52,9.811,56,10.566,3471,1205,2266,6.250,18.003,3513,1284,2229,6.660,18.220,-42,-0.218,36.005,38,38,396
2001,4841,39383,48655,982109,985617,8758,18.135,8034,16.636,154014,59068,94946,5.993,15.626,160257,70692,89565,7.172,16.260,-6243,-0.633,31.252,5782,6088,42961
2001,4842,45383,48835,492963,499627,5808,11.782,6732,13.656,79684,25636,54048,5.131,15.949,93114,33684,59430,6.742,18.637,-13430,-2.688,31.897,5037,5068,21239
2001,4851,492,717,41310,41640,104,14.617,93,13.071,4769,2112,2657,5.072,11.453,5494,3290,2204,7.901,13.194,-725,-1.741,22.906,39,50,1059
2001,4852,203,399,20237,20776,58,14.910,38,9.769,2804,850,1954,4.091,13.496,3904,623,3281,2.999,18.791,-1100,-5.295,26.993,22,25,236
2001,4853,5903,6018,69426,68891,955,15.981,871,14.575,12307,4892,7415,7.101,17.865,11184,4893,6291,7.103,16.234,1123,1.630,32.469,687,688,3841
2001,4854,3060,4222,169161,165624,324,7.721,273,6.505,22127,8571,13556,5.175,13.360,14712,4131,10581,2.494,8.883,7415,4.477,17.766,195,195,2053
2001,4855,1155,1297,33549,33361,110,8.397,136,10.382,4907,1495,3412,4.481,14.709,4598,1098,3500,3.291,13.783,309,0.926,27.565,101,105,847
2001,4859,2276,2475,53264,52710,394,16.055,352,14.344,10088,4028,6060,7.642,19.139,8901,3502,5399,6.644,16.887,1187,2.252,33.774,265,265,1813
2001,4861,42,241,6373,6494,27,9.872,92,33.638,891,283,608,4.358,13.721,1159,686,473,10.564,17.849,-268,-4.127,27.443,0,0,0
2001,4862,129,2067,35098,35784,203,9.963,144,7.067,4544,1842,2702,5.148,12.698,6033,2333,3700,6.520,16.859,-1489,-4.161,25.397,5,5,46
2001,4869,55,466,5931,6232,49,10.000,97,19.796,916,286,630,4.590,14.700,1530,749,781,12.020,24.553,-614,-9.853,29.399,4,4,7
2001,4871,392,432,8648,8533,71,16.825,51,12.085,1206,416,790,4.875,14.134,983,395,588,4.629,11.521,223,2.614,23.041,30,30,193
2001,4872,1211,1243,13100,12812,172,13.978,147,11.946,2457,593,1864,4.628,19.177,1887,654,1233,5.105,14.728,570,4.449,29.457,120,120,478
2001,4879,132,136,1951,2006,12,8.511,22,15.603,164,16,148,0.798,8.178,278,123,155,6.133,13.862,-114,-5.684,16.355,16,16,97
2001,4881,3200,4183,132328,131230,511,12.272,473,11.359,23619,8294,15325,6.320,17.998,21347,10124,11223,7.715,16.267,2272,1.731,32.534,284,289,2067
2001,4882,427,786,22541,22815,74,9.343,86,10.859,4085,1517,2568,6.649,17.905,4602,1685,2917,7.386,20.171,-517,-2.266,35.811,35,46,657
2001,4883,1703,2204,78667,79051,203,9.113,250,11.223,12107,3133,8974,3.963,15.316,12943,2861,10082,3.619,16.373,-836,-1.058,30.631,136,140,689
2001,4884,6183,6507,58245,56463,942,14.648,790,12.284,13177,4822,8355,8.540,23.337,9628,4451,5177,7.883,17.052,3549,6.286,34.104,587,589,2496
2001,4885,11062,15000,171494,169123,1836,12.386,1483,10.004,34513,13272,21241,7.848,20.407,29695,10481,19214,6.197,17.558,4818,2.849,35.116,922,999,5980
2001,4889,998,1102,25954,25492,190,17.399,170,15.568,4213,1371,2842,5.378,16.527,3243,811,2432,3.181,12.722,970,3.805,25.444,140,140,588
2001,4921,2547,6679,517197,534253,1114,17.168,734,11.311,32301,12926,19375,2.419,6.046,66020,8843,57177,1.655,12.357,-33719,-6.311,12.092,335,340,2274
2001,4922,4351,4787,60944,64770,703,14.635,736,15.322,9408,3635,5773,5.612,14.525,17052,5446,11606,8.408,26.327,-7644,-11.802,29.051,584,605,4678
2001,4931,6835,12620,576647,569897,1449,11.438,1545,12.196,116842,46853,69989,8.221,20.502,102672,43082,59590,7.560,18.016,14170,2.486,36.032,374,637,7217
2001,5111,15110,19491,689876,690898,2113,10.873,1997,10.276,85703,33647,52056,4.870,12.405,87346,39404,47942,5.703,12.642,-1643,-0.238,24.809,1342,1376,13074
2001,5112,7456,10067,366539,352883,1494,14.824,1517,15.052,93126,32087,61039,9.093,26.390,66976,31772,35204,9.004,18.980,26150,7.410,37.959,911,979,15852
2001,5121,12171,15853,265210,269031,2114,13.180,2487,15.505,55930,16915,39015,6.287,20.789,62649,23516,39133,8.741,23.287,-6719,-2.497,41.579,1236,1288,7069
2001,5122,2572,2766,22229,22808,379,13.705,378,13.668,3661,1266,2395,5.551,16.052,4843,1668,3175,7.313,21.234,-1182,-5.183,32.103,281,282,986
2001,5151,4832,8358,256190,251704,2042,25.607,1275,15.988,61260,39554,21706,15.715,24.338,49861,34899,14962,13.865,19.809,11399,4.529,39.619,622,667,7901
2001,5152,311,586,33702,33798,109,18.924,89,15.451,7252,3951,3301,11.690,21.457,7730,2520,5210,7.456,22.872,-478,-1.414,42.914,40,45,1487
2001,5173,7767,43875,1470159,1423137,10152,24.314,5911,14.157,328753,177644,151109,12.483,23.101,240687,110353,130334,7.754,16.912,88066,6.188,33.825,1230,1590,25542
2001,5174,425,653,20464,20795,107,16.474,100,15.396,5113,1818,3295,8.743,24.588,5802,2296,3506,11.041,27.902,-689,-3.313,49.176,57,58,608
2001,5179,6325,7615,130450,132798,1875,24.269,2097,27.142,41229,16391,24838,12.343,31.047,45280,24227,21053,18.244,34.097,-4051,-3.051,62.093,1661,1702,18873
2001,5182,5984,10816,414698,399752,2519,24.674,1305,12.783,99822,40959,58863,10.246,24.971,70519,27146,43373,6.791,17.641,29303,7.330,35.281,464,472,6785
2001,5191,3879,4725,89298,84355,805,17.933,333,7.418,21901,9466,12435,11.222,25.963,12087,4182,7905,4.958,14.329,9814,11.634,28.658,226,243,2455
2001,5211,15,52,22282,22443,D,D,D,D,346,D,321,D,1.542,656,D,570,D,2.923,-310,-1.381,3.083,0,0,0
2001,5221,17865,107548,2049633,2014298,11183,10.443,10249,9.571,434782,186782,248000,9.273,21.585,355646,171482,184164,8.513,17.656,79136,3.929,35.312,660,1139,15631
2001,5222,17667,44869,626996,625446,6746,14.925,7407,16.387,158589,70927,87662,11.340,25.356,154428,72203,82225,11.544,24.691,4161,0.665,49.382,2015,2312,15968
2001,5223,15350,23042,226509,218758,5214,23.758,3022,13.770,63949,28014,35935,12.806,29.233,48443,21455,26988,9.808,22.145,15506,7.088,44.289,1580,1738,10427
2001,5231,12084,37635,559136,551908,5541,14.823,5031,13.459,123392,60111,63281,10.891,22.357,106081,51578,54503,9.345,19.221,17311,3.137,38.442,1029,1159,11727
2001,5232,30,41,6294,6433,9,19.355,20,43.011,206,73,133,1.135,3.202,496,45,451,0.700,7.711,-290,-4.508,6.405,16,16,35
2001,5239,27164,30387,346527,333149,5597,18.878,4121,13.899,87124,35002,52122,10.506,26.152,59300,24269,35031,7.285,17.800,27824,8.352,35.600,2437,2463,10929
2001,5241,5205,29686,1507820,1506083,4942,14.951,11679,35.333,259580,104048,155532,6.909,17.235,251929,113969,137960,7.567,16.727,7651,0.508,33.455,375,397,4835
2001,5242,113079,124747,833697,829740,12742,10.242,12076,9.706,144694,60331,84363,7.271,17.438,136137,59255,76882,7.141,16.407,8557,1.031,32.814,8221,8459,31783
2001,5259,626,673,5476,5437,209,33.254,120,19.093,1513,883,630,16.241,27.828,1442,954,488,17.546,26.522,71,1.306,53.044,79,79,555
2001,5311,86038,100268,535104,531666,10649,10.656,9982,9.989,98954,45567,53387,8.571,18.612,92281,40169,52112,7.555,17.357,6673,1.255,34.714,7505,7685,27424
2001,5312,51544,58131,280351,277774,8639,15.068,7041,12.281,64942,29966,34976,10.788,23.379,59242,26004,33238,9.362,21.327,5700,2.052,42.655,4418,4582,13260
2001,5313,46397,52988,504003,503433,7211,13.655,6850,12.972,88513,36770,51743,7.304,17.582,88162,38018,50144,7.552,17.512,351,0.070,35.024,3575,3664,17343
2001,5321,4451,10898,183164,180948,1896,17.815,1386,13.023,35281,16746,18535,9.255,19.498,30100,11686,18414,6.458,16.635,5181,2.863,33.269,484,692,6058
2001,5322,13844,29916,250888,251516,2673,8.811,3517,11.593,43568,15425,28143,6.133,17.322,45506,18793,26713,7.472,18.093,-1938,-0.771,34.644,1997,2165,9409
2001,5323,3366,5856,39056,39284,442,7.568,411,7.037,5268,1872,3396,4.765,13.410,5651,2119,3532,5.394,14.385,-383,-0.975,26.820,256,285,1465
2001,5324,7115,11823,163172,161744,1595,13.677,1272,10.908,33721,12605,21116,7.793,20.848,30806,13108,17698,8.104,19.046,2915,1.802,38.092,703,735,5118
2001,5331,1739,1858,21881,21684,224,11.979,248,13.262,4638,1799,2839,8.297,21.390,4239,2141,2098,9.874,19.549,399,1.840,39.099,165,169,904
2001,5411,153949,161589,1112871,1103174,13582,8.394,14006,8.656,147309,44360,102949,4.021,13.353,127598,47031,80567,4.263,11.566,19711,1.787,23.133,9908,10082,32662
2001,5412,86371,93672,1183423,1160551,9363,10.034,8639,9.258,234266,65617,168649,5.654,20.186,190591,56182,134409,4.841,16.422,43675,3.763,32.845,5672,5745,27840
2001,5413,83704,94841,1300696,1274820,10710,11.397,8978,9.554,219240,62059,157181,4.868,17.198,167571,56540,111031,4.435,13.145,51669,4.053,26.289,5889,5958,27253
2001,5414,24941,25203,143703,141227,3894,15.680,3155,12.705,30627,10337,20290,7.319,21.686,25476,10758,14718,7.618,18.039,5151,3.647,36.078,2389,2391,8093
2001,5415,76866,86563,1259320,1221807,19167,22.607,15608,18.409,362492,143049,219443,11.708,29.669,287322,119788,167534,9.804,23.516,75170,6.152,47.032,10784,10875,64148
2001,5416,71525,76518,688478,661726,16735,22.670,11341,15.363,191881,86533,105348,13.077,28.997,138465,63869,74596,9.652,20.925,53416,8.072,41.850,8142,8202,34073
2001,5417,10207,13174,613434,594163,2043,15.903,1388,10.804,137185,45083,92102,7.588,23.089,97029,35014,62015,5.893,16.330,40156,6.758,32.661,767,783,8770
2001,5418,31838,35356,476325,481192,4145,11.689,4353,12.276,83837,29058,54779,6.039,17.423,93714,36074,57640,7.497,19.475,-9877,-2.053,34.846,2992,3039,17537
2001,5419,46802,53967,491082,485472,6694,12.504,5826,10.883,92683,34758,57925,7.160,19.091,80225,30015,50210,6.183,16.525,12458,2.566,33.050,3413,3424,15078
2001,5511,28145,52364,3278895,3313695,5619,10.661,6308,11.968,582317,191308,391009,5.773,17.573,651561,243105,408456,7.336,19.663,-69244,-2.090,35.146,1308,1378,26704
2001,5611,20201,22176,441718,435500,3825,17.427,3371,15.358,102242,44029,58213,10.110,23.477,90115,41958,48157,9.634,20.692,12127,2.785,41.385,2129,2153,24009
2001,5612,1536,3331,132554,131524,542,16.840,317,9.849,20940,8435,12505,6.413,15.921,18928,7781,11147,5.916,14.391,2012,1.530,28.783,87,93,2583
2001,5613,27403,47268,4270569,4411847,7669,16.570,5699,12.313,1114839,340957,773882,7.728,25.269,1406656,409908,996748,9.291,31.884,-291817,-6.614,50.538,2952,3086,128834
2001,5614,25211,30586,734915,729040,4050,13.257,3980,13.027,174459,59230,115229,8.124,23.930,161987,60568,101419,8.308,22.219,12472,1.711,44.438,2756,2870,22789
2001,5615,21369,29258,305742,305544,2275,7.620,3471,11.626,47022,15051,31971,4.926,15.390,46812,17631,29181,5.770,15.321,210,0.069,30.642,2431,2500,10942
2001,5616,15876,20191,718116,713782,2585,12.850,2436,12.109,126077,43177,82900,6.049,17.663,116462,51811,64651,7.259,16.316,9615,1.347,32.632,1573,1643,20538
2001,5617,120098,126421,1548390,1537889,18527,14.777,16436,13.109,317764,119452,198312,7.767,20.662,295571,113359,182212,7.371,19.219,22193,1.443,38.439,11880,11909,55040
2001,5619,19543,21794,469959,468465,2452,11.210,2610,11.933,83602,20963,62639,4.475,17.846,80599,23513,57086,5.019,17.205,3003,0.641,34.410,1860,1915,12464
2001,5621,5953,7467,154198,154479,931,12.644,723,9.819,26312,11012,15300,7.129,17.033,26996,11045,15951,7.150,17.476,-684,-0.443,34.066,484,488,3509
2001,5622,1457,2427,53582,53190,312,12.941,280,11.613,9951,4675,5276,8.789,18.708,9256,3847,5409,7.233,17.402,695,1.307,34.804,133,135,976
2001,5629,5672,6305,100209,98927,818,13.229,575,9.299,20067,6069,13998,6.135,20.285,17379,5736,11643,5.798,17.568,2688,2.717,35.135,386,395,3915
2001,6111,16016,18208,718693,706436,1009,5.581,754,4.170,67043,13710,53333,1.941,9.490,42516,10936,31580,1.548,6.018,24527,3.472,12.037,431,439,7217
2001,6112,525,805,81152,79238,59,7.459,31,3.919,8508,954,7554,1.204,10.737,4731,1226,3505,1.547,5.971,3777,4.767,11.941,19,19,372
2001,6113,2195,2851,1263487,1253452,160,5.658,114,4.031,75281,4410,70871,0.352,6.006,54305,3132,51173,0.250,4.332,20976,1.673,8.665,62,64,1446
2001,6114,5582,6108,63319,63048,996,16.464,879,14.530,14894,6051,8843,9.597,23.623,14223,5639,8584,8.944,22.559,671,1.064,45.118,599,610,3296
2001,6115,5276,6229,84947,81950,695,11.211,636,10.259,18413,6686,11727,8.159,22.469,12561,5698,6863,6.953,15.328,5852,7.141,30.655,457,468,3690
2001,6116,21630,23595,211407,204857,3421,14.791,2489,10.761,46510,16377,30133,7.994,22.704,33303,12074,21229,5.894,16.257,13207,6.447,32.513,1775,1799,8007
2001,6117,3353,3644,43853,41605,595,16.681,441,12.363,10287,3347,6940,8.045,24.725,5784,2449,3335,5.886,13.902,4503,10.823,27.804,323,323,1723
2001,6211,160104,180171,1817801,1786508,15592,8.685,14315,7.973,294744,97800,196944,5.474,16.498,231818,98859,132959,5.534,12.976,62926,3.522,25.952,9251,9638,48168
2001,6212,106661,110829,727578,717171,5248,4.744,4817,4.355,98638,24900,73738,3.472,13.754,78089,22220,55869,3.098,10.888,20549,2.865,21.777,3611,3695,16894
2001,6213,81035,87081,444426,432295,9904,11.562,7059,8.241,91641,37843,53798,8.754,21.199,67500,27685,39815,6.404,15.614,24141,5.584,31.229,4798,4978,16755
2001,6214,10714,22617,567463,559632,2564,11.556,1706,7.689,88541,31751,56790,5.674,15.821,72831,25238,47593,4.510,13.014,15710,2.807,26.028,599,711,9279
2001,6215,5732,10141,168484,160239,2421,25.747,945,10.050,41969,18743,23226,11.697,26.192,24936,13461,11475,8.401,15.562,17033,10.630,31.124,461,492,3520
2001,6216,10254,15232,766969,778581,2200,14.576,1923,12.741,124223,33343,90880,4.283,15.955,148100,46982,101118,6.034,19.022,-23877,-3.067,31.910,1001,1091,22741
2001,6219,4556,7130,182147,183092,1091,15.844,603,8.757,31651,10610,21041,5.795,17.287,34022,12366,21656,6.754,18.582,-2371,-1.295,34.574,332,358,4504
2001,6221,3343,5346,4600150,4581375,132,2.446,232,4.299,249263,52173,197090,1.139,5.441,211042,81955,129087,1.789,4.607,38221,0.834,9.213,66,88,42701
2001,6222,504,666,239308,239932,37,5.193,130,18.246,10817,3957,6860,1.649,4.508,11640,8483,3157,3.536,4.851,-823,-0.343,9.017,18,18,1410
2001,6223,295,504,157998,152025,101,21.308,41,8.650,21448,13890,7558,9.137,14.108,9735,3258,6477,2.143,6.404,11713,7.705,12.807,15,21,1986
2001,6231,7928,15566,1527831,1520475,1225,7.840,1344,8.601,176823,73412,103411,4.828,11.629,163316,69882,93434,4.596,10.741,13507,0.888,21.482,471,547,26017
2001,6232,7311,23979,416691,408720,2847,12.286,1236,5.334,67973,25567,42406,6.255,16.631,52051,15440,36611,3.778,12.735,15922,3.896,25.470,375,431,4742
2001,6233,12525,16770,535172,522713,1969,11.852,1656,9.968,82592,32332,50260,6.185,15.801,57416,26406,31010,5.052,10.984,25176,4.816,21.968,1094,1159,17040
2001,6239,3312,5927,149671,147742,524,8.836,531,8.954,20162,5914,14248,4.003,13.647,16232,4973,11259,3.366,10.987,3930,2.660,21.973,211,234,1968
2001,6241,29863,43401,806274,788220,4077,9.524,2893,6.758,120220,31615,88605,4.011,15.252,84221,21614,62607,2.742,10.685,35999,4.567,21.370,1603,1656,10720
2001,6242,7809,9946,121356,119039,599,6.060,476,4.816,15980,3724,12256,3.128,13.424,11279,2690,8589,2.260,9.475,4701,3.949,18.950,274,282,1360
2001,6243,4947,7729,306980,307128,567,7.308,627,8.081,42182,7522,34660,2.449,13.734,42253,10045,32208,3.271,13.757,-71,-0.023,27.469,264,319,2751
2001,6244,47895,60576,735180,714870,6966,11.586,6063,10.084,130881,42608,88273,5.960,18.308,89597,35586,54011,4.978,12.533,41284,5.775,25.067,4259,4344,24292
2001,7111,7301,7384,118229,117032,984,13.378,927,12.603,24285,6215,18070,5.311,20.751,21872,6880,14992,5.879,18.689,2413,2.062,37.378,623,623,4142
2001,7112,3335,3488,103807,101284,513,14.695,519,14.867,19777,7641,12136,7.544,19.526,14999,4572,10427,4.514,14.809,4778,4.717,29.618,391,394,2312
2001,7113,3473,3657,78743,77326,541,15.007,437,12.122,15953,7387,8566,9.553,20.631,13082,4231,8851,5.472,16.918,2871,3.713,33.836,280,282,1656
2001,7114,2494,2551,15804,15896,394,15.657,325,12.915,3041,1221,1820,7.681,19.131,3255,1325,1930,8.335,20.477,-214,-1.346,38.261,237,237,860
2001,7115,9394,9417,40375,40442,1819,19.654,1495,16.153,12865,6862,6003,16.968,31.811,12994,5019,7975,12.410,32.130,-129,-0.319,63.622,899,899,2670
2001,7121,4852,5265,107408,105851,330,6.312,256,4.897,10657,1830,8827,1.729,10.068,7660,1787,5873,1.688,7.237,2997,2.831,14.473,154,154,1123
2001,7131,1585,2337,120189,123040,277,11.700,338,14.277,9581,3218,6363,2.615,7.787,14928,3320,11608,2.698,12.133,-5347,-4.346,15.574,219,239,2008
2001,7132,1570,1940,193077,190354,193,9.725,282,14.210,23538,5172,18366,2.717,12.365,18404,5892,12512,3.095,9.668,5134,2.697,19.337,209,212,3541
2001,7139,44869,49472,965852,958192,5004,10.149,4670,9.472,147185,47759,99426,4.984,15.361,132335,46958,85377,4.901,13.811,14850,1.550,27.622,3412,3456,31335
2001,7211,35291,45172,1700612,1710507,4744,10.572,4150,9.248,216004,90547,125457,5.294,12.628,236978,104945,132033,6.135,13.854,-20974,-1.226,25.256,2503,2589,41496
2001,7212,5092,5521,38503,38604,497,9.053,435,7.923,5727,1529,4198,3.961,14.835,5894,1662,4232,4.305,15.268,-167,-0.433,29.671,299,305,1086
2001,7213,2647,2694,14257,14416,161,5.857,271,9.858,2049,668,1381,4.634,14.214,2338,778,1560,5.397,16.219,-289,-2.005,28.428,187,189,444
2001,7223,10605,25336,519053,511233,3300,13.210,2589,10.364,86362,38915,47447,7.612,16.893,70490,30812,39678,6.027,13.788,15872,3.105,27.576,1242,1256,8536
2001,7224,44041,44538,331887,329815,5019,11.175,5765,12.836,69267,32571,36696,9.876,21.002,64863,28254,36609,8.567,19.667,4404,1.335,39.333,4487,4499,21758
2001,7225,265439,367674,7370349,7341414,43487,11.879,40288,11.005,1268642,625910,642732,8.526,17.281,1213500,458833,754667,6.250,16.530,55142,0.751,33.059,26896,28597,291057
2001,8111,138195,150775,882395,876419,15187,10.075,15126,10.034,151735,57823,93912,6.598,17.313,140298,55191,85107,6.297,16.008,11437,1.305,32.016,10870,11068,38937
2001,8112,11943,13723,137478,140990,1378,9.827,1976,14.092,24057,8611,15446,6.108,17.063,30830,16561,14269,11.746,21.867,-6773,-4.804,34.126,1373,1387,6625
2001,8113,21021,22567,197643,198737,1993,8.799,2158,9.528,29918,8095,21823,4.073,15.054,31816,10603,21213,5.335,16.009,-1898,-0.955,30.108,1473,1490,6469
2001,8114,22771,23958,130892,134712,2543,10.479,3161,13.026,20132,8250,11882,6.124,14.944,27757,9784,17973,7.263,20.605,-7625,-5.660,29.889,2434,2447,6993
2001,8121,74292,86272,514313,507982,11181,13.027,10293,11.993,101911,47427,54484,9.336,20.062,89774,38715,51059,7.621,17.673,12137,2.389,35.345,7609,7812,26714
2001,8122,14850,21108,165675,163961,888,4.187,1094,5.158,18486,4534,13952,2.765,11.275,15080,4627,10453,2.822,9.197,3406,2.077,18.395,584,622,2305
2001,8123,32393,38734,385454,388256,3443,8.802,4210,10.762,49180,18376,30804,4.733,12.667,54803,21102,33701,5.435,14.115,-5623,-1.448,25.334,3096,3241,15262
2001,8129,18574,28974,235668,230268,3684,12.620,4118,14.107,52982,17096,35886,7.424,23.009,42502,20131,22371,8.742,18.458,10480,4.551,36.915,2449,2522,10247
2001,8131,155293,155425,1537667,1517962,7554,4.882,6164,3.984,164840,27595,137245,1.818,10.859,124844,20290,104554,1.337,8.224,39996,2.635,16.449,3444,3444,10978
2001,8132,10345,12294,130571,128777,1130,9.361,686,5.683,17166,3910,13256,3.036,13.330,13600,3259,10341,2.531,10.561,3566,2.769,21.122,449,451,2072
2001,8133,8616,10549,105369,102762,1094,10.585,666,6.444,15486,3633,11853,3.535,15.070,10379,3016,7363,2.935,10.100,5107,4.970,20.200,397,400,1998
2001,8134,26704,28577,316889,314119,1234,4.296,1533,5.337,36043,5272,30771,1.678,11.474,30385,5449,24936,1.735,9.673,5658,1.801,19.346,999,1003,3316
2001,8139,60458,62498,506847,510791,2823,4.480,3848,6.107,56710,10307,46403,2.018,11.102,64336,15146,49190,2.965,12.595,-7626,-1.493,22.205,2562,2576,9784
2002,1131,515,566,4815,4409,76,13.781,47,8.522,1491,1010,481,22.908,33.817,650,184,466,4.173,14.743,841,19.075,29.485,28,28,106
2002,1132,224,290,2540,2649,34,11.826,29,10.087,483,107,376,4.040,18.237,728,119,609,4.493,27.487,-245,-9.251,36.473,18,18,81
2002,1133,9923,9994,68581,70331,982,9.503,1662,16.083,12116,3529,8587,5.018,17.227,15520,6208,9312,8.827,22.067,-3404,-4.840,34.454,1175,1176,4517
2002,1141,1243,1258,6677,6824,186,14.269,277,21.250,1463,599,864,8.778,21.439,1771,756,1015,11.079,25.953,-308,-4.513,42.878,178,178,529
2002,1142,322,322,2646,2631,45,14.041,42,13.105,370,125,245,4.751,14.063,337,94,243,3.573,12.809,33,1.254,25.618,21,21,52
2002,1151,4106,4454,59118,60394,523,11.669,579,12.918,12526,5830,6696,9.653,20.741,15328,5430,9898,8.991,25.380,-2802,-4.640,41.481,380,380,3776
2002,1152,3722,3779,22294,22218,508,13.539,454,12.100,3857,1405,2452,6.324,17.360,3663,1199,2464,5.397,16.487,194,0.873,32.974,326,326,813
2002,1153,1342,1393,14389,15083,191,13.706,192,13.778,2348,791,1557,5.244,15.567,3712,940,2772,6.232,24.610,-1364,-9.043,31.134,107,107,504
2002,2111,5707,6951,86536,85607,681,9.791,690,9.920,19626,6540,13086,7.640,22.926,18086,8394,9692,9.805,21.127,1540,1.799,42.254,369,373,2850
2002,2121,740,1131,76827,74923,147,13.067,135,12.000,13766,5290,8476,7.061,18.374,9942,2772,7170,3.700,13.270,3824,5.104,26.539,67,69,1497
2002,2122,223,304,25765,28965,36,10.762,97,28.999,973,241,732,0.832,3.359,7522,2214,5308,7.644,25.970,-6549,-22.610,6.719,45,45,161
2002,2123,3278,5300,93438,96436,447,8.365,535,10.011,14429,4558,9871,4.726,14.962,20166,6822,13344,7.074,20.911,-5737,-5.949,29.925,240,241,2205
2002,2131,6826,8365,192056,197259,1263,15.388,948,11.550,34310,16927,17383,8.581,17.393,45860,14294,31566,7.246,23.249,-11550,-5.855,34.787,544,550,4241
2002,2211,1536,9547,533202,530438,793,8.510,335,3.595,60298,30819,29479,5.810,11.368,55116,11424,43692,2.154,10.391,5182,0.977,20.781,85,85,1231
2002,2212,503,2551,90495,94778,162,6.273,225,8.712,7225,2874,4351,3.032,7.623,15970,4965,11005,5.239,16.850,-8745,-9.227,15.246,38,38,250
2002,2213,4536,5292,43896,42807,336,6.348,338,6.386,7568,3148,4420,7.354,17.680,5513,2159,3354,5.044,12.879,2055,4.801,25.758,215,215,1338
2002,2361,137171,138018,759532,754673,22430,16.402,19899,14.551,183142,76308,106834,10.111,24.268,172844,67265,105579,8.913,22.903,10298,1.365,45.806,12413,12415,44390
2002,2362,38239,39139,723954,745039,4059,10.296,4626,11.734,133149,34978,98171,4.695,17.871,175552,42297,133255,5.677,23.563,-42403,-5.691,35.743,3126,3186,25371
2002,2371,18891,19633,513932,524561,1909,9.771,1716,8.784,98602,27881,70721,5.315,18.797,121056,25309,95747,4.825,23.078,-22454,-4.281,37.594,1076,1080,12792
2002,2372,9800,9914,58270,58292,1728,17.507,1641,16.625,15356,6731,8625,11.547,26.343,15491,7131,8360,12.233,26.575,-135,-0.232,52.687,1162,1179,5188
2002,2373,10319,10837,316323,315433,920,8.381,1201,10.941,64431,16190,48241,5.133,20.426,63059,15247,47812,4.834,19.991,1372,0.435,39.983,669,670,8107
2002,2379,4281,4436,85716,84763,571,12.585,773,17.038,19778,5689,14089,6.712,23.333,17863,4739,13124,5.591,21.074,1915,2.259,42.148,504,504,2771
2002,2381,90133,90610,960076,970628,12480,13.715,13256,14.567,211210,66327,144883,6.833,21.760,232524,65046,167478,6.701,23.956,-21314,-2.196,43.520,8409,8415,43743
2002,2382,141351,144607,1745327,1781359,14993,10.393,14311,9.920,299568,88568,211000,4.972,16.817,372274,96710,275564,5.429,20.898,-72706,-4.081,33.634,9999,10004,66239
2002,2383,94568,95423,798104,803789,15078,15.880,14136,14.888,181102,61599,119503,7.664,22.531,191569,59541,132028,7.408,23.833,-10467,-1.302,45.062,9488,9497,42232
2002,2389,46227,46624,421236,425784,6086,12.782,8066,16.940,88249,28363,59886,6.661,20.726,97823,33720,64103,7.920,22.975,-9574,-2.249,41.452,5133,5136,23051
2002,3111,1145,1741,46869,48007,131,7.557,116,6.692,5651,2470,3181,5.145,11.771,8079,2390,5689,4.978,16.829,-2428,-5.058,23.543,66,66,1239
2002,3112,474,809,56485,57391,35,4.253,63,7.655,4509,1429,3080,2.490,7.857,6288,1876,4412,3.269,10.956,-1779,-3.100,15.713,26,27,515
2002,3113,1539,1725,82384,84994,157,9.070,169,9.763,7374,2677,4697,3.150,8.676,12772,3937,8835,4.632,15.027,-5398,-6.351,17.352,122,122,2517
2002,3114,1279,1671,165427,168684,112,6.669,129,7.681,17991,6323,11668,3.748,10.666,24713,8897,15816,5.274,14.651,-6722,-3.985,21.331,89,91,4598
2002,3115,1080,1589,132221,132262,99,6.178,126,7.863,11525,2947,8578,2.228,8.714,11507,3401,8106,2.571,8.700,18,0.014,17.400,71,73,1028
2002,3116,3097,3730,497782,496506,233,6.177,317,8.404,45731,13325,32406,2.684,9.211,43386,12742,30644,2.566,8.738,2345,0.472,17.477,222,223,6128
2002,3117,575,675,39336,39849,47,6.734,93,13.324,5742,2055,3687,5.157,14.410,6753,2504,4249,6.284,16.947,-1011,-2.537,28.819,59,60,1571
2002,3118,9622,10635,307024,310333,1148,10.814,1110,10.456,38521,14117,24404,4.549,12.413,44800,14572,30228,4.696,14.436,-6279,-2.023,24.826,804,810,6976
2002,3119,2443,2862,157496,154072,268,9.361,270,9.431,24837,6083,18754,3.948,16.120,18338,6903,11435,4.480,11.902,6499,4.218,23.805,164,165,2675
2002,3121,2167,2642,137760,139780,278,10.570,254,9.658,16394,3862,12532,2.763,11.728,20535,4284,16251,3.065,14.691,-4141,-2.963,23.457,162,164,2767
2002,3122,78,104,23415,23810,7,6.167,26,22.907,1559,39,1520,0.164,6.548,2228,1610,618,6.762,9.357,-669,-2.810,13.095,13,13,78
2002,3131,357,551,65314,69782,40,6.969,86,14.983,5117,2256,2861,3.233,7.333,13944,5523,8421,7.915,19.982,-8827,-12.649,14.666,33,36,1527
2002,3132,1432,1685,141951,155004,119,6.806,246,14.069,9962,3390,6572,2.187,6.427,35563,14610,20953,9.426,22.943,-25601,-16.516,12.854,152,166,7762
2002,3133,1389,1489,61556,67797,124,7.447,476,28.589,5597,2712,2885,4.000,8.256,17836,8605,9231,12.692,26.308,-12239,-18.053,16.511,340,355,5946
2002,3141,2607,2809,103617,107481,197,6.880,306,10.686,8144,3260,4884,3.033,7.577,15859,4246,11613,3.950,14.755,-7715,-7.178,15.154,235,241,2562
2002,3149,4608,4758,90076,95379,488,10.247,497,10.436,11055,4853,6202,5.088,11.591,21592,7655,13937,8.026,22.638,-10537,-11.048,23.181,368,370,5245
2002,3151,738,801,52915,59737,51,5.968,158,18.490,3888,1751,2137,2.931,6.509,17395,6759,10636,11.315,29.120,-13507,-22.611,13.017,124,127,3984
2002,3152,8260,8577,243199,273329,1380,15.380,2171,24.196,37168,20239,16929,7.405,13.598,97784,47318,50466,17.312,35.775,-60616,-22.177,27.197,1732,1751,29385
2002,3159,1215,1255,28273,31509,115,8.614,275,20.599,3555,1326,2229,4.208,11.282,10030,4299,5731,13.644,31.832,-6475,-20.550,22.565,211,214,2485
2002,3161,230,241,9195,10125,25,10.081,39,15.726,643,202,441,1.995,6.351,2512,775,1737,7.655,24.811,-1869,-18.460,12.702,28,28,480
2002,3162,297,329,20505,22686,33,9.735,53,15.634,1130,347,783,1.530,4.981,5361,2150,3211,9.477,23.631,-4231,-18.650,9.962,38,38,448
2002,3169,821,837,17076,18292,86,9.948,141,16.310,1852,738,1114,4.035,10.125,4253,1276,2977,6.976,23.251,-2401,-13.126,20.249,98,98,735
2002,3211,3598,4061,113791,117299,293,7.058,474,11.418,10866,3888,6978,3.315,9.264,17771,6369,11402,5.430,15.150,-6905,-5.887,18.527,335,339,3676
2002,3212,1478,1877,113052,115542,106,5.608,132,6.984,9816,2520,7296,2.181,8.496,14717,4940,9777,4.276,12.737,-4901,-4.242,16.991,92,99,2564
2002,3219,9516,10330,313704,321030,959,9.219,1103,10.604,36870,12462,24408,3.882,11.485,51467,15141,36326,4.716,16.032,-14597,-4.547,22.970,797,807,7987
2002,3221,285,581,165120,171694,42,7.113,61,10.330,6775,3796,2979,2.211,3.946,19996,7873,12123,4.585,11.646,-13221,-7.700,7.892,34,36,3061
2002,3222,3227,4857,339578,353038,205,4.153,363,7.354,22755,6896,15859,1.953,6.445,49967,15664,34303,4.437,14.153,-27212,-7.708,12.891,206,208,5932
2002,3231,33658,35449,721051,759089,2156,5.972,3465,9.597,57553,21420,36133,2.822,7.582,133606,42445,91161,5.592,17.601,-76053,-10.019,15.164,2679,2700,25971
2002,3241,1060,2235,97739,99426,181,8.162,146,6.584,8693,2859,5834,2.876,8.743,12053,4299,7754,4.324,12.123,-3360,-3.379,17.486,52,53,885
2002,3251,1164,2321,182812,188873,98,4.160,168,7.131,9810,2886,6924,1.528,5.194,21712,4274,17438,2.263,11.496,-11902,-6.302,10.388,67,69,920
2002,3252,612,936,102161,108662,48,5.066,71,7.493,4802,1970,2832,1.813,4.419,17645,3713,13932,3.417,16.238,-12843,-11.819,8.838,35,37,1534
2002,3253,653,911,31057,31774,107,11.935,78,8.701,3391,1400,1991,4.406,10.672,4836,1270,3566,3.997,15.220,-1445,-4.548,21.345,42,42,340
2002,3254,1361,1749,243333,240293,132,7.551,130,7.437,31298,4294,27004,1.787,13.025,24726,4717,20009,1.963,10.290,6572,2.735,20.580,79,79,1838
2002,3255,1521,1949,70490,71750,135,6.820,196,9.901,7713,3697,4016,5.153,10.750,10247,3164,7083,4.410,14.282,-2534,-3.532,21.500,121,122,1344
2002,3256,2032,2299,112429,117205,198,8.583,214,9.276,11360,5339,6021,4.555,9.692,20960,6710,14250,5.725,17.883,-9600,-8.191,19.385,139,139,3182
2002,3259,2169,2800,113408,117028,194,6.890,225,7.991,8910,2577,6333,2.202,7.614,16304,4506,11798,3.850,13.932,-7394,-6.318,15.227,114,115,1340
2002,3261,10010,12629,755729,782424,773,6.056,1042,8.164,73007,28391,44616,3.629,9.331,126721,36788,89933,4.702,16.196,-53714,-6.865,18.662,663,681,18273
2002,3262,1835,2369,177600,185813,142,5.908,211,8.779,10955,3752,7203,2.019,5.896,27400,7007,20393,3.771,14.746,-16445,-8.850,11.791,122,122,2250
2002,3271,1301,1519,61622,66132,111,7.111,195,12.492,4189,878,3311,1.328,6.334,13076,3169,9907,4.792,19.773,-8887,-13.438,12.669,134,138,1402
2002,3272,1799,2110,115113,121800,173,8.122,213,10.000,6497,1940,4557,1.593,5.334,20145,3930,16215,3.227,16.539,-13648,-11.205,10.668,150,151,1774
2002,3273,5146,9150,206969,215277,631,6.888,653,7.128,25385,8159,17226,3.790,11.792,42384,10956,31428,5.089,19.688,-16999,-7.896,23.584,327,338,6176
2002,3274,235,360,17087,17898,24,6.548,37,10.095,905,239,666,1.335,5.056,2531,768,1763,4.291,14.141,-1626,-9.085,10.113,16,21,336
2002,3279,2397,2815,74953,76022,273,9.840,192,6.920,9124,3406,5718,4.480,12.002,11330,2835,8495,3.729,14.904,-2206,-2.902,24.004,113,116,1023
2002,3311,319,426,124272,135197,42,9.013,122,26.180,4665,1560,3105,1.154,3.451,26216,11633,14583,8.605,19.391,-21551,-15.941,6.901,90,90,3229
2002,3312,487,644,51203,54113,55,8.227,104,15.557,4155,1557,2598,2.877,7.678,9736,4221,5515,7.800,17.992,-5581,-10.314,15.357,72,75,1892
2002,3313,423,579,71426,75985,44,7.451,67,11.346,4746,1900,2846,2.501,6.246,13741,4183,9558,5.505,18.084,-8995,-11.838,12.492,33,33,1061
2002,3314,771,983,67743,72245,78,7.951,74,7.543,3253,1316,1937,1.822,4.503,12255,1797,10458,2.487,16.963,-9002,-12.460,9.006,46,47,654
2002,3315,2121,2419,181633,193855,103,4.162,215,8.687,9972,4030,5942,2.079,5.144,34611,9028,25583,4.657,17.854,-24639,-12.710,10.288,143,150,3585
2002,3321,2547,2804,127451,137844,132,4.657,193,6.809,8500,3798,4702,2.755,6.166,29355,7041,22314,5.108,21.296,-20855,-15.129,12.333,123,125,4258
2002,3322,1338,1475,61509,65307,81,5.431,114,7.643,4000,1391,2609,2.130,6.125,11457,2718,8739,4.162,17.543,-7457,-11.418,12.250,73,73,969
2002,3323,12111,13043,383805,402431,926,7.106,904,6.937,42049,13700,28349,3.404,10.449,79051,21572,57479,5.360,19.643,-37002,-9.195,20.898,610,617,12195
2002,3324,1275,1576,92638,97341,65,4.030,139,8.617,6533,1401,5132,1.439,6.711,15819,4937,10882,5.072,16.251,-9286,-9.540,13.423,72,75,1652
2002,3325,771,860,60667,62387,53,6.092,73,8.391,7390,4750,2640,7.614,11.846,10878,3781,7097,6.061,17.436,-3488,-5.591,23.691,42,43,1420
2002,3326,1747,1928,60664,64095,132,6.831,141,7.296,4899,1719,3180,2.682,7.643,11649,3145,8504,4.907,18.175,-6750,-10.531,15.287,90,91,1321
2002,3327,24423,24894,374138,399563,1547,6.117,2341,9.256,34636,11593,23043,2.901,8.668,85329,20515,64814,5.134,21.356,-50693,-12.687,17.337,1683,1687,12596
2002,3328,5548,6117,140048,149340,337,5.441,491,7.927,13494,5151,8343,3.449,9.036,32118,6851,25267,4.588,21.507,-18624,-12.471,18.072,326,328,3844
2002,3329,5904,6471,283130,297692,468,7.164,592,9.062,22726,8667,14059,2.911,7.634,51843,14989,36854,5.035,17.415,-29117,-9.781,15.268,415,421,6668
2002,3331,2534,2855,181028,187932,181,6.267,247,8.553,14534,5552,8982,2.954,7.734,28288,6861,21427,3.651,15.052,-13754,-7.319,15.467,152,153,2999
2002,3332,3923,4168,153955,169797,241,5.641,449,10.510,13753,5729,8024,3.374,8.100,45606,11471,34135,6.756,26.859,-31853,-18.759,16.199,324,325,5422
2002,3333,2114,2290,111347,116785,149,6.429,204,8.803,9082,2534,6548,2.170,7.777,19857,5913,13944,5.063,17.003,-10775,-9.226,15.553,132,132,1802
2002,3334,1473,1802,162603,174867,124,6.847,142,7.841,10497,4166,6331,2.382,6.003,35408,7076,28332,4.047,20.249,-24911,-14.246,12.006,86,86,3070
2002,3335,8415,8798,192310,209544,392,4.340,859,9.511,14420,5768,8652,2.753,6.882,49041,10630,38411,5.073,23.404,-34621,-16.522,13.763,628,629,6293
2002,3336,731,901,99509,103048,48,5.313,53,5.866,6723,1638,5085,1.590,6.524,13849,2127,11722,2.064,13.439,-7126,-6.915,13.048,32,33,550
2002,3339,5664,6400,299978,321031,367,5.657,543,8.369,21703,7388,14315,2.301,6.760,63671,12480,51191,3.887,19.833,-41968,-13.073,13.521,368,370,5412
2002,3341,1346,1438,152331,170823,113,7.483,257,17.020,21085,3919,17166,2.294,12.343,57856,18675,39181,10.932,33.869,-36771,-21.526,24.686,169,170,3303
2002,3342,1711,1955,200084,233626,179,8.968,261,13.076,22372,7948,14424,3.402,9.576,90781,20936,69845,8.961,38.857,-68409,-29.281,19.152,169,171,6308
2002,3343,504,529,25326,26619,50,9.242,74,13.678,2219,890,1329,3.344,8.336,4873,1242,3631,4.666,18.307,-2654,-9.971,16.673,55,55,828
2002,3344,4551,5220,442071,518158,370,6.905,647,12.074,31748,12061,19687,2.328,6.127,184178,43429,140749,8.381,35.545,-152430,-29.418,12.254,401,404,14177
2002,3345,4410,5080,424291,442405,347,6.771,437,8.527,43671,19190,24481,4.338,9.871,80208,15187,65021,3.433,18.130,-36537,-8.259,19.743,270,272,6603
2002,3346,803,861,36816,38282,79,8.837,145,16.219,4353,1296,3057,3.385,11.371,7280,2471,4809,6.455,19.017,-2927,-7.646,22.742,98,107,1311
2002,3351,1082,1192,66672,70417,78,6.452,112,9.264,3854,2329,1525,3.307,5.473,11253,2300,8953,3.266,15.981,-7399,-10.507,10.946,89,90,1357
2002,3352,250,318,95260,96392,33,10.526,24,7.656,6965,1509,5456,1.565,7.226,9124,602,8522,0.625,9.466,-2159,-2.240,14.451,14,14,348
2002,3353,2100,2485,161294,174865,163,6.436,258,10.188,10896,5194,5702,2.970,6.231,37893,11568,26325,6.615,21.670,-26997,-15.439,12.462,139,141,5460
2002,3359,1898,2269,175687,194416,168,7.298,234,10.165,9433,3818,5615,1.964,4.852,46893,9696,37197,4.987,24.120,-37460,-19.268,9.704,125,127,2604
2002,3361,282,348,208545,210005,37,10.771,28,8.151,12706,1543,11163,0.735,6.050,14853,632,14221,0.301,7.073,-2147,-1.022,12.101,20,20,604
2002,3362,1827,2062,123258,129916,154,7.440,170,8.213,11374,3331,8043,2.564,8.755,24590,7725,16865,5.946,18.928,-13216,-10.173,17.510,122,124,3334
2002,3363,4368,5532,680982,723579,368,6.586,480,8.590,55331,22671,32660,3.133,7.647,139184,27714,111470,3.830,19.235,-83853,-11.589,15.294,301,317,10753
2002,3364,1185,1511,369063,390761,107,7.003,141,9.228,22874,7028,15846,1.799,5.854,67048,8321,58727,2.129,17.158,-44174,-11.305,11.707,94,94,4762
2002,3365,140,201,28507,31804,11,5.301,24,11.566,2074,471,1603,1.481,6.521,8440,1752,6688,5.509,26.538,-6366,-20.017,13.043,10,11,813
2002,3366,1513,1629,133975,136084,149,9.000,202,12.202,11368,2255,9113,1.657,8.354,15727,4001,11726,2.940,11.557,-4359,-3.203,16.707,144,148,2581
2002,3369,706,738,38761,39926,73,9.799,87,11.678,3660,1215,2445,3.043,9.167,5983,1334,4649,3.341,14.985,-2323,-5.818,18.334,73,73,1138
2002,3371,15127,15707,388418,399081,1501,9.569,1460,9.307,42929,14333,28596,3.592,10.757,64417,20950,43467,5.250,16.141,-21488,-5.384,21.514,1024,1026,11145
2002,3372,3950,4169,164363,175339,232,5.481,359,8.482,13828,4965,8863,2.832,7.886,35744,7561,28183,4.312,20.386,-21916,-12.499,15.773,255,256,4277
2002,3379,947,1074,46879,47775,72,6.679,80,7.421,4561,1445,3116,3.025,9.547,6451,2411,4040,5.047,13.503,-1890,-3.956,19.094,56,61,888
2002,3391,10572,11290,304943,306850,834,7.375,870,7.694,36619,11337,25282,3.695,11.934,40450,11641,28809,3.794,13.182,-3831,-1.248,23.868,610,611,5640
2002,3399,18208,18737,412716,431086,1594,8.441,1890,10.008,43434,13766,29668,3.193,10.075,80515,19657,60858,4.560,18.677,-37081,-8.602,20.151,1379,1391,11601
2002,4231,18027,24570,358151,361988,2460,10.003,2506,10.190,53987,20103,33884,5.553,14.914,61385,20859,40526,5.762,16.958,-7398,-2.044,29.828,1531,1633,11610
2002,4232,11171,12750,161093,166285,1418,11.164,1322,10.408,23792,9798,13994,5.892,14.308,33976,11277,22699,6.782,20.432,-10184,-6.124,28.616,900,921,7758
2002,4233,11345,16504,225204,226260,1680,10.242,1478,9.011,35673,14306,21367,6.323,15.766,37818,13431,24387,5.936,16.714,-2145,-0.948,31.533,802,839,6915
2002,4234,26563,33858,696035,717492,3775,10.925,5167,14.953,122616,46321,76295,6.456,17.090,164478,61000,103478,8.502,22.924,-41862,-5.834,34.179,2855,2956,29123
2002,4235,7508,10223,146773,153056,718,6.950,935,9.050,16379,6096,10283,3.983,10.701,28942,8135,20807,5.315,18.909,-12563,-8.208,21.403,479,496,3732
2002,4236,20537,30932,499559,522307,2922,9.280,4029,12.796,95136,29175,65961,5.586,18.215,139047,51527,87520,9.865,26.622,-43911,-8.407,36.429,1777,1845,17252
2002,4237,11318,18027,208550,214465,1221,6.727,1471,8.104,27987,9788,18199,4.564,13.050,39594,15737,23857,7.338,18.462,-11607,-5.412,26.099,731,771,6884
2002,4238,44634,60398,698987,720168,4537,7.397,6419,10.465,94365,35514,58851,4.931,13.103,136412,48240,88172,6.698,18.942,-42047,-5.839,26.206,3500,3686,24581
2002,4239,28601,31564,320035,327539,3786,11.937,4089,12.893,50559,18582,31977,5.673,15.436,65773,22727,43046,6.939,20.081,-15214,-4.645,30.872,2854,2920,13597
2002,4241,9924,12474,211123,217775,927,7.250,1551,12.130,24658,10319,14339,4.738,11.323,37624,14135,23489,6.491,17.277,-12966,-5.954,22.645,681,731,5570
2002,4242,5497,7000,226492,229363,853,12.244,786,11.283,46121,15538,30583,6.774,20.108,52958,21632,31326,9.431,23.089,-6837,-2.981,40.217,416,420,5773
2002,4243,14299,15532,198606,203529,2034,13.128,1958,12.637,36778,12511,24267,6.147,18.070,46759,14157,32602,6.956,22.974,-9981,-4.904,36.140,1358,1372,8490
2002,4244,26558,32220,744822,764121,3273,10.096,3671,11.324,98137,33328,64809,4.362,12.843,136947,48741,88206,6.379,17.922,-38810,-5.079,25.686,2283,2404,25256
2002,4245,4455,7098,65378,66828,482,6.681,715,9.911,10632,3248,7384,4.860,15.910,13560,4510,9050,6.749,20.291,-2928,-4.381,31.819,366,402,2808
2002,4246,8848,13640,146062,149528,1024,7.410,1383,10.008,22526,7606,14920,5.087,15.065,29541,12948,16593,8.659,19.756,-7015,-4.691,30.129,632,656,4257
2002,4247,5416,7678,104737,107994,695,8.761,1205,15.190,19713,7903,11810,7.318,18.254,25996,10037,15959,9.294,24.072,-6283,-5.818,36.508,548,569,5382
2002,4248,3229,4041,160881,160085,354,8.652,455,11.121,22535,9379,13156,5.859,14.077,20862,10506,10356,6.563,13.032,1673,1.045,26.064,259,277,6873
2002,4249,23746,29596,385797,395313,3552,11.988,3617,12.208,65349,26819,38530,6.784,16.531,84295,34598,49697,8.752,21.324,-18946,-4.793,33.062,2394,2443,19181
2002,4251,29053,30917,247609,244714,2952,9.430,3728,11.909,53980,17394,36586,7.108,22.058,48788,24709,24079,10.097,19.937,5192,2.122,39.873,2176,2202,13405
2002,4411,43421,47424,1260284,1242347,5252,11.110,4950,10.471,189454,79512,109942,6.400,15.250,153596,67223,86373,5.411,12.363,35858,2.886,24.727,3581,3621,46715
2002,4412,12885,14088,137973,136454,1522,10.846,1412,10.062,24914,9399,15515,6.888,18.258,22000,8647,13353,6.337,16.123,2914,2.136,32.245,990,1003,6339
2002,4413,32275,55427,476196,475032,4208,7.558,4706,8.452,78599,25256,53343,5.317,16.546,75560,26633,48927,5.607,15.906,3039,0.640,31.813,2767,2937,15632
2002,4421,18575,25847,251519,258378,3107,11.905,3608,13.825,44837,21226,23611,8.215,17.353,57828,25161,32667,9.738,22.381,-12991,-5.028,34.707,1824,2166,15409
2002,4422,25232,33663,287488,290601,3965,11.754,4108,12.177,61306,29598,31708,10.185,21.096,67248,36335,30913,12.503,23.141,-5942,-2.045,42.193,2250,2952,28982
2002,4431,29605,48392,447437,454996,6062,12.482,6410,13.199,74412,35783,38629,7.864,16.354,89036,38324,50712,8.423,19.569,-14624,-3.214,32.709,4008,4269,21595
2002,4441,44456,63548,1019195,1003290,5096,7.970,5876,9.190,169893,88737,81156,8.845,16.934,141168,53378,87790,5.320,14.071,28725,2.863,28.141,3579,3981,37946
2002,4442,15690,18927,168188,171110,1709,8.899,2264,11.789,30102,11761,18341,6.873,17.592,36106,14875,21231,8.693,21.101,-6004,-3.509,35.184,1312,1349,8157
2002,4451,58494,85284,2551711,2587713,9479,11.117,9448,11.080,285506,136502,149004,5.275,11.033,360633,103302,257331,3.992,13.936,-75127,-2.903,22.066,6102,6221,46713
2002,4452,15698,20522,130854,133023,3336,16.266,3309,16.135,28475,13785,14690,10.363,21.406,32893,14771,18122,11.104,24.727,-4418,-3.321,42.812,2174,2276,9962
2002,4453,22881,25996,133153,132970,2627,10.129,2504,9.655,24777,9475,15302,7.126,18.634,24469,8753,15716,6.583,18.402,308,0.232,36.804,1709,1729,5953
2002,4461,38269,77073,938950,932691,7595,9.911,6712,8.759,182250,83622,98628,8.966,19.540,168195,46902,121293,5.029,18.033,14055,1.507,36.067,3272,3819,21325
2002,4471,60486,114024,926647,943112,9951,8.685,11053,9.647,171358,68531,102827,7.266,18.169,205812,65254,140558,6.919,21.823,-34454,-3.653,36.339,5801,6534,36370
2002,4481,34559,83954,1015583,1015836,10606,12.730,9333,11.202,221668,116929,104739,11.511,21.821,220003,65380,154623,6.436,21.657,1665,0.164,43.315,4207,4994,29083
2002,4482,6244,27223,209251,202222,2472,9.057,2612,9.570,51496,16830,34666,8.323,25.465,37927,13017,24910,6.437,18.755,13569,6.710,37.510,657,901,3933
2002,4483,18199,28030,159048,163167,2400,8.487,2897,10.245,24703,9718,14985,5.956,15.140,32879,11454,21425,7.020,20.151,-8176,-5.011,30.279,1569,1619,5812
2002,4511,27612,38365,393586,400091,4103,10.628,4587,11.881,76654,30908,45746,7.725,19.159,88367,23725,64642,5.930,22.087,-11713,-2.928,38.318,2958,3179,14580
2002,4512,6393,11869,141710,141488,1060,8.800,1414,11.738,24804,8307,16497,5.871,17.531,24925,10313,14612,7.289,17.616,-121,-0.086,35.062,716,837,4764
2002,4522,70,5519,828391,840292,108,1.953,131,2.369,44480,12313,32167,1.465,5.293,68311,13403,54908,1.595,8.129,-23831,-2.836,10.587,3,3,131
2002,4523,8134,32448,1753864,1726273,3281,10.220,2592,8.074,185084,72101,112983,4.177,10.722,134626,30705,103921,1.779,7.799,50458,2.923,15.597,1104,1378,7225
2002,4531,20037,20890,115756,118749,2132,10.088,2621,12.402,23174,11010,12164,9.272,19.515,28889,13678,15211,11.518,24.328,-5715,-4.813,39.030,1916,1936,7517
2002,4532,28213,39745,320375,331276,4517,11.217,5562,13.813,54853,23115,31738,6.978,16.558,76432,29304,47128,8.846,23.072,-21579,-6.514,33.116,3352,3681,16018
2002,4533,12477,16510,119411,119638,1819,10.980,1932,11.662,20184,9203,10981,7.692,16.871,20673,6962,13711,5.819,17.280,-489,-0.409,33.742,1392,1413,4454
2002,4539,30215,38809,238815,240745,6047,15.661,5651,14.636,51348,24565,26783,10.204,21.329,55274,23144,32130,9.613,22.960,-3926,-1.631,42.658,3526,3855,15890
2002,4541,13011,13938,260662,269377,2394,17.489,1895,13.844,53985,25544,28441,9.483,20.041,71645,31182,40463,11.576,26.597,-17660,-6.556,40.081,1336,1351,15054
2002,4542,4648,5335,62738,63114,664,12.315,778,14.429,15402,9536,5866,15.109,24.403,15936,7886,8050,12.495,25.250,-534,-0.846,48.807,532,532,3689
2002,4543,23455,29680,240879,246470,3357,11.428,2750,9.361,40439,15359,25080,6.232,16.407,51588,22335,29253,9.062,20.931,-11149,-4.523,32.815,1631,1674,11687
2002,4811,579,3043,496068,520060,320,10.391,393,12.762,32084,7355,24729,1.414,6.169,79015,5957,73058,1.145,15.193,-46931,-9.024,12.339,80,108,1539
2002,4812,1781,1919,34284,35320,299,15.729,263,13.835,6948,3081,3867,8.723,19.672,9329,2524,6805,7.146,26.413,-2381,-6.741,39.343,190,190,1874
2002,4831,805,1222,48311,50789,100,8.107,123,9.972,9084,3568,5516,7.025,17.886,13910,3948,9962,7.773,27.388,-4826,-9.502,35.772,62,62,2213
2002,4832,430,478,19156,19279,52,10.800,59,12.253,2601,729,1872,3.781,13.492,2873,900,1973,4.668,14.903,-272,-1.411,26.983,39,39,298
2002,4841,40737,50283,989773,995427,7973,15.805,8298,16.449,160765,52437,108328,5.268,16.150,172287,53549,118738,5.380,17.308,-11522,-1.157,32.301,5936,6081,34718
2002,4842,42935,46243,444043,458195,5990,12.769,7323,15.611,76927,28494,48433,6.219,16.789,104477,39998,64479,8.729,22.802,-27550,-6.013,33.578,5070,5180,26578
2002,4851,615,906,46793,45888,135,15.297,88,9.972,7460,3952,3508,8.612,16.257,5695,3247,2448,7.076,12.411,1765,3.846,24.822,35,41,959
2002,4852,207,454,13257,15262,82,19.114,32,7.459,2174,1447,727,9.481,14.245,6355,353,6002,2.313,41.639,-4181,-27.395,28.489,18,18,250
2002,4853,5905,6024,63527,66472,924,15.191,1041,17.115,10545,5408,5137,8.136,15.864,16431,6098,10333,9.174,24.719,-5886,-8.855,31.728,813,814,4359
2002,4854,3103,4304,174823,172425,307,7.125,317,7.357,26966,11023,15943,6.393,15.639,22140,10001,12139,5.800,12.840,4826,2.799,25.681,200,204,5842
2002,4855,1055,1174,28156,28780,122,10.269,150,12.626,4862,2488,2374,8.645,16.894,6076,2459,3617,8.544,21.112,-1214,-4.218,33.787,109,110,1237
2002,4859,2408,2636,53516,53509,478,18.665,328,12.807,13437,6788,6649,12.686,25.112,13489,5780,7709,10.802,25.209,-52,-0.097,50.224,241,243,3996
2002,4861,50,261,6440,6392,50,19.920,30,11.952,2793,2217,576,34.687,43.699,2676,1383,1293,21.638,41.868,117,1.831,83.736,D,D,D
2002,4862,117,1877,27159,27318,132,6.918,194,10.168,3798,2046,1752,7.490,13.903,4096,3313,783,12.128,14.994,-298,-1.091,27.806,10,10,62
2002,4869,55,460,6304,6211,29,6.017,73,15.145,1306,181,1125,2.914,21.029,1121,709,412,11.416,18.050,185,2.979,36.100,3,3,35
2002,4871,438,484,8368,9089,63,12.702,87,17.540,1174,483,691,5.314,12.917,2646,871,1775,9.583,29.112,-1472,-16.195,25.833,58,58,709
2002,4872,1155,1189,10782,12247,178,14.430,267,21.646,1696,720,976,5.879,13.848,4567,1688,2879,13.783,37.291,-2871,-23.442,27.697,156,156,1060
2002,4879,138,141,1536,1681,24,16.961,25,17.668,219,83,136,4.938,13.028,489,112,377,6.663,29.090,-270,-16.062,26.056,12,12,55
2002,4881,3291,4524,132144,131143,783,17.814,526,11.967,30748,14270,16478,10.881,23.446,28515,11044,17471,8.421,21.743,2233,1.703,43.487,267,274,2658
2002,4882,423,793,21917,22421,84,10.559,89,11.188,2921,1064,1857,4.746,13.028,3900,1215,2685,5.419,17.395,-979,-4.367,26.057,47,50,531
2002,4883,1617,2101,64896,65865,217,10.236,255,12.028,12312,5482,6830,8.323,18.693,14193,4149,10044,6.299,21.549,-1881,-2.856,37.386,129,131,1383
2002,4884,6646,6947,54433,55152,1000,14.519,881,12.791,11910,5101,6809,9.249,21.595,13216,5187,8029,9.405,23.963,-1306,-2.368,43.190,638,641,2829
2002,4885,11118,15303,165405,169695,1712,11.214,1638,10.730,26842,11649,15193,6.865,15.818,35609,11493,24116,6.773,20.984,-8767,-5.166,31.636,991,1053,6458
2002,4889,1025,1144,26421,27004,173,14.985,194,16.804,3476,1610,1866,5.962,12.872,4597,1614,2983,5.977,17.024,-1121,-4.151,25.745,144,144,1034
2002,4921,2763,6946,508869,517773,923,13.426,780,11.346,32010,8593,23417,1.660,6.182,49060,12213,36847,2.359,9.475,-17050,-3.293,12.364,364,366,3243
2002,4922,4077,4482,46315,50069,724,16.043,786,17.416,8559,4120,4439,8.229,17.095,15992,5774,10218,11.532,31.940,-7433,-14.846,34.189,613,621,4561
2002,4931,6695,11952,544691,548301,1314,10.877,1572,13.012,100545,47410,53135,8.647,18.338,107212,32687,74525,5.962,19.553,-6667,-1.216,36.675,404,449,5901
2002,5111,14993,20588,713934,731762,2416,11.843,2040,10.000,86544,40746,45798,5.568,11.827,123302,31721,91581,4.335,16.850,-36758,-5.023,23.654,1274,1295,15534
2002,5112,6526,9049,361331,380700,1128,12.135,1621,17.439,57720,24752,32968,6.502,15.162,95918,31448,64470,8.261,25.195,-38198,-10.034,30.323,900,912,14545
2002,5121,11669,15255,256661,264387,2077,13.436,2483,16.063,51852,18722,33130,7.081,19.612,67308,17487,49821,6.614,25.458,-15456,-5.846,39.224,1378,1423,8339
2002,5122,2554,2850,30529,30815,453,15.945,435,15.312,5571,3129,2442,10.154,18.079,6247,2011,4236,6.526,20.273,-676,-2.194,36.158,293,293,1068
2002,5151,4623,8360,246293,251697,749,8.940,785,9.370,28707,14281,14426,5.674,11.405,39353,14375,24978,5.711,15.635,-10646,-4.230,22.811,493,507,7326
2002,5152,303,623,37499,37619,137,23.103,77,12.985,7344,1214,6130,3.227,19.522,7467,2220,5247,5.901,19.849,-123,-0.327,39.045,40,40,988
2002,5173,6879,44120,1441014,1471987,10256,23.326,9951,22.633,400979,261675,139304,17.777,27.241,459513,175128,284385,11.897,31.217,-58534,-3.977,54.481,1336,1389,31439
2002,5174,412,576,14461,16895,122,20.000,190,31.148,3749,2045,1704,12.105,22.191,8438,4349,4089,25.742,49.945,-4689,-27.755,44.381,63,71,850
2002,5179,4703,5521,84201,100237,1377,21.835,2948,46.745,23726,13286,10440,13.255,23.670,56433,33925,22508,33.845,56.300,-32707,-32.630,47.340,1921,1958,23977
2002,5182,7268,12786,432945,438398,2439,19.781,1527,12.384,100592,53374,47218,12.175,22.945,111157,31561,79596,7.199,25.355,-10565,-2.410,45.891,502,522,6400
2002,5191,4441,5422,102969,106454,667,12.622,392,7.418,16972,6952,10020,6.531,15.943,23746,3846,19900,3.613,22.306,-6774,-6.363,31.886,246,253,2625
2002,5211,12,47,22869,22950,D,D,D,D,440,D,377,D,1.917,594,D,569,D,2.588,-154,-0.671,3.835,D,D,D
2002,5221,17297,111869,2107719,2087872,10007,9.112,5925,5.395,366157,128859,237298,6.172,17.537,325988,106213,219775,5.087,15.613,40169,1.924,31.227,660,798,13472
2002,5222,16858,46030,668249,659605,7350,16.265,5668,12.543,154811,65470,89341,9.926,23.470,136937,49894,87043,7.564,20.760,17874,2.710,41.521,1805,1971,12492
2002,5223,18831,28511,279794,264466,6702,25.363,2529,9.571,83081,37367,45714,14.129,31.415,52167,19052,33115,7.204,19.725,30914,11.689,39.451,1365,1495,10824
2002,5231,12163,39347,600357,576624,7058,18.312,5448,14.135,194511,93776,100735,16.263,33.733,144050,67436,76614,11.695,24.982,50461,8.751,49.963,1200,1276,9977
2002,5232,21,29,6628,6465,5,15.385,12,36.923,817,530,287,8.198,12.637,508,255,253,3.944,7.858,309,4.780,15.715,8,8,42
2002,5239,27687,31551,368854,367638,5703,18.443,4446,14.378,77653,45298,32355,12.321,21.122,75081,28663,46418,7.797,20.423,2572,0.700,40.845,2922,2952,16401
2002,5241,5111,30430,1552694,1550764,4126,13.707,3471,11.531,212228,85276,126952,5.499,13.685,207562,61023,146539,3.935,13.384,4666,0.301,26.769,424,481,10124
2002,5242,113508,126015,825754,815704,13279,10.592,11974,9.552,175924,74517,101407,9.135,21.567,156144,68609,87535,8.411,19.142,19780,2.425,38.284,7710,7878,36335
2002,5259,800,858,5827,6306,202,24.589,129,15.703,1329,619,710,9.816,21.075,2217,990,1227,15.699,35.157,-888,-14.082,42.150,92,92,523
2002,5311,86302,103770,531670,533688,10968,10.633,9725,9.428,95953,44029,51924,8.250,17.979,100244,36946,63298,6.923,18.783,-4291,-0.804,35.958,7117,7180,24627
2002,5312,53900,61321,272461,273061,9859,16.389,7530,12.517,64371,32538,31833,11.916,23.574,65256,26539,38717,9.719,23.898,-885,-0.324,47.148,4534,4591,16223
2002,5313,50946,56081,529952,526980,8312,15.104,6217,11.297,101031,45366,55665,8.609,19.172,95706,38196,57510,7.248,18.161,5325,1.010,36.322,3574,3602,21919
2002,5321,4266,10990,176421,180439,1119,10.223,1031,9.419,24706,8688,16018,4.815,13.692,32396,9523,22873,5.278,17.954,-7690,-4.262,27.384,518,551,3400
2002,5322,13133,31058,254146,254828,3784,12.236,3517,11.373,52663,26858,25805,10.540,20.666,54364,19852,34512,7.790,21.334,-1701,-0.668,41.332,1694,2026,9116
2002,5323,3425,5082,32285,32113,582,11.606,447,8.914,6861,3047,3814,9.489,21.366,6315,2105,4210,6.555,19.665,546,1.700,39.330,252,258,1200
2002,5324,7205,12006,155685,157388,1348,11.237,1329,11.078,29757,10021,19736,6.367,18.907,33566,12147,21419,7.718,21.327,-3809,-2.420,37.814,675,716,5036
2002,5331,1918,2044,26113,25678,279,13.730,255,12.549,6572,2779,3793,10.823,25.594,5639,2027,3612,7.894,21.961,933,3.634,43.922,169,169,1080
2002,5411,154593,162775,1141449,1128383,15578,9.611,14211,8.767,172473,63755,108718,5.650,15.285,146195,58103,88092,5.149,12.956,26278,2.329,25.912,9577,9683,40722
2002,5412,87994,99692,1242438,1240205,15155,15.629,9709,10.012,332046,177080,154966,14.278,26.773,330408,170021,160387,13.709,26.641,1638,0.132,53.283,5520,5556,32759
2002,5413,83226,94685,1255132,1266587,10816,11.446,10439,11.047,230471,79607,150864,6.285,18.196,253773,98573,155200,7.783,20.036,-23302,-1.840,36.392,6233,6305,39354
2002,5414,25193,25431,117337,123994,3800,14.957,3752,14.768,21468,10442,11026,8.421,17.314,34868,14116,20752,11.384,28.121,-13400,-10.807,34.628,2666,2676,10071
2002,5415,75872,85927,1097887,1188616,16806,19.236,19689,22.536,246990,119895,127095,10.087,20.780,427263,161069,266194,13.551,35.946,-180273,-15.167,41.559,12894,13084,87208
2002,5416,76825,82048,686146,695168,16456,20.319,14335,17.700,155075,68788,86287,9.895,22.308,174141,75111,99030,10.805,25.050,-19066,-2.743,44.615,9645,9674,44237
2002,5417,10339,13335,603263,604124,1896,14.321,1705,12.878,99142,30737,68405,5.088,16.411,101711,39364,62347,6.516,16.836,-2569,-0.425,32.822,895,911,10175
2002,5418,30293,33532,405960,428911,3900,11.477,4800,14.125,67860,29199,38661,6.808,15.821,113467,40603,72864,9.467,26.455,-45607,-10.633,31.643,3254,3269,20700
2002,5419,48042,55944,506287,505899,6676,12.013,5930,10.671,99220,36068,63152,7.129,19.613,98253,32188,66065,6.363,19.421,967,0.191,38.843,3698,3728,19153
2002,5511,26619,47232,2831498,2903231,5426,11.279,7175,14.915,520091,186734,333357,6.432,17.914,662845,223995,438850,7.715,22.831,-142754,-4.917,35.828,1498,1589,31479
2002,5611,16224,18242,386080,389628,3285,18.000,3301,18.088,99144,46684,52460,11.982,25.446,107127,51991,55136,13.344,27.495,-7983,-2.049,50.892,2306,2325,26084
2002,5612,1685,3354,142049,140422,699,20.900,680,20.332,40146,21438,18708,15.267,28.590,36727,11171,25556,7.955,26.155,3419,2.435,52.309,111,119,3737
2002,5613,25999,44364,3919823,4119374,6724,14.798,8875,19.531,1076717,325118,751599,7.892,26.138,1487666,465178,1022488,11.292,36.114,-410949,-9.976,52.276,3930,4113,220601
2002,5614,25771,30926,745124,749212,4152,13.364,4435,14.275,172125,63610,108515,8.490,22.974,180301,67781,112520,9.047,24.065,-8176,-1.091,45.948,2810,2882,29928
2002,5615,18818,26335,265074,284999,2090,7.589,4500,16.340,41502,18216,23286,6.392,14.562,81794,33754,48040,11.844,28.700,-40292,-14.138,29.124,2884,2972,14869
2002,5616,16556,20741,743517,735844,3158,15.249,3095,14.945,200611,87609,113002,11.906,27.263,187217,94131,93086,12.792,25.442,13394,1.820,50.885,1510,1605,20390
2002,5617,116925,123657,1520891,1526946,19678,15.868,20386,16.439,302607,112369,190238,7.359,19.818,313582,109024,204558,7.140,20.537,-10975,-0.719,39.636,13003,13028,63488
2002,5619,16655,18806,338848,391274,2361,12.451,2673,14.097,59646,22289,37357,5.697,15.244,160681,26924,133757,6.881,41.066,-101035,-25.822,30.488,1874,1907,17386
2002,5621,6205,8038,171525,170060,954,12.050,712,8.993,33398,14921,18477,8.774,19.639,30743,7912,22831,4.652,18.078,2655,1.561,36.156,508,516,3975
2002,5622,1444,2330,48546,49624,237,10.081,279,11.867,6892,2616,4276,5.272,13.888,9196,4632,4564,9.334,18.531,-2304,-4.643,27.777,144,146,2069
2002,5629,6099,6772,100931,100633,895,13.481,629,9.474,20842,6945,13897,6.901,20.711,20478,5580,14898,5.545,20.349,364,0.362,40.698,393,393,2985
2002,6111,17603,19836,790663,776047,1229,6.296,600,3.074,84754,22467,62287,2.895,10.921,55298,10075,45223,1.298,7.126,29456,3.796,14.251,353,357,6504
2002,6112,577,883,93138,90350,62,7.106,41,4.699,11718,3126,8592,3.460,12.970,5904,1106,4798,1.224,6.535,5814,6.435,13.069,24,27,690
2002,6113,2414,3166,1412829,1390952,213,6.838,111,3.563,122958,16773,106185,1.206,8.840,80247,13909,66338,1.000,5.769,42711,3.071,11.538,51,51,11477
2002,6114,6240,6864,66809,68121,1090,15.991,995,14.597,15848,7306,8542,10.725,23.265,18281,6439,11842,9.452,26.836,-2433,-3.572,46.529,654,689,3824
2002,6115,5508,6549,92547,91553,739,11.321,696,10.663,18756,5887,12869,6.430,20.487,16453,4891,11562,5.342,17.971,2303,2.515,35.942,454,460,3078
2002,6116,22801,24757,215316,212057,3737,15.438,2636,10.890,50674,19086,31588,9.000,23.896,44169,17445,26724,8.227,20.829,6505,3.068,41.658,1662,1686,9466
2002,6117,3569,3954,46540,44551,785,20.485,541,14.118,12365,6550,5815,14.702,27.755,8133,3097,5036,6.952,18.256,4232,9.499,36.511,372,376,2293
2002,6211,162694,185413,1868648,1836768,20014,10.946,14886,8.141,353918,148379,205539,8.078,19.269,291007,110373,180634,6.009,15.843,62911,3.425,31.687,9357,9631,66491
2002,6212,107379,111884,748468,739040,6721,6.038,5561,4.996,116885,35685,81200,4.829,15.816,98089,32043,66046,4.336,13.272,18796,2.543,26.545,3863,3930,21353
2002,6213,85399,93060,483132,467852,12437,13.723,7572,8.355,111610,47525,64085,10.158,23.856,80705,28595,52110,6.112,17.250,30905,6.606,34.500,4898,4965,18167
2002,6214,11736,24170,578810,575103,3130,13.263,1989,8.428,98666,39840,58826,6.927,17.156,92235,35407,56828,6.157,16.038,6431,1.118,32.076,615,646,10876
2002,6215,6158,10128,195200,188936,1720,16.707,2054,19.951,51434,26117,25317,13.823,27.223,38939,20819,18120,11.019,20.610,12495,6.613,41.219,477,503,5978
2002,6216,10979,15878,757864,749860,2976,19.264,2117,13.704,178687,66677,112010,8.892,23.829,161645,66764,94881,8.904,21.557,17042,2.273,43.113,866,937,24435
2002,6219,5181,8179,213171,205805,1200,15.101,735,9.249,49676,16641,33035,8.086,24.137,35525,17720,17805,8.610,17.262,14151,6.876,34.523,356,361,4419
2002,6221,3216,5208,4696014,4647908,202,3.869,227,4.348,373487,92555,280932,1.991,8.036,278573,84342,194231,1.815,5.994,94914,2.042,11.987,106,122,46485
2002,6222,487,613,219112,221671,32,5.136,52,8.347,21042,8281,12761,3.736,9.492,25957,7834,18123,3.534,11.710,-4915,-2.217,18.985,18,18,2116
2002,6223,322,605,185864,179520,59,9.858,46,7.686,23737,7283,16454,4.057,13.222,11751,4742,7009,2.641,6.546,11986,6.677,13.092,27,27,1388
2002,6231,8172,15769,1588100,1568898,1276,8.099,1249,7.927,202569,86500,116069,5.513,12.912,164982,81789,83193,5.213,10.516,37587,2.396,21.032,484,543,35230
2002,6232,7891,27562,489543,477357,3593,13.518,1626,6.118,96774,37565,59209,7.869,20.273,72269,21086,51183,4.417,15.139,24505,5.133,30.279,349,466,7587
2002,6233,12624,16684,561100,551050,2014,12.178,1722,10.412,85868,37593,48275,6.822,15.583,65849,26194,39655,4.753,11.950,20019,3.633,23.899,1102,1127,14813
2002,6239,3350,6063,158585,155880,683,11.500,435,7.324,25673,8515,17158,5.463,16.470,20221,5919,14302,3.797,12.972,5452,3.498,25.944,190,202,2624
2002,6241,33373,46561,891279,868097,5501,12.139,3011,6.644,168640,58393,110247,6.727,19.426,123019,32070,90949,3.694,14.171,45621,5.255,28.342,1538,1590,19993
2002,6242,9096,12111,146392,144520,1104,9.384,412,3.502,23841,7618,16223,5.271,16.497,20373,4468,15905,3.092,14.097,3468,2.400,28.194,214,215,3085
2002,6243,5105,8167,320350,319158,924,11.531,617,7.700,55428,16299,39129,5.107,17.367,53389,11511,41878,3.607,16.728,2039,0.639,33.456,224,235,5343
2002,6244,49766,63284,746823,746391,8008,12.839,6182,9.912,132467,55487,76980,7.434,17.748,132467,43177,89290,5.785,17.748,0,0.000,35.495,4240,4304,28549
2002,7111,7458,7579,130234,127799,1047,13.855,1003,13.272,33795,9893,23902,7.741,26.444,28633,9824,18809,7.687,22.405,5162,4.039,44.809,635,637,6251
2002,7112,3112,3263,101098,103219,462,13.880,593,17.816,17288,5091,12197,4.932,16.749,21243,6399,14844,6.199,20.581,-3955,-3.832,33.498,418,419,4767
2002,7113,4064,4300,94370,91637,654,15.533,475,11.281,22858,7666,15192,8.366,24.944,17484,5268,12216,5.749,19.080,5374,5.864,38.159,306,307,3007
2002,7114,2563,2626,15252,15705,467,17.982,409,15.749,3512,2212,1300,14.085,22.363,4399,2120,2279,13.499,28.011,-887,-5.648,44.726,289,290,1212
2002,7115,10446,10464,40543,42856,1981,19.024,1879,18.045,12203,5313,6890,12.397,28.474,17114,5326,11788,12.428,39.934,-4911,-11.459,56.949,1004,1006,2552
2002,7121,5547,5984,117779,117300,496,8.426,301,5.113,12131,3105,9026,2.647,10.342,11198,2034,9164,1.734,9.547,933,0.795,19.093,161,161,1545
2002,7131,1719,2464,121781,122163,350,14.104,385,15.515,17240,3436,13804,2.813,14.112,18850,2822,16028,2.310,15.430,-1610,-1.318,28.225,216,219,1475
2002,7132,1550,1925,163656,160613,233,12.110,231,12.006,24259,9530,14729,5.934,15.104,18330,10314,8016,6.422,11.413,5929,3.691,22.825,159,161,8828
2002,7139,44309,49227,992801,984190,6054,12.335,5756,11.728,173058,66592,106466,6.766,17.584,155828,51204,104624,5.203,15.833,17230,1.751,31.666,3726,3824,33091
2002,7211,35225,45227,1690062,1729511,4803,10.618,4818,10.651,235280,121674,113606,7.035,13.604,310851,96484,214367,5.579,17.973,-75571,-4.370,27.208,2868,2923,46855
2002,7212,5065,5529,36974,36984,614,11.057,662,11.921,7431,2347,5084,6.346,20.093,7418,2585,4833,6.990,20.058,13,0.035,40.115,355,356,1486
2002,7213,2390,2462,12762,13099,207,8.340,247,9.952,1695,626,1069,4.779,12.940,2372,971,1401,7.413,18.109,-677,-5.169,25.881,181,181,675
2002,7223,10340,27692,552772,542010,7377,27.810,5045,19.019,165525,102937,62588,18.992,30.539,138481,58439,80042,10.782,25.550,27044,4.990,51.099,1375,1416,9760
2002,7224,43018,43494,335650,332205,5413,12.402,5718,13.101,78487,38932,39555,11.719,23.626,71211,29470,41741,8.871,21.436,7276,2.190,42.872,4413,4423,22866
2002,7225,272557,376614,7446359,7412637,50292,13.498,42226,11.333,1410200,732704,677496,9.885,19.024,1340872,490047,850825,6.611,18.089,69328,0.935,36.178,27472,28664,291358
2002,8111,138768,152053,871269,874532,16112,10.631,15106,9.968,158419,67756,90663,7.748,18.115,164439,58686,105753,6.711,18.803,-6020,-0.688,36.229,10788,10928,41309
2002,8112,11541,13174,132318,132753,1777,13.390,1972,14.859,29816,15556,14260,11.718,22.460,30584,12062,18522,9.086,23.038,-768,-0.579,44.920,1245,1278,6281
2002,8113,21039,22262,170458,175172,2237,10.023,2352,10.538,29640,11560,18080,6.599,16.921,39118,15074,24044,8.605,22.331,-9478,-5.411,33.841,1528,1543,7270
2002,8114,20702,21850,113226,114436,2618,11.827,3191,14.415,18607,8264,10343,7.222,16.260,21186,9251,11935,8.084,18.513,-2579,-2.254,32.520,2309,2319,6506
2002,8121,75028,87654,526547,519568,11913,13.719,10274,11.832,110419,52546,57873,10.113,21.252,96628,39569,57059,7.616,18.598,13791,2.654,37.196,7480,7573,25755
2002,8122,14657,21165,145411,155474,1841,8.726,1709,8.100,26735,10586,16149,6.809,17.196,47714,9272,38442,5.964,30.689,-20979,-13.494,34.392,636,647,2701
2002,8123,32145,38385,373028,379542,3961,10.266,4360,11.300,54322,21815,32507,5.748,14.313,67366,24481,42885,6.450,17.749,-13044,-3.437,28.625,2982,3076,16268
2002,8129,20530,31183,229045,237369,5621,18.166,5141,16.614,56210,29302,26908,12.345,23.680,72600,29111,43489,12.264,30.585,-16390,-6.905,47.361,2375,2484,11767
2002,8131,164225,164389,1636112,1612644,9136,5.634,4658,2.873,185934,30182,155752,1.872,11.530,138880,16590,122290,1.029,8.612,47054,2.918,17.224,2399,2399,8722
2002,8132,11750,13814,142991,140342,1412,10.477,737,5.469,23365,7121,16244,5.074,16.649,18147,6088,12059,4.338,12.931,5218,3.718,25.861,403,403,3226
2002,8133,9522,11591,104726,103116,1406,12.483,750,6.659,18544,5681,12863,5.509,17.984,15374,4396,10978,4.263,14.909,3170,3.074,29.819,395,397,2541
2002,8134,27795,29815,316683,312987,1587,5.337,1431,4.812,44131,9971,34160,3.186,14.100,36497,5963,30534,1.905,11.661,7634,2.439,23.322,933,934,4000
2002,8139,60373,62425,508487,503722,3643,5.842,3517,5.640,76721,18606,58115,3.694,15.231,66806,16755,50051,3.326,13.262,9915,1.968,26.525,2245,2250,11198
2003,1131,460,514,5353,4924,67,13.035,67,13.035,2212,252,1960,5.118,44.927,1309,845,464,17.163,26.587,903,18.341,53.174,32,32,160
2003,1132,200,258,2257,2378,36,13.611,49,18.526,388,141,247,5.931,16.320,624,143,481,6.015,26.246,-236,-9.926,32.639,18,18,59
2003,1133,9556,9635,68125,68136,1001,10.258,1248,12.789,12889,3934,8955,5.774,18.917,12879,4675,8204,6.861,18.902,10,0.015,37.804,935,935,3097
2003,1141,1218,1232,6222,6400,210,16.935,226,18.226,1332,492,840,7.688,20.814,1653,651,1002,10.173,25.830,-321,-5.016,41.628,129,129,350
2003,1142,314,314,2492,2505,47,15.385,30,9.820,371,116,255,4.632,14.813,401,90,311,3.594,16.011,-30,-1.198,29.627,17,17,51
2003,1151,3983,4357,61102,60088,497,11.346,544,12.419,13247,3847,9400,6.402,22.046,11128,3512,7616,5.845,18.520,2119,3.527,37.039,363,363,2446
2003,1152,3690,3753,21710,21736,515,13.790,478,12.800,4018,1450,2568,6.671,18.486,4038,1471,2567,6.768,18.578,-20,-0.092,36.972,374,374,1145
2003,1153,1321,1372,15140,14674,201,14.714,189,13.836,3671,1165,2506,7.939,25.018,2762,942,1820,6.420,18.823,909,6.195,37.646,118,118,553
2003,2111,5580,6739,82477,85253,633,9.282,794,11.643,16655,6267,10388,7.351,19.536,22206,11337,10869,13.298,26.047,-5551,-6.511,39.072,375,384,2385
2003,2121,656,1067,69942,73251,126,11.460,191,17.372,9673,3762,5911,5.136,13.205,16147,6328,9819,8.639,22.043,-6474,-8.838,26.411,92,92,1574
2003,2122,193,263,24699,25199,26,9.386,54,19.495,2014,460,1554,1.825,7.992,2904,1165,1739,4.623,11.524,-890,-3.532,15.985,29,32,171
2003,2123,3168,5151,91681,92381,300,5.770,397,7.635,10734,2236,8498,2.420,11.619,12177,2893,9284,3.132,13.181,-1443,-1.562,23.239,226,232,1374
2003,2131,6768,8248,186305,187773,826,9.974,893,10.783,33105,7558,25547,4.025,17.630,35361,9519,25842,5.069,18.832,-2256,-1.201,35.261,533,547,4891
2003,2211,1540,9652,531169,531509,757,7.893,635,6.621,57529,15698,41831,2.953,10.824,58248,15032,43216,2.828,10.959,-719,-0.135,21.647,67,68,888
2003,2212,531,2632,89123,89378,320,12.310,255,9.810,14661,9457,5204,10.581,16.403,14677,6137,8540,6.866,16.421,-16,-0.018,32.807,27,31,386
2003,2213,4465,5310,42796,42251,405,7.734,258,4.927,5194,1963,3231,4.646,12.293,4066,1672,2394,3.957,9.623,1128,2.670,19.247,156,162,805
2003,2361,139891,140808,793522,775987,23799,17.058,21213,15.205,203935,80790,123145,10.411,26.281,169554,68313,101241,8.803,21.850,34381,4.431,43.700,13979,13979,48034
2003,2362,38102,39080,710076,716453,4290,10.969,4352,11.127,137318,37206,100112,5.193,19.166,149995,31732,118263,4.429,20.936,-12677,-1.769,38.333,3125,3126,21107
2003,2371,18433,19122,455251,480713,1607,8.316,2013,10.417,69251,11772,57479,2.449,14.406,118834,19208,99626,3.996,24.720,-49583,-10.314,28.812,1356,1356,9727
2003,2372,10085,10182,64511,62269,1807,17.894,1640,16.240,18228,7852,10376,12.610,29.273,13704,6898,6806,11.078,22.008,4524,7.265,44.015,1208,1237,4886
2003,2373,10157,10868,306124,311388,1086,9.999,1072,9.870,50637,7842,42795,2.518,16.262,61228,11053,50175,3.550,19.663,-10591,-3.401,32.523,687,689,5316
2003,2379,4280,4435,82781,83596,665,15.016,652,14.723,17164,5425,11739,6.490,20.532,18599,5306,13293,6.347,22.249,-1435,-1.717,41.064,461,464,3207
2003,2381,90764,91250,978386,968235,12883,14.163,12305,13.528,229234,65981,163253,6.815,23.675,208911,59925,148986,6.189,21.576,20323,2.099,43.153,8027,8029,43215
2003,2382,144383,147579,1737402,1740197,16330,11.172,13516,9.247,304380,80674,223706,4.636,17.491,309699,81066,228633,4.658,17.797,-5319,-0.306,34.982,9767,9774,53342
2003,2383,96391,97276,810076,804748,16085,16.669,14526,15.053,189510,60431,129079,7.509,23.549,179031,54395,124636,6.759,22.247,10479,1.302,44.494,10222,10223,39711
2003,2389,47881,48280,426305,426656,8259,17.370,6793,14.287,95687,33873,61814,7.939,22.427,96468,30036,66432,7.040,22.610,-781,-0.183,44.854,4602,4604,20819
2003,3111,1163,1729,45833,46443,94,5.407,113,6.500,4971,854,4117,1.839,10.703,6170,1647,4523,3.546,13.285,-1199,-2.582,21.407,56,56,640
2003,3112,463,786,56454,56368,43,5.433,54,6.822,5076,936,4140,1.661,9.005,4972,1936,3036,3.435,8.821,104,0.185,17.641,26,26,283
2003,3113,1511,1673,79001,80345,140,8.333,154,9.167,7549,1988,5561,2.474,9.396,10265,4039,6226,5.027,12.776,-2716,-3.380,18.791,98,104,1379
2003,3114,1263,1648,161898,163584,122,7.356,143,8.622,16035,3011,13024,1.841,9.802,19472,7563,11909,4.623,11.903,-3437,-2.101,19.605,77,77,2609
2003,3115,1057,1568,132689,132570,99,6.284,114,7.236,10686,1738,8948,1.311,8.061,10463,3352,7111,2.528,7.892,223,0.168,15.785,76,77,1032
2003,3116,3080,3695,494012,495032,220,5.932,247,6.660,33365,3400,29965,0.687,6.740,35919,11536,24383,2.330,7.256,-2554,-0.516,13.480,159,160,2389
2003,3117,575,672,38473,39005,63,9.375,63,9.375,4894,737,4157,1.890,12.547,5941,1463,4478,3.751,15.232,-1047,-2.684,25.095,43,45,649
2003,3118,9525,10447,315160,310732,981,9.350,1071,10.208,47883,10399,37484,3.347,15.410,38803,15538,23265,5.000,12.488,9080,2.922,24.975,833,839,6676
2003,3119,2692,3100,164005,160485,504,16.953,250,8.409,23332,8098,15234,5.046,14.538,16258,6372,9886,3.970,10.131,7074,4.408,20.261,167,169,2494
2003,3121,2264,2767,131452,133397,331,12.271,192,7.118,14400,3590,10810,2.691,10.795,18076,3880,14196,2.909,13.551,-3676,-2.756,21.590,129,129,917
2003,3122,88,112,23323,23386,13,11.982,6,5.530,1173,81,1092,0.346,5.016,1317,300,1017,1.283,5.632,-144,-0.616,10.032,4,4,15
2003,3131,351,534,60140,62916,38,7.011,54,9.963,3989,1853,2136,2.945,6.340,9355,3783,5572,6.013,14.869,-5366,-8.529,12.681,30,30,852
2003,3132,1319,1559,135069,138062,84,5.237,174,10.848,10159,2668,7491,1.932,7.358,15812,5770,10042,4.179,11.453,-5653,-4.095,14.717,125,127,1924
2003,3133,1376,1477,59905,61591,105,6.988,156,10.383,5150,1002,4148,1.627,8.362,8655,2413,6242,3.918,14.052,-3505,-5.691,16.723,122,122,1522
2003,3141,2500,2694,99887,101934,168,6.133,259,9.454,8273,2048,6225,2.009,8.116,12296,3660,8636,3.591,12.063,-4023,-3.947,16.232,196,198,1374
2003,3149,4521,4666,88879,89477,399,8.452,508,10.762,13282,4396,8886,4.913,14.844,14467,5607,8860,6.266,16.168,-1185,-1.324,29.688,400,402,4095
2003,3151,645,703,44008,47495,34,4.545,124,16.578,4006,988,3018,2.080,8.435,11146,4066,7080,8.561,23.468,-7140,-15.033,16.869,99,101,1665
2003,3152,8255,8504,223187,233959,1625,18.944,1773,20.669,43536,18847,24689,8.056,18.608,64850,35605,29245,15.219,27.719,-21314,-9.110,37.217,1511,1519,21225
2003,3159,1105,1143,26450,27509,97,8.172,185,15.586,3487,897,2590,3.261,12.676,5646,2431,3215,8.837,20.525,-2159,-7.848,25.352,153,153,1337
2003,3161,212,222,8446,8838,17,7.375,34,14.751,712,87,625,0.984,8.057,1487,469,1018,5.307,16.826,-775,-8.769,16.113,25,25,223
2003,3162,276,306,17079,18180,24,7.705,35,11.236,1044,190,854,1.045,5.743,3222,1904,1318,10.473,17.723,-2178,-11.981,11.485,22,22,846
2003,3169,784,801,17177,17115,75,9.225,99,12.177,2515,656,1859,3.833,14.695,2419,877,1542,5.124,14.134,96,0.561,28.268,83,83,590
2003,3211,3518,3959,111801,112817,274,6.837,371,9.258,10835,2578,8257,2.285,9.604,12938,4091,8847,3.626,11.468,-2103,-1.864,19.208,263,263,1794
2003,3212,1452,1849,110919,112014,97,5.211,122,6.554,10228,2224,8004,1.985,9.131,12289,3924,8365,3.503,10.971,-2061,-1.840,18.262,82,84,1829
2003,3219,9397,10226,308990,310960,906,8.819,1000,9.734,39190,11525,27665,3.706,12.603,43519,14686,28833,4.723,13.995,-4329,-1.392,25.206,742,745,6536
2003,3221,279,598,155280,159436,65,11.017,49,8.305,7540,3156,4384,1.979,4.729,16195,6574,9621,4.123,10.158,-8655,-5.429,9.458,20,21,1464
2003,3222,3138,4746,331940,335237,212,4.421,311,6.485,25677,7677,18000,2.290,7.659,31987,12330,19657,3.678,9.542,-6310,-1.882,15.319,174,186,4305
2003,3231,32533,34240,698761,709500,2083,5.983,3239,9.303,69308,19728,49580,2.781,9.769,90752,32272,58480,4.549,12.791,-21444,-3.022,19.537,2587,2626,19640
2003,3241,1051,2241,99077,98372,133,5.949,122,5.457,8654,3664,4990,3.725,8.797,7134,2058,5076,2.092,7.252,1520,1.545,14.504,57,57,558
2003,3251,1165,2303,176933,179811,122,5.278,139,6.013,9187,1817,7370,1.011,5.109,15023,2767,12256,1.539,8.355,-5836,-3.246,10.219,52,54,508
2003,3252,648,967,100124,101425,55,5.679,58,5.989,6791,2157,4634,2.127,6.696,9391,2204,7187,2.173,9.259,-2600,-2.563,13.391,26,28,558
2003,3253,617,862,30311,30599,56,6.407,80,9.153,3474,1615,1859,5.278,11.353,4101,1385,2716,4.526,13.402,-627,-2.049,22.707,48,50,691
2003,3254,1365,1757,251067,247649,138,7.888,123,7.031,24265,2899,21366,1.171,9.798,17781,3407,14374,1.376,7.180,6484,2.618,14.360,72,72,954
2003,3255,1481,1892,68014,69046,89,4.650,133,6.949,6032,1074,4958,1.555,8.736,7889,2527,5362,3.660,11.426,-1857,-2.690,17.473,84,87,965
2003,3256,1964,2202,107759,109756,125,5.570,209,9.314,10251,2271,7980,2.069,9.340,14397,5776,8621,5.263,13.117,-4146,-3.777,18.680,136,136,1541
2003,3259,2123,2765,114120,113453,211,7.626,215,7.770,11664,4372,7292,3.854,10.281,10485,3630,6855,3.200,9.242,1179,1.039,18.484,128,132,1423
2003,3261,9699,12269,748114,751393,600,4.830,905,7.286,78229,18139,60090,2.414,10.411,84527,28913,55614,3.848,11.249,-6298,-0.838,20.822,577,596,10134
2003,3262,1779,2291,173748,175681,119,5.140,167,7.214,13910,2590,11320,1.474,7.918,18101,5219,12882,2.971,10.303,-4191,-2.386,15.836,98,101,1460
2003,3271,1268,1476,60885,61479,117,7.826,155,10.368,5318,924,4394,1.503,8.650,6650,1574,5076,2.560,10.817,-1332,-2.167,17.300,112,112,498
2003,3272,1724,2042,111613,113322,150,7.276,189,9.168,9550,3034,6516,2.677,8.427,12873,3662,9211,3.231,11.360,-3323,-2.932,16.855,140,143,1247
2003,3273,5026,9114,206897,206774,459,5.032,476,5.218,27296,5614,21682,2.715,13.201,26873,5996,20877,2.900,12.996,423,0.205,25.993,233,253,3247
2003,3274,226,341,16460,16685,22,6.322,36,10.345,2010,152,1858,0.911,12.047,2485,869,1616,5.208,14.894,-475,-2.847,24.094,16,16,143
2003,3279,2368,2777,72340,73415,212,7.630,215,7.738,8019,1655,6364,2.254,10.923,10137,3525,6612,4.802,13.808,-2118,-2.885,21.846,133,135,1198
2003,3311,443,556,121669,122400,85,16.023,34,6.409,11751,8764,2987,7.160,9.600,12597,1984,10613,1.621,10.292,-846,-0.691,19.201,18,18,872
2003,3312,535,685,50537,51808,59,8.601,61,8.892,4890,1935,2955,3.735,9.439,7335,3925,3410,7.576,14.158,-2445,-4.719,18.877,29,30,987
2003,3313,408,552,66963,69269,30,5.286,61,10.749,3136,379,2757,0.547,4.527,7727,2760,4967,3.984,11.155,-4591,-6.628,9.055,28,28,708
2003,3314,756,965,62475,65118,68,7.021,75,7.744,3941,1606,2335,2.466,6.052,9217,2760,6457,4.238,14.154,-5276,-8.102,12.104,39,43,586
2003,3315,2051,2330,171108,176072,101,4.259,184,7.759,12339,2189,10150,1.243,7.008,22482,7690,14792,4.368,12.769,-10143,-5.761,14.016,129,133,4616
2003,3321,2464,2706,123624,125191,98,3.562,188,6.834,11118,2479,8639,1.980,8.881,14346,4296,10050,3.432,11.459,-3228,-2.578,17.762,115,115,1137
2003,3322,1316,1455,61174,61360,76,5.172,105,7.145,5759,1471,4288,2.397,9.386,6244,1291,4953,2.104,10.176,-485,-0.790,18.771,66,66,323
2003,3323,11834,12748,365017,374195,735,5.700,1027,7.965,39893,9145,30748,2.444,10.661,58234,17393,40841,4.648,15.562,-18341,-4.901,21.322,703,706,6733
2003,3324,1246,1536,89147,90522,61,3.920,101,6.491,7931,1370,6561,1.513,8.761,10497,2869,7628,3.169,11.596,-2566,-2.835,17.523,61,61,767
2003,3325,729,813,56931,58324,33,3.990,61,7.376,4003,1076,2927,1.845,6.863,6854,1210,5644,2.075,11.752,-2851,-4.888,13.727,43,43,350
2003,3326,1661,1847,60188,60753,125,6.713,155,8.324,5986,1861,4125,3.063,9.853,7181,1684,5497,2.772,11.820,-1195,-1.967,19.706,108,108,797
2003,3327,23499,23950,358124,365536,1299,5.325,2186,8.961,38553,8042,30511,2.200,10.547,53313,14392,38921,3.937,14.585,-14760,-4.038,21.094,1640,1647,8899
2003,3328,5438,5978,135885,137652,313,5.178,446,7.379,14499,3300,11199,2.397,10.533,18099,5711,12388,4.149,13.148,-3600,-2.615,21.066,314,314,2519
2003,3329,5717,6269,273195,278011,446,7.046,568,8.973,26007,8672,17335,3.119,9.355,35521,12916,22605,4.646,12.777,-9514,-3.422,18.709,424,425,4708
2003,3331,2449,2730,171245,175222,144,5.182,242,8.708,14045,2605,11440,1.487,8.016,22179,6190,15989,3.533,12.658,-8134,-4.642,16.031,149,150,1827
2003,3332,3748,3972,145037,148716,218,5.369,394,9.704,17107,3449,13658,2.319,11.503,24543,8614,15929,5.792,16.503,-7436,-5.000,23.006,269,270,2666
2003,3333,2088,2260,105563,108587,135,5.898,193,8.432,8585,2123,6462,1.955,7.906,14626,5095,9531,4.692,13.469,-6041,-5.563,15.812,140,140,2534
2003,3334,1453,1751,154408,157823,96,5.402,148,8.329,13370,2454,10916,1.555,8.472,19901,7539,12362,4.777,12.610,-6531,-4.138,16.943,77,79,1906
2003,3335,8067,8408,183826,188251,366,4.254,758,8.810,18395,4610,13785,2.449,9.772,27270,9701,17569,5.153,14.486,-8875,-4.714,19.543,565,568,5423
2003,3336,735,888,93241,96374,41,4.543,70,7.756,5800,1289,4511,1.338,6.018,12140,2046,10094,2.123,12.597,-6340,-6.579,12.037,31,32,448
2003,3339,5554,6241,288087,294444,334,5.304,447,7.098,23953,5783,18170,1.964,8.135,36672,10120,26552,3.437,12.455,-12719,-4.320,16.270,284,288,3061
2003,3341,1314,1411,130145,138513,159,11.201,176,12.399,14452,3614,10838,2.609,10.434,32123,9553,22570,6.897,23.191,-17671,-12.758,20.867,128,128,2046
2003,3342,1592,1818,148303,171791,125,6.717,211,11.338,11044,3826,7218,2.227,6.429,58303,14199,44104,8.265,33.938,-47259,-27.510,12.858,131,133,2870
2003,3343,489,511,23956,24626,59,11.535,60,11.730,1847,469,1378,1.904,7.500,3199,1191,2008,4.836,12.990,-1352,-5.490,15.000,45,46,412
2003,3344,4377,4992,386812,412601,328,6.428,549,10.759,33772,10592,23180,2.567,8.185,84840,28272,56568,6.852,20.562,-51068,-12.377,16.370,363,366,6797
2003,3345,4280,4946,406169,417070,310,6.179,452,9.009,41433,11463,29970,2.748,9.934,63421,14879,48542,3.568,15.206,-21988,-5.272,19.869,268,268,4267
2003,3346,765,815,36821,36463,90,10.778,130,15.569,6519,1523,4996,4.177,17.878,5808,1826,3982,5.008,15.928,711,1.950,31.857,101,101,670
2003,3351,1062,1165,62218,64221,59,5.000,89,7.542,4443,1216,3227,1.893,6.918,8463,3456,5007,5.381,13.178,-4020,-6.260,13.837,60,61,689
2003,3352,256,314,90925,92305,31,9.857,32,10.175,6179,2754,3425,2.984,6.694,8665,1200,7465,1.300,9.387,-2486,-2.693,13.388,21,21,149
2003,3353,2034,2404,146742,153530,125,5.119,201,8.231,8512,2132,6380,1.389,5.544,22039,5648,16391,3.679,14.355,-13527,-8.811,11.088,134,139,1394
2003,3359,1843,2184,158484,165546,137,6.182,201,9.070,11590,2894,8696,1.748,7.001,25688,6586,19102,3.978,15.517,-14098,-8.516,14.002,118,120,1865
2003,3361,270,338,206788,207607,27,7.860,38,11.063,10608,1506,9102,0.725,5.110,12652,1163,11489,0.560,6.094,-2044,-0.985,10.219,27,27,450
2003,3362,1790,2018,132787,128001,133,6.550,158,7.781,22512,4120,18392,3.219,17.587,12881,5387,7494,4.209,10.063,9631,7.524,20.126,111,112,2067
2003,3363,4298,5451,686741,683911,339,6.182,405,7.385,76183,15110,61073,2.209,11.139,71597,19396,52201,2.836,10.469,4586,0.671,20.938,254,258,5319
2003,3364,1147,1492,373255,384407,89,5.933,105,7.000,21591,10027,11564,2.608,5.617,44689,9479,35210,2.466,11.625,-23098,-6.009,11.233,75,76,1141
2003,3365,144,198,25499,27052,15,7.614,13,6.599,2778,142,2636,0.525,10.269,6041,1827,4214,6.754,22.331,-3263,-12.062,20.538,3,3,8
2003,3366,1516,1640,136123,135212,155,9.466,150,9.160,13197,2399,10798,1.774,9.760,11111,2960,8151,2.189,8.217,2086,1.543,16.435,103,103,1179
2003,3369,712,744,40457,39685,82,11.059,77,10.384,5085,885,4200,2.230,12.813,3486,1283,2203,3.233,8.784,1599,4.029,17.568,59,60,585
2003,3371,14717,15251,368438,378033,1211,7.845,1583,10.255,36840,8472,28368,2.241,9.745,55593,18073,37520,4.781,14.706,-18753,-4.961,19.490,1163,1167,9522
2003,3372,3933,4131,156786,160422,259,6.230,312,7.505,15191,3299,11892,2.056,9.469,22509,6010,16499,3.746,14.031,-7318,-4.562,18.939,230,231,2661
2003,3379,918,1045,45683,46256,52,4.917,77,7.281,4182,1107,3075,2.393,9.041,5475,1671,3804,3.613,11.836,-1293,-2.795,18.082,53,53,514
2003,3391,10549,11254,300200,301866,769,6.829,781,6.936,32703,7490,25213,2.481,10.834,35978,13615,22363,4.510,11.919,-3275,-1.085,21.667,596,596,4532
2003,3399,17656,18167,405088,407577,1455,7.922,1854,10.094,47845,10046,37799,2.465,11.739,52948,17473,35475,4.287,12.991,-5103,-1.252,23.478,1453,1456,10821
2003,4231,17864,24166,356445,355493,2079,8.592,2141,8.848,46945,12756,34189,3.588,13.206,44908,16505,28403,4.643,12.633,2037,0.573,25.265,1371,1411,8323
2003,4232,11092,12639,161514,160375,1348,10.688,1294,10.260,25937,7966,17971,4.967,16.173,23607,7793,15814,4.859,14.720,2330,1.453,29.440,911,935,5286
2003,4233,11441,16629,229777,226213,1516,9.183,1275,7.723,34388,9851,24537,4.355,15.202,27328,8968,18360,3.964,12.081,7060,3.121,24.161,742,769,4318
2003,4234,26265,33751,696735,695660,3896,11.523,4017,11.881,121303,55423,65880,7.967,17.437,118863,41246,77617,5.929,17.086,2440,0.351,34.173,2583,2653,16746
2003,4235,7465,10145,146368,146174,757,7.444,806,7.926,18621,6416,12205,4.389,12.739,18245,5869,12376,4.015,12.482,376,0.257,24.963,487,507,3082
2003,4236,20065,29472,465076,480681,2505,8.338,3646,12.136,70867,27815,43052,5.787,14.743,102420,37789,64631,7.862,21.307,-31553,-6.564,29.486,1827,1916,12006
2003,4237,11288,18014,210162,210260,1332,7.410,1257,6.992,26671,8340,18331,3.967,12.685,27315,9375,17940,4.459,12.991,-644,-0.306,25.370,674,741,5322
2003,4238,44075,58990,688561,692755,4111,6.897,5335,8.951,92746,33774,58972,4.875,13.388,101226,34983,66243,5.050,14.612,-8480,-1.224,26.776,3049,3187,16394
2003,4239,29076,31944,324386,320307,4067,12.832,3567,11.254,54489,16727,37762,5.222,17.012,46339,17212,29127,5.374,14.467,8150,2.544,28.934,2681,2717,10955
2003,4241,9689,12188,218790,213949,966,7.876,1120,9.132,32847,16800,16047,7.852,15.353,23434,9048,14386,4.229,10.953,9413,4.400,21.906,695,749,4051
2003,4242,5529,6984,250378,237635,831,11.916,811,11.629,53396,13036,40360,5.486,22.470,26980,11419,15561,4.805,11.354,26416,11.116,22.707,519,530,4955
2003,4243,14043,15201,193669,194385,1870,12.239,2026,13.260,36814,11081,25733,5.701,18.939,38184,15419,22765,7.932,19.644,-1370,-0.705,37.878,1564,1609,8414
2003,4244,26481,32146,762746,752339,3108,9.684,3005,9.363,108182,26238,81944,3.488,14.379,87465,30792,56673,4.093,11.626,20717,2.754,23.251,2143,2173,13855
2003,4245,4355,6914,64504,65004,393,5.620,551,7.879,9372,2092,7280,3.218,14.418,10331,2637,7694,4.057,15.893,-959,-1.475,28.835,302,318,1500
2003,4246,8847,12433,146356,145753,978,7.515,2141,16.451,24808,5267,19541,3.614,17.021,23451,11279,12172,7.738,16.090,1357,0.931,32.179,598,610,2555
2003,4247,5366,7502,104971,104897,483,6.329,742,9.723,20691,5553,15138,5.294,19.725,20707,7481,13226,7.132,19.740,-16,-0.015,39.450,347,374,1973
2003,4248,3195,3992,166450,163478,278,6.946,299,7.470,19356,4015,15341,2.456,11.840,13309,5548,7761,3.394,8.141,6047,3.699,16.282,215,220,3141
2003,4249,23977,29597,379637,381808,3432,11.620,3310,11.207,59773,17612,42161,4.613,15.655,64134,22673,41461,5.938,16.797,-4361,-1.142,31.311,2236,2261,11103
2003,4251,30087,31929,259273,255437,3013,9.489,2663,8.386,40276,11710,28566,4.584,15.768,32605,8653,23952,3.388,12.764,7671,3.003,25.529,1802,1814,4928
2003,4411,43781,47910,1285580,1271698,4802,10.090,4165,8.752,156116,51439,104677,4.045,12.276,128410,43181,85229,3.396,10.098,27706,2.179,20.195,3263,3287,30018
2003,4412,13223,14568,148021,143214,1616,11.262,1179,8.216,27664,10512,17152,7.340,19.317,18035,5729,12306,4.000,12.593,9629,6.724,25.186,877,903,4300
2003,4413,32354,55703,484330,482112,3975,7.129,4082,7.321,69777,22201,47576,4.605,14.473,65206,19961,45245,4.140,13.525,4571,0.948,27.050,2376,2591,11385
2003,4421,18884,26195,265890,259692,2823,10.829,2571,9.862,50516,18575,31941,7.153,19.452,38330,14736,23594,5.674,14.760,12186,4.692,29.520,1566,1726,9403
2003,4422,25467,34322,299265,293283,3752,11.055,2989,8.807,59974,26328,33646,8.977,20.449,48213,12655,35558,4.315,16.439,11761,4.010,32.878,1972,2045,6768
2003,4431,30202,49771,468031,459750,6421,13.029,5446,11.050,83720,36910,46810,8.028,18.210,67809,24791,43018,5.392,14.749,15911,3.461,29.498,3686,3966,15963
2003,4441,44714,64276,1039523,1031282,4550,7.101,4155,6.484,112287,40136,72151,3.892,10.888,95315,26670,68645,2.586,9.242,16972,1.646,18.485,2703,2842,14634
2003,4442,15640,18842,171739,170120,1460,7.712,1637,8.647,29343,7289,22054,4.285,17.248,25877,7470,18407,4.391,15.211,3466,2.037,30.422,1093,1124,4911
2003,4451,59830,86846,2571691,2558910,10841,12.613,9055,10.535,310409,141876,168533,5.544,12.131,286340,104662,181678,4.090,11.190,24069,0.941,22.380,6320,6409,38781
2003,4452,17108,21231,149346,142483,3560,16.844,3369,15.940,42050,20291,21759,14.241,29.512,27743,12300,15443,8.633,19.471,14307,10.041,38.942,1998,2046,8722
2003,4453,23236,26541,139665,136331,2931,11.171,2326,8.865,27799,10812,16987,7.931,20.391,21258,7891,13367,5.788,15.593,6541,4.798,31.186,1799,1812,6134
2003,4461,39182,78352,955732,948811,6084,7.811,5167,6.633,114162,40019,74143,4.218,12.032,102168,36988,65180,3.898,10.768,11994,1.264,21.536,2778,2981,15687
2003,4471,60819,112579,931442,928149,10135,8.946,11566,10.209,171985,62283,109702,6.710,18.530,165644,67642,98002,7.288,17.847,6341,0.683,35.693,5562,6053,32289
2003,4481,35044,84612,1101048,1060830,8749,10.377,8153,9.670,214419,59483,154936,5.607,20.212,132519,52812,79707,4.978,12.492,81900,7.720,24.984,3883,4065,17656
2003,4482,6141,26559,190887,200032,1906,7.091,2543,9.461,30522,10815,19707,5.407,15.259,47855,12796,35059,6.397,23.924,-17333,-8.665,30.517,769,1029,3728
2003,4483,18447,28209,163111,161241,2530,8.999,2343,8.333,27889,8580,19309,5.321,17.296,23913,8969,14944,5.562,14.831,3976,2.466,29.661,1362,1482,4356
2003,4511,27818,38221,403698,399928,3917,10.203,4255,11.084,75924,21402,54522,5.351,18.984,68864,24741,44123,6.186,17.219,7060,1.765,34.438,2643,2824,11142
2003,4512,6396,12028,141853,142203,1153,9.602,1112,9.261,18178,5160,13018,3.629,12.783,19074,5823,13251,4.095,13.413,-896,-0.630,25.566,657,675,2698
2003,4522,163,5361,774220,811003,265,4.842,489,8.935,44675,21958,22717,2.708,5.509,115782,35190,80592,4.339,14.276,-71107,-8.768,11.017,4,242,13656
2003,4523,8315,33998,1832119,1792643,3711,11.167,2178,6.554,200201,92020,108181,5.133,11.168,121609,37144,84465,2.072,6.784,78592,4.384,13.568,998,1149,11917
2003,4531,19504,20354,113285,114247,1800,8.748,2244,10.906,20018,6510,13508,5.698,17.522,21936,7345,14591,6.429,19.201,-1918,-1.679,35.043,1808,1832,5836
2003,4532,27793,39119,325515,323293,4075,10.359,4514,11.475,54069,17424,36645,5.390,16.724,49902,18816,31086,5.820,15.436,4167,1.289,30.871,3214,3304,11270
2003,4533,12264,16391,127004,123204,1688,10.263,1801,10.950,24000,7292,16708,5.919,19.480,16110,6215,9895,5.044,13.076,7890,6.404,26.152,1372,1383,4071
2003,4539,31062,39823,252264,247242,5226,13.200,4761,12.026,54793,21496,33297,8.694,22.162,44216,17768,26448,7.186,17.884,10577,4.278,35.767,3212,3334,12092
2003,4541,13233,14186,271700,269624,2253,16.151,1780,12.760,48652,17045,31607,6.322,18.044,44173,17426,26747,6.463,16.383,4479,1.661,32.766,1331,1353,6851
2003,4542,4537,5138,61723,61949,519,9.971,653,12.546,7637,2504,5133,4.042,12.328,8044,3817,4227,6.162,12.985,-407,-0.657,24.656,465,467,2487
2003,4543,22925,29036,241934,241137,2909,10.010,2960,10.185,36128,11897,24231,4.934,14.982,34595,12492,22103,5.180,14.347,1533,0.636,28.693,2031,2080,8065
2003,4811,578,3045,481938,489075,273,8.967,272,8.934,28612,10342,18270,2.115,5.850,41707,4030,37677,0.824,8.528,-13095,-2.678,11.700,67,96,1826
2003,4812,1829,1982,35204,34909,291,14.870,241,12.315,6031,2030,4001,5.815,17.277,5575,1280,4295,3.667,15.970,456,1.306,31.941,181,182,759
2003,4831,802,1177,47397,48177,128,10.640,180,14.963,8054,2733,5321,5.673,16.718,9296,5019,4277,10.418,19.296,-1242,-2.578,33.435,76,78,914
2003,4832,470,527,19317,19034,81,15.728,57,11.068,6641,5449,1192,28.628,34.891,5891,1985,3906,10.429,30.951,750,3.940,61.901,34,34,180
2003,4841,41855,51019,971484,983915,8487,16.693,8134,15.998,146820,42460,104360,4.315,14.922,171785,84494,87291,8.588,17.459,-24965,-2.537,29.844,5842,5925,30816
2003,4842,41556,44751,440229,441488,5485,12.101,6633,14.634,79077,24975,54102,5.657,17.911,81185,31330,49855,7.096,18.389,-2108,-0.477,35.823,4832,4864,20727
2003,4851,623,893,47115,46351,103,11.464,114,12.688,6893,3378,3515,7.288,14.871,5625,3036,2589,6.550,12.136,1268,2.736,24.271,62,66,1042
2003,4852,214,489,17672,15491,111,23.718,69,14.744,6575,2315,4260,14.945,42.445,2057,1356,701,8.754,13.279,4518,29.166,26.558,19,21,273
2003,4853,5855,5972,64204,63696,888,14.846,907,15.163,11527,4280,7247,6.719,18.097,10612,4395,6217,6.900,16.661,915,1.437,33.321,742,742,3805
2003,4854,3023,4232,181213,177929,309,7.263,354,8.321,25241,8419,16822,4.732,14.186,18572,5561,13011,3.125,10.438,6669,3.748,20.876,243,243,2716
2003,4855,1061,1173,28988,28428,114,9.657,129,10.928,4915,1181,3734,4.154,17.289,3868,1343,2525,4.724,13.606,1047,3.683,27.213,94,96,815
2003,4859,2527,2762,56556,55221,406,14.869,343,12.562,12252,4956,7296,8.975,22.187,9699,4219,5480,7.640,17.564,2553,4.623,35.128,261,262,2394
2003,4861,56,286,6153,6258,55,20.258,26,9.576,1564,464,1100,7.415,24.994,1802,879,923,14.047,28.797,-238,-3.803,49.988,0,0,0
2003,4862,126,1887,27199,28568,135,7.171,126,6.693,2925,1281,1644,4.484,10.239,5621,966,4655,3.381,19.676,-2696,-9.437,20.478,6,6,30
2003,4869,59,510,5787,6058,93,19.116,46,9.455,1836,1055,781,17.415,30.307,2258,523,1735,8.633,37.273,-422,-6.966,60.614,3,3,6
2003,4871,433,483,9159,8877,61,12.695,56,11.655,1669,397,1272,4.472,18.801,1101,382,719,4.303,12.403,568,6.399,24.806,40,40,188
2003,4872,1122,1152,11187,10947,174,14.904,205,17.559,2423,676,1747,6.175,22.134,1933,543,1390,4.960,17.658,490,4.476,35.316,132,132,403
2003,4879,126,129,1687,1599,15,11.321,22,16.604,304,44,260,2.753,19.018,134,43,91,2.690,8.383,170,10.635,16.766,13,13,24
2003,4881,3295,4676,131891,134439,631,13.722,476,10.351,23157,9915,13242,7.375,17.225,27438,7104,20334,5.284,20.409,-4281,-3.184,34.450,299,312,3742
2003,4882,443,869,25371,23915,145,17.417,72,8.649,5468,2199,3269,9.195,22.864,2558,784,1774,3.278,10.696,2910,12.168,21.392,28,29,238
2003,4883,1629,2118,78915,77243,244,11.602,214,10.176,16627,4688,11939,6.069,21.526,13433,4442,8991,5.751,17.391,3194,4.135,34.781,121,123,1636
2003,4884,6934,7304,60421,57722,1174,16.430,857,11.994,15380,7917,7463,13.716,26.645,10126,4136,5990,7.165,17.543,5254,9.102,35.086,649,653,2900
2003,4885,11146,15438,172155,167801,1802,11.777,1529,9.992,37453,14458,22995,8.616,22.320,28502,11305,17197,6.737,16.986,8951,5.334,33.971,927,951,5372
2003,4889,1025,1143,21308,20895,176,15.205,205,17.711,3936,1870,2066,8.950,18.837,3203,1040,2163,4.977,15.329,733,3.508,30.659,165,165,684
2003,4921,2838,8569,446900,476589,2656,34.247,1029,13.268,186983,184567,2416,38.727,39.234,246743,19913,226830,4.178,51.773,-59760,-12.539,78.467,375,377,2575
2003,4922,4169,4569,43890,44950,783,17.323,685,15.155,8395,3271,5124,7.277,18.677,10561,3851,6710,8.567,23.495,-2166,-4.819,37.353,564,573,3027
2003,4931,6684,12012,545870,545408,1175,9.767,1212,10.074,88688,25298,63390,4.638,16.261,88003,28540,59463,5.233,16.135,685,0.126,32.271,388,417,5696
2003,5111,15094,20487,699213,704800,1954,9.527,1999,9.747,68928,22349,46579,3.171,9.780,80579,20979,59600,2.977,11.433,-11651,-1.653,19.560,1208,1235,7445
2003,5112,6283,8631,336829,345262,973,11.078,1278,14.550,47274,19171,28103,5.553,13.692,64283,26152,38131,7.575,18.619,-17009,-4.926,27.384,699,730,8843
2003,5121,11727,15294,267583,261933,2197,14.368,2190,14.323,74311,39277,35034,14.995,28.370,60975,17719,43256,6.765,23.279,13336,5.091,46.558,1282,1297,6929
2003,5122,2531,2802,26989,28304,389,13.743,446,15.757,2835,1163,1672,4.109,10.016,5463,2825,2638,9.981,19.301,-2628,-9.285,20.033,322,326,1064
2003,5151,4666,9203,252751,250154,1673,19.043,838,9.538,39739,17476,22263,6.986,15.886,34803,12084,22719,4.831,13.913,4936,1.973,27.825,350,362,3222
2003,5152,314,874,44644,47458,91,10.190,129,14.446,4774,1268,3506,2.672,10.059,10492,2319,8173,4.886,22.108,-5718,-12.049,20.119,40,42,1292
2003,5173,6960,43736,1388440,1409076,5892,13.466,5931,13.555,226160,83643,142517,5.936,16.050,272957,163346,109611,11.592,19.371,-46797,-3.321,32.100,1107,1175,14564
2003,5174,416,554,13792,14704,85,15.004,110,19.417,1794,603,1191,4.101,12.201,3633,1651,1982,11.228,24.708,-1839,-12.507,24.402,65,67,882
2003,5179,5161,5989,78930,86092,1388,23.287,1331,22.330,16916,7223,9693,8.390,19.649,31242,14984,16258,17.405,36.289,-14326,-16.640,39.297,985,1009,8357
2003,5182,6924,12601,402854,410450,2373,19.011,2135,17.105,69630,30598,39032,7.455,16.964,84742,35279,49463,8.595,20.646,-15112,-3.682,33.929,778,796,9293
2003,5191,4330,5225,92515,94679,563,10.717,620,11.802,13130,4485,8645,4.737,13.868,17483,7754,9729,8.190,18.466,-4353,-4.598,27.736,427,439,3417
2003,5211,18,53,22256,22686,D,D,0,0.000,375,D,371,D,1.653,1219,0,1219,0.000,5.373,-844,-3.720,3.306,0,0,0
2003,5221,16904,113411,2065969,2086357,9517,8.464,7586,6.746,294250,110139,184111,5.279,14.104,337872,104992,232880,5.032,16.194,-43622,-2.091,28.207,501,650,7409
2003,5222,18243,48278,717871,694508,7040,14.854,5272,11.124,175110,68933,106177,9.925,25.214,127416,57699,69717,8.308,18.346,47694,6.867,36.692,1568,1692,8842
2003,5223,20363,30783,307120,289438,5404,18.321,2830,9.595,86986,32363,54623,11.181,30.053,52234,20292,31942,7.011,18.047,34752,12.007,36.093,1642,1728,8979
2003,5231,11868,42973,519157,559408,10078,24.536,6282,15.294,91093,44373,46720,7.932,16.284,178911,69506,109405,12.425,31.982,-87818,-15.698,32.568,1204,1402,6801
2003,5232,50,59,7028,6762,19,36.190,6,11.429,995,702,293,10.382,14.715,467,22,445,0.325,6.906,528,7.808,13.812,D,D,D
2003,5239,28996,32659,358157,362594,5841,18.200,4710,14.676,71756,39181,32575,10.806,19.790,79463,32071,47392,8.845,21.915,-7707,-2.126,39.579,3001,3025,12045
2003,5241,5441,29537,1499746,1521737,3641,12.134,4579,15.260,191500,61823,129677,4.063,12.584,235192,86042,149150,5.654,15.456,-43692,-2.871,25.169,353,389,6746
2003,5242,114837,127643,869587,845501,12779,10.089,10812,8.536,171958,56982,114976,6.739,20.338,123865,50530,73335,5.976,14.650,48093,5.688,29.300,7387,7505,24336
2003,5259,905,950,7281,6971,208,22.523,155,16.784,2322,904,1418,12.968,33.309,1713,804,909,11.533,24.573,609,8.736,49.146,104,104,503
2003,5311,87086,104047,543631,536987,11061,10.672,10255,9.894,108305,45863,62442,8.541,20.169,94350,37324,57026,6.951,17.570,13955,2.599,35.141,7164,7300,24146
2003,5312,57929,65472,296595,284346,10853,17.066,7099,11.163,72028,30684,41344,10.791,25.331,47158,20110,27048,7.072,16.585,24870,8.746,33.170,4536,4641,12912
2003,5313,53824,59882,570840,553319,9279,15.994,5545,9.558,115091,44141,70950,7.977,20.800,80357,30566,49791,5.524,14.523,34734,6.277,29.045,3834,3879,19166
2003,5321,4196,10388,167981,172375,1064,9.951,1672,15.638,22225,7853,14372,4.556,12.893,30786,13494,17292,7.828,17.860,-8561,-4.967,25.787,554,601,3145
2003,5322,12503,31275,271175,262451,2944,9.469,2578,8.292,50436,14486,35950,5.520,19.217,34113,13074,21039,4.982,12.998,16323,6.219,25.996,1456,1606,7106
2003,5323,3301,4884,32828,32654,346,6.998,467,9.445,5586,1743,3843,5.338,17.107,5219,1834,3385,5.616,15.983,367,1.124,31.965,249,280,1075
2003,5324,7228,11861,149347,152294,1215,10.208,1298,10.905,23554,7637,15917,5.015,15.466,29632,10087,19545,6.623,19.457,-6078,-3.991,30.932,647,657,3630
2003,5331,1944,2063,28911,27751,278,13.561,252,12.293,6171,3188,2983,11.488,22.237,3861,1674,2187,6.032,13.913,2310,8.324,27.826,169,170,776
2003,5411,156846,165184,1189847,1166728,15239,9.296,12743,7.773,174115,49238,124877,4.220,14.923,127835,42870,84965,3.674,10.957,46280,3.967,21.913,9261,9370,28291
2003,5412,89335,101714,1246491,1239619,11103,11.025,9082,9.019,253333,78369,174964,6.322,20.436,244315,80222,164093,6.472,19.709,9018,0.727,39.418,5611,5685,35571
2003,5413,82634,94543,1246243,1257276,10455,11.108,9614,10.214,196073,59910,136163,4.765,15.595,219810,58593,161217,4.660,17.483,-23737,-1.888,31.190,5986,6076,26768
2003,5414,25152,25429,116970,117667,3634,14.253,3767,14.775,23216,9652,13564,8.203,19.730,24541,9829,14712,8.353,20.856,-1325,-1.126,39.461,2741,2743,7321
2003,5415,73203,82945,1074387,1089421,15236,18.073,17952,21.295,224632,96134,128498,8.824,20.619,252987,109555,143432,10.056,23.222,-28355,-2.603,41.239,12117,12216,56891
2003,5416,80257,85872,730487,712742,17934,21.283,14716,17.464,184114,76572,107542,10.743,25.832,148948,71306,77642,10.004,20.898,35166,4.934,41.796,10210,10280,35867
2003,5417,10355,13328,604633,602777,1671,12.543,1659,12.453,89386,34057,55329,5.650,14.829,85556,27858,57698,4.622,14.194,3830,0.635,28.387,985,991,8919
2003,5418,29927,33087,403925,405024,3692,11.096,4063,12.211,67843,18837,49006,4.651,16.750,69508,27045,42463,6.677,17.161,-1665,-0.411,33.501,2960,2995,16300
2003,5419,51965,59373,537580,528595,7942,13.648,5582,9.592,105876,36313,69563,6.870,20.030,89401,28546,60855,5.400,16.913,16475,3.117,33.826,3574,3592,18149
2003,5511,26472,46604,2803468,2829231,4781,10.180,5504,11.719,487717,142779,344938,5.047,17.239,535216,185092,350124,6.542,18.917,-47499,-1.679,34.477,1152,1221,17340
2003,5611,17828,19675,412772,400902,4211,22.049,3057,16.007,106295,49388,56907,12.319,26.514,82186,35289,46897,8.802,20.500,24109,6.014,41.001,1855,1875,20835
2003,5612,1694,3159,138131,139853,471,14.735,546,17.081,26401,10633,15768,7.603,18.878,30222,14454,15768,10.335,21.610,-3821,-2.732,37.755,131,135,2156
2003,5613,26041,43225,3711266,3793108,5967,13.636,7033,16.072,933829,207965,725864,5.483,24.619,1091238,382433,708805,10.082,28.769,-157409,-4.150,49.238,3416,3552,162666
2003,5614,26080,31224,757139,751691,4161,13.380,3910,12.573,157111,55618,101493,7.399,20.901,145531,54739,90792,7.282,19.360,11580,1.541,38.721,2720,2858,25184
2003,5615,17428,23737,277970,282374,2565,10.253,5123,20.479,51455,19260,32195,6.821,18.222,60783,24552,36231,8.695,21.526,-9328,-3.303,36.445,2343,2395,8871
2003,5616,16582,20890,738830,741153,2533,12.190,2313,11.131,164502,49143,115359,6.631,22.195,166320,43446,122874,5.862,22.441,-1818,-0.245,44.391,1546,1562,20120
2003,5617,119112,125364,1542110,1531878,19584,15.735,17785,14.289,303449,95291,208158,6.221,19.809,281570,100611,180959,6.568,18.381,21879,1.428,36.761,11869,11902,58232
2003,5619,16487,18579,349968,345071,2166,11.595,2369,12.682,74774,18110,56664,5.248,21.669,63857,23066,40791,6.684,18.505,10917,3.164,37.011,1617,1650,10344
2003,5621,6214,7943,176769,173442,709,8.900,755,9.478,24633,6919,17714,3.989,14.202,18307,7781,10526,4.486,10.555,6326,3.647,21.110,497,499,3578
2003,5622,1431,2414,53089,52240,278,11.593,246,10.259,8813,2991,5822,5.725,16.870,7178,3089,4089,5.913,13.740,1635,3.130,27.481,137,137,1227
2003,5629,6166,6823,102054,101200,739,10.872,687,10.107,23197,7487,15710,7.398,22.922,21288,5873,15415,5.803,21.036,1909,1.886,42.071,471,479,3804
2003,6111,17785,19850,803233,794906,1011,5.116,834,4.220,79377,15083,64294,1.897,9.986,62951,12390,50561,1.559,7.919,16426,2.066,15.839,504,514,6702
2003,6112,547,852,92896,92189,38,4.413,56,6.504,11169,463,10706,0.502,12.115,9856,908,8948,0.985,10.691,1313,1.424,21.382,28,35,544
2003,6113,2426,3237,1443177,1426155,207,6.479,123,3.850,107089,4543,102546,0.319,7.509,73692,5553,68139,0.389,5.167,33397,2.342,10.334,83,83,2058
2003,6114,5917,6449,63814,64996,855,12.908,1205,18.191,12116,3847,8269,5.919,18.641,14423,6374,8049,9.807,22.191,-2307,-3.549,37.283,784,819,4247
2003,6115,5703,6738,94755,93452,755,11.329,608,9.123,19003,5563,13440,5.953,20.335,16307,6452,9855,6.904,17.450,2696,2.885,34.899,406,424,4015
2003,6116,24422,26377,235278,225873,4143,16.210,2507,9.809,56713,19711,37002,8.727,25.108,38265,12763,25502,5.651,16.941,18448,8.167,33.882,1798,1829,9541
2003,6117,3885,4322,49015,48111,893,21.456,573,13.767,11528,4309,7219,8.956,23.962,9776,3623,6153,7.531,20.320,1752,3.642,40.640,393,395,1416
2003,6211,167108,190164,1961060,1918401,17410,9.260,13097,6.966,326329,103718,222611,5.406,17.010,240454,77241,163213,4.026,12.534,85875,4.476,25.068,8970,9182,42658
2003,6212,108758,113353,771457,759275,6187,5.499,4517,4.014,113124,33590,79534,4.424,14.899,88411,24386,64025,3.212,11.644,24713,3.255,23.288,3554,3588,19915
2003,6213,88907,96727,517618,500532,11497,12.147,7343,7.758,110597,40621,69976,8.116,22.096,76389,26866,49523,5.367,15.262,34208,6.834,30.523,5149,5252,16621
2003,6214,12159,24143,621001,600030,2340,9.694,2330,9.653,118594,30489,88105,5.081,19.765,77066,34072,42994,5.678,12.844,41528,6.921,25.687,690,741,7946
2003,6215,6356,9709,203861,198821,1323,13.337,1744,17.582,44232,20537,23695,10.329,22.247,33624,17426,16198,8.765,16.912,10608,5.335,33.823,504,1136,11107
2003,6216,11347,16451,804707,779165,2474,15.436,1627,10.151,155246,41406,113840,5.314,19.925,104517,30648,73869,3.933,13.414,50729,6.511,26.828,983,1049,15384
2003,6219,5302,8211,223804,218031,802,9.808,734,8.976,40567,12474,28093,5.721,18.606,29211,10488,18723,4.810,13.398,11356,5.208,26.795,383,390,4208
2003,6221,3236,5297,4776231,4739632,166,3.149,114,2.163,269256,48173,221083,1.016,5.681,196899,52929,143970,1.117,4.154,72357,1.527,8.309,37,37,10567
2003,6222,489,622,214777,215682,36,5.821,29,4.689,12270,5605,6665,2.599,5.689,13422,8803,4619,4.081,6.223,-1152,-0.534,11.378,9,9,4179
2003,6223,378,659,186620,185750,86,13.333,58,8.992,16215,4826,11389,2.598,8.729,14587,10260,4327,5.524,7.853,1628,0.876,15.706,14,14,2846
2003,6231,8261,15785,1603034,1593851,1072,6.806,1002,6.362,174482,62680,111802,3.933,10.947,155585,65491,90094,4.109,9.762,18897,1.186,19.523,483,551,31564
2003,6232,7949,27899,514908,500019,1945,7.041,1397,5.057,91245,20625,70620,4.125,18.248,61102,16652,44450,3.330,12.220,30143,6.028,24.440,370,433,5912
2003,6233,12789,16924,594866,578622,1805,10.710,1663,9.868,88763,30608,58155,5.290,15.340,56230,25038,31192,4.327,9.718,32533,5.622,19.436,1206,1224,16177
2003,6239,3410,5955,159018,156892,448,7.514,462,7.749,23931,5334,18597,3.400,15.253,19638,5651,13987,3.602,12.517,4293,2.736,25.034,176,193,2257
2003,6241,34405,47835,932973,914994,4302,9.099,3193,6.753,152527,35655,116872,3.897,16.670,116266,24613,91653,2.690,12.707,36261,3.963,25.414,1755,1824,11284
2003,6242,9121,12236,152675,150405,693,5.681,619,5.074,21644,4334,17310,2.882,14.391,16968,4132,12836,2.747,11.282,4676,3.109,22.563,298,302,1921
2003,6243,5011,8028,326600,323630,535,6.640,593,7.360,49565,7099,42466,2.194,15.315,43468,7669,35799,2.370,13.431,6097,1.884,26.863,197,214,1859
2003,6244,51185,64830,772780,759675,7320,11.402,6061,9.441,133675,47733,85942,6.283,17.596,108222,36634,71588,4.822,14.246,25453,3.351,28.492,4356,4408,24117
2003,7111,7446,7611,131358,130617,951,12.511,932,12.261,28138,6635,21503,5.080,21.542,26801,6812,19989,5.215,20.519,1337,1.024,41.038,654,654,4651
2003,7112,3145,3311,111533,108022,537,16.228,533,16.108,23662,8038,15624,7.441,21.905,16977,5565,11412,5.152,15.716,6685,6.189,31.433,430,433,4122
2003,7113,4214,4479,98376,95810,662,15.097,474,10.810,24615,7243,17372,7.560,25.692,19181,7762,11419,8.101,20.020,5434,5.672,40.040,305,306,5443
2003,7114,2585,2647,15696,15432,423,16.044,402,15.247,3424,1584,1840,10.265,22.188,2807,1243,1564,8.055,18.190,617,3.998,36.380,288,288,913
2003,7115,11035,11056,41728,41408,2392,22.152,1876,17.374,14443,7004,7439,16.915,34.880,13840,5427,8413,13.106,33.424,603,1.456,66.848,1112,1112,3196
2003,7121,5703,6135,120147,123936,473,7.799,333,5.491,12836,1682,11154,1.357,10.357,20934,1253,19681,1.011,16.891,-8098,-6.534,20.714,191,191,789
2003,7131,1720,2390,133236,127644,299,12.264,395,16.202,27842,3575,24267,2.801,21.812,15859,5750,10109,4.505,12.424,11983,9.388,24.849,236,236,2642
2003,7132,1584,1994,162341,159674,225,11.430,174,8.839,19849,6881,12968,4.309,12.431,14798,4947,9851,3.098,9.268,5051,3.163,18.535,121,127,4187
2003,7139,45993,50979,1020501,1005500,6708,13.392,4929,9.840,177341,59618,117723,5.929,17.637,146703,43267,103436,4.303,14.590,30638,3.047,29.180,3549,3594,28194
2003,7211,35783,45764,1746422,1718259,4637,10.182,4190,9.201,243951,88447,155504,5.147,14.198,189282,66168,123114,3.851,11.016,54669,3.182,22.032,2752,2828,36211
2003,7212,5013,5464,37151,36911,513,9.348,561,10.222,6880,1652,5228,4.476,18.640,6349,1905,4444,5.161,17.201,531,1.439,34.402,318,319,1113
2003,7213,2338,2418,13316,13070,149,6.077,217,8.850,2177,527,1650,4.032,16.656,1714,545,1169,4.170,13.114,463,3.542,26.228,156,156,355
2003,7223,10635,27574,550314,550738,4606,16.622,4877,17.600,125730,61564,64166,11.178,22.829,126040,73929,52111,13.424,22.886,-310,-0.056,45.659,1357,1393,8198
2003,7224,43002,43499,351969,344963,5382,12.352,5525,12.681,82725,39544,43181,11.463,23.981,68766,28696,40070,8.319,19.934,13959,4.047,39.869,4535,4547,24154
2003,7225,280809,387040,7733683,7588130,50977,13.353,40433,10.591,1465798,696935,768863,9.185,19.317,1175379,446031,729348,5.878,15.490,290419,3.827,30.979,29286,30154,281539
2003,8111,139279,151995,893495,882976,15267,10.048,15147,9.969,166931,61646,105285,6.982,18.906,146021,57336,88685,6.493,16.537,20910,2.368,33.075,10939,11140,40303
2003,8112,11330,12839,132464,132768,1350,10.380,1684,12.948,24021,6155,17866,4.636,18.093,24973,8881,16092,6.689,18.810,-952,-0.717,36.185,1209,1215,4805
2003,8113,20689,21855,171798,171383,2019,9.169,2348,10.663,30454,9130,21324,5.327,17.770,29335,10840,18495,6.325,17.117,1119,0.653,34.233,1698,1721,6596
2003,8114,20898,22128,110127,112363,2827,12.835,2622,11.904,21592,6871,14721,6.115,19.216,25560,7721,17839,6.871,22.748,-3968,-3.531,38.433,1967,1979,4991
2003,8121,77054,90403,551963,539733,12895,14.486,10127,11.376,112547,53198,59349,9.856,20.852,88405,39115,49290,7.247,16.379,24142,4.473,32.759,7691,8088,29984
2003,8122,14703,20889,145214,145278,889,4.230,1144,5.443,16208,3166,13042,2.179,11.157,16492,4251,12241,2.926,11.352,-284,-0.195,22.313,484,498,1696
2003,8123,32182,38143,366990,369024,3791,9.904,4058,10.602,53843,17303,36540,4.689,14.591,57241,22259,34982,6.032,15.511,-3398,-0.921,29.181,2974,3062,14928
2003,8129,22102,33092,238908,234063,6084,18.924,4200,13.064,55957,23891,32066,10.207,23.907,46536,20369,26167,8.702,19.882,9421,4.025,39.764,2439,2462,11320
2003,8131,166702,166932,1657950,1646151,9066,5.475,6357,3.839,180462,27297,153165,1.658,10.963,157201,23903,133298,1.452,9.550,23261,1.413,19.099,4147,4147,11273
2003,8132,12125,14078,143828,143209,1180,8.473,877,6.297,18291,4099,14192,2.862,12.772,17265,2885,14380,2.015,12.056,1026,0.716,24.112,586,587,1610
2003,8133,9914,12009,109903,107451,1168,9.869,820,6.929,19190,3844,15346,3.577,17.859,13891,3173,10718,2.953,12.928,5299,4.932,25.856,483,500,1866
2003,8134,27900,29905,320403,317767,1612,5.404,1456,4.881,43096,6969,36127,2.193,13.562,37746,6528,31218,2.054,11.879,5350,1.684,23.757,970,975,3545
2003,8139,59674,61688,521319,514017,3117,5.030,3682,5.942,75628,15095,60533,2.937,14.713,61251,12623,48628,2.456,11.916,14377,2.797,23.832,2542,2545,8774
2004,1131,391,437,4665,4779,63,14.483,59,13.563,535,211,324,4.415,11.195,765,468,297,9.793,16.008,-230,-4.813,22.390,37,37,151
2004,1132,162,211,2174,1985,28,12.874,41,18.851,694,507,187,25.548,34.971,312,169,143,8.516,15.722,382,19.249,31.444,28,28,142
2004,1133,9518,9598,69217,68566,1122,11.676,1145,11.915,13222,3678,9544,5.364,19.284,11990,4263,7727,6.217,17.487,1232,1.797,34.974,854,855,3400
2004,1141,1248,1262,6147,6114,220,17.685,184,14.791,1273,466,807,7.622,20.823,1246,464,782,7.590,20.381,27,0.442,40.762,112,112,343
2004,1142,303,303,2444,2456,43,14.215,42,13.884,288,85,203,3.462,11.729,313,153,160,6.231,12.747,-25,-1.018,23.458,29,29,111
2004,1151,3955,4279,61300,61222,466,10.807,532,12.338,10819,3394,7425,5.544,17.672,10595,4272,6323,6.978,17.306,224,0.366,34.612,334,334,1816
2004,1152,3691,3759,21279,21270,545,14.647,469,12.604,3803,1543,2260,7.255,17.880,3851,1629,2222,7.659,18.106,-48,-0.226,35.760,358,358,1283
2004,1153,1292,1333,15087,15045,198,14.843,200,14.993,2924,955,1969,6.348,19.435,2840,863,1977,5.736,18.877,84,0.558,37.753,142,142,546
2004,2111,5585,6666,80401,81020,613,9.171,649,9.710,13707,6511,7196,8.036,16.918,14631,6781,7850,8.370,18.059,-924,-1.140,33.836,325,330,2479
2004,2121,621,1011,69719,69644,111,10.678,168,16.162,11521,3624,7897,5.204,16.543,11444,5577,5867,8.008,16.432,77,0.111,32.865,84,90,1693
2004,2122,191,261,25585,25176,40,15.355,39,14.971,3154,1269,1885,5.041,12.528,2328,347,1981,1.378,9.247,826,3.281,18.494,27,27,109
2004,2123,3200,5180,94246,92965,404,7.809,391,7.558,12420,3614,8806,3.888,13.360,9969,3180,6789,3.421,10.723,2451,2.636,21.447,193,199,1021
2004,2131,7106,8594,197452,192246,986,11.651,723,8.544,33627,8608,25019,4.478,17.492,23081,7030,16051,3.657,12.006,10546,5.486,24.012,461,474,4276
2004,2211,1582,9622,504783,518331,787,8.167,816,8.468,42212,16098,26114,3.106,8.144,68957,17859,51098,3.445,13.304,-26745,-5.160,16.288,57,60,494
2004,2212,497,2478,83321,86280,100,3.925,239,9.382,7098,1964,5134,2.276,8.227,12957,3629,9328,4.206,15.017,-5859,-6.791,16.453,33,33,205
2004,2213,4329,5163,42076,41889,352,6.839,320,6.217,6126,2600,3526,6.207,14.625,5820,2488,3332,5.940,13.894,306,0.731,27.788,196,196,732
2004,2361,148772,149710,858290,826388,28559,19.623,20210,13.887,226615,85991,140624,10.406,27.422,162509,67114,95395,8.121,19.665,64106,7.757,39.330,13538,13540,47762
2004,2362,37855,38827,710279,709011,4327,11.169,4156,10.728,133553,28471,105082,4.016,18.837,131544,34300,97244,4.838,18.553,2009,0.283,37.106,3026,3032,24646
2004,2371,18208,18912,454217,455098,1584,8.323,1825,9.589,92263,14680,77583,3.226,20.273,93824,15623,78201,3.433,20.616,-1561,-0.343,40.546,1310,1312,10916
2004,2372,9729,9819,66580,64653,1395,14.096,1550,15.662,18225,6837,11388,10.575,28.189,14422,7655,6767,11.840,22.307,3803,5.882,44.614,1193,1193,5822
2004,2373,9940,10666,312216,308636,901,8.419,972,9.083,53317,8648,44669,2.802,17.275,46474,12952,33522,4.197,15.058,6843,2.217,30.116,647,648,7098
2004,2379,4211,4403,81368,82197,614,13.893,647,14.640,16009,4115,11894,5.006,19.476,17316,6804,10512,8.278,21.067,-1307,-1.590,38.953,467,467,2411
2004,2381,93009,93484,1043282,1010212,14386,15.586,12020,13.023,259456,65696,193760,6.503,25.683,193205,63116,130089,6.248,19.125,66251,6.558,38.250,8308,8314,48137
2004,2382,148675,151706,1779660,1758506,17745,11.854,13717,9.163,333671,79856,253815,4.541,18.975,291926,86547,205379,4.922,16.601,41745,2.374,33.202,9874,9920,57269
2004,2383,100674,101589,856926,832109,18607,18.713,14296,14.377,213009,62361,150648,7.494,25.599,163934,57534,106400,6.914,19.701,49075,5.898,39.402,10158,10166,42367
2004,2389,51634,52033,467965,446106,10124,20.236,6115,12.223,117491,39190,78301,8.785,26.337,74325,25497,48828,5.715,16.661,43166,9.676,33.322,4154,4157,17936
2004,3111,1156,1714,46642,46185,104,6.043,118,6.856,5699,2007,3692,4.346,12.340,4793,1667,3126,3.609,10.378,906,1.962,20.756,56,58,832
2004,3112,462,786,54906,55640,48,6.119,45,5.736,3081,802,2279,1.441,5.537,4638,657,3981,1.181,8.336,-1557,-2.798,11.075,24,24,278
2004,3113,1537,1709,79009,78980,157,9.279,123,7.270,8700,2605,6095,3.298,11.016,8734,1891,6843,2.394,11.059,-34,-0.043,22.031,88,89,892
2004,3114,1260,1655,164207,163605,130,7.872,123,7.448,16058,4485,11573,2.741,9.815,15178,4912,10266,3.002,9.277,880,0.538,18.555,80,80,699
2004,3115,1044,1550,134165,133542,93,5.990,98,6.312,10979,2209,8770,1.654,8.221,9524,1757,7767,1.316,7.132,1455,1.090,14.264,64,64,499
2004,3116,3068,3718,493586,494553,262,7.054,254,6.839,35986,11093,24893,2.243,7.276,39038,13763,25275,2.783,7.894,-3052,-0.617,14.553,175,177,2310
2004,3117,559,654,37843,38126,48,7.273,60,9.091,3795,688,3107,1.805,9.954,4405,1164,3241,3.053,11.554,-610,-1.600,19.908,46,46,557
2004,3118,9349,10222,306175,310363,865,8.401,1014,9.848,35362,8642,26720,2.784,11.394,43641,12904,30737,4.158,14.061,-8279,-2.668,22.788,799,803,6427
2004,3119,2810,3244,164136,165106,272,8.480,199,6.204,17872,5077,12795,3.075,10.825,19532,3924,15608,2.377,11.830,-1660,-1.005,21.649,128,128,1664
2004,3121,2330,2861,132303,132144,337,11.993,235,8.363,12603,3513,9090,2.658,9.537,12269,3273,8996,2.477,9.285,334,0.253,18.569,146,146,1268
2004,3122,104,128,21822,22599,16,13.115,4,3.279,868,190,678,0.841,3.841,2487,22,2465,0.097,11.005,-1619,-7.164,7.682,3,3,21
2004,3131,335,512,55008,57362,29,5.561,48,9.204,3239,872,2367,1.520,5.647,7996,2586,5410,4.508,13.940,-4757,-8.293,11.293,28,28,459
2004,3132,1236,1460,114555,124853,75,4.983,165,10.963,5634,779,4855,0.624,4.513,26689,10961,15728,8.779,21.376,-21055,-16.864,9.025,114,116,2121
2004,3133,1314,1401,54146,57006,107,7.438,182,12.652,5362,2206,3156,3.870,9.406,11015,3908,7107,6.855,19.323,-5653,-9.917,18.812,137,140,1850
2004,3141,2431,2615,95289,97558,185,6.980,256,9.659,10381,5010,5371,5.135,10.641,14995,6443,8552,6.604,15.370,-4614,-4.730,21.282,190,191,1514
2004,3149,4459,4595,84832,86524,401,8.657,475,10.255,11734,3225,8509,3.727,13.562,15208,5550,9658,6.414,17.577,-3474,-4.015,27.123,375,376,3454
2004,3151,572,625,38311,41131,48,7.251,122,18.429,2516,688,1828,1.673,6.117,8123,2968,5155,7.216,19.749,-5607,-13.632,12.234,104,104,1684
2004,3152,8021,8215,206224,212783,1536,18.401,1801,21.575,41721,17702,24019,8.319,19.607,55263,29025,26238,13.641,25.972,-13542,-6.364,39.215,1574,1580,21186
2004,3159,1033,1067,23737,25011,92,8.390,151,13.771,2325,577,1748,2.307,9.296,4803,2149,2654,8.592,19.204,-2478,-9.908,18.592,115,115,1615
2004,3161,213,223,7924,8253,22,9.821,24,10.714,776,277,499,3.356,9.403,1396,199,1197,2.411,16.915,-620,-7.512,18.805,18,18,114
2004,3162,278,309,16156,16423,30,9.677,32,10.323,1570,550,1020,3.349,9.560,2133,249,1884,1.516,12.988,-563,-3.428,19.120,26,26,222
2004,3169,788,802,17227,17159,89,11.049,96,11.918,2575,1208,1367,7.040,15.007,2370,880,1490,5.129,13.812,205,1.195,27.625,79,81,737
2004,3211,3552,3970,111940,111885,310,7.802,317,7.978,12370,3225,9145,2.882,11.056,12234,5019,7215,4.486,10.934,136,0.122,21.869,223,224,2524
2004,3212,1465,1846,112981,111854,103,5.565,113,6.105,12266,2039,10227,1.823,10.966,9939,4023,5916,3.597,8.886,2327,2.080,17.771,67,67,1202
2004,3219,9318,10177,315022,311788,893,8.740,974,9.533,41437,10507,30930,3.370,13.290,34914,13351,21563,4.282,11.198,6523,2.092,22.396,728,729,6618
2004,3221,297,611,150200,152824,40,6.595,31,5.111,8130,1545,6585,1.011,5.320,13064,3372,9692,2.206,8.548,-4934,-3.229,10.640,8,8,1128
2004,3222,3114,4673,316619,323248,192,4.072,276,5.854,20182,5249,14933,1.624,6.244,33226,10626,22600,3.287,10.279,-13044,-4.035,12.487,156,158,2694
2004,3231,31682,33352,674125,686191,1966,5.811,2922,8.637,60553,14186,46367,2.067,8.825,84615,26627,57988,3.880,12.331,-24062,-3.507,17.649,2344,2363,17205
2004,3241,1046,2340,101898,100351,276,12.024,187,8.146,11478,5179,6299,5.161,11.438,8286,2053,6233,2.046,8.257,3192,3.181,16.514,52,52,538
2004,3251,1162,2328,170268,173064,127,5.464,120,5.162,10863,3971,6892,2.295,6.277,16285,2602,13683,1.503,9.410,-5422,-3.133,12.554,50,50,650
2004,3252,661,994,95286,97472,81,8.232,61,6.199,7756,4534,3222,4.652,7.957,12211,1586,10625,1.627,12.528,-4455,-4.571,15.914,36,37,584
2004,3253,623,875,30855,30612,80,9.174,74,8.486,3595,1472,2123,4.809,11.744,3061,610,2451,1.993,10.000,534,1.744,19.999,38,39,215
2004,3254,1364,1755,242863,246251,126,7.186,123,7.015,21305,5768,15537,2.342,8.652,28500,8365,20135,3.397,11.574,-7195,-2.922,17.303,72,73,1316
2004,3255,1489,1898,66268,67073,111,5.861,103,5.438,6173,1567,4606,2.336,9.203,7800,2109,5691,3.144,11.629,-1627,-2.426,18.407,73,73,1275
2004,3256,1956,2198,106687,108501,145,6.573,161,7.298,9244,2294,6950,2.114,8.520,12994,2913,10081,2.685,11.976,-3750,-3.456,17.040,112,113,1432
2004,3259,2120,2758,113987,114485,159,5.735,188,6.781,10208,2084,8124,1.820,8.916,11157,3444,7713,3.008,9.745,-949,-0.829,17.833,112,112,907
2004,3261,9578,12103,731578,739048,583,4.782,759,6.226,67562,13499,54063,1.827,9.142,82808,24352,58456,3.295,11.205,-15246,-2.063,18.284,465,468,8059
2004,3262,1742,2246,164907,168658,102,4.504,139,6.138,10131,1538,8593,0.912,6.007,17587,3546,14041,2.102,10.428,-7456,-4.421,12.014,91,92,1118
2004,3271,1243,1444,56057,58363,100,6.817,146,9.952,3992,798,3194,1.367,6.840,8524,3359,5165,5.755,14.605,-4532,-7.765,13.680,106,110,1035
2004,3272,1738,2051,108395,109882,149,7.240,163,7.920,8316,1855,6461,1.688,7.568,11147,3969,7178,3.612,10.145,-2831,-2.576,15.136,112,112,790
2004,3273,4968,9127,211683,209471,454,4.967,479,5.241,27550,5975,21575,2.852,13.152,22981,5949,17032,2.840,10.971,4569,2.181,21.942,247,254,2979
2004,3274,222,340,18501,17488,23,6.735,26,7.613,3403,170,3233,0.972,19.459,1179,277,902,1.584,6.742,2224,12.717,13.484,19,19,121
2004,3279,2473,2881,73213,72809,291,10.257,203,7.155,9866,3021,6845,4.149,13.551,8918,2396,6522,3.291,12.249,948,1.302,24.497,130,130,931
2004,3311,488,604,108421,115285,124,21.071,93,15.803,9227,5215,4012,4.524,8.004,22788,12473,10315,10.819,19.767,-13561,-11.763,16.007,70,70,3736
2004,3312,507,648,46111,48263,51,7.640,90,13.483,3517,770,2747,1.595,7.287,7690,3539,4151,7.333,15.934,-4173,-8.646,14.574,51,53,1256
2004,3313,413,558,64482,65709,43,7.734,39,7.014,2984,965,2019,1.469,4.541,5419,1275,4144,1.940,8.247,-2435,-3.706,9.082,29,29,246
2004,3314,743,940,61335,62109,49,5.139,76,7.971,5646,2515,3131,4.049,9.091,7229,2645,4584,4.259,11.639,-1583,-2.549,18.181,40,41,878
2004,3315,1995,2256,164212,167407,110,4.790,191,8.317,12066,2630,9436,1.571,7.208,18406,6555,11851,3.916,10.995,-6340,-3.787,14.415,138,146,3265
2004,3321,2409,2657,120872,122042,95,3.539,149,5.551,10934,2313,8621,1.895,8.959,13219,4050,9169,3.319,10.832,-2285,-1.872,17.918,103,103,1308
2004,3322,1312,1440,56385,58736,85,5.852,110,7.573,3822,887,2935,1.510,6.507,8594,2226,6368,3.790,14.632,-4772,-8.124,13.014,70,70,476
2004,3323,11618,12530,370526,368497,730,5.764,1000,7.896,46706,9431,37275,2.559,12.675,42563,12210,30353,3.313,11.550,4143,1.124,23.101,753,757,7417
2004,3324,1257,1554,89682,89511,72,4.647,63,4.066,8373,1931,6442,2.157,9.354,8061,1681,6380,1.878,9.006,312,0.349,18.011,42,42,607
2004,3325,717,801,52782,54569,49,6.102,53,6.600,3627,905,2722,1.658,6.647,7076,1593,5483,2.919,12.967,-3449,-6.320,13.293,38,38,316
2004,3326,1639,1831,60267,60564,80,4.341,104,5.643,5578,1239,4339,2.046,9.210,6203,1808,4395,2.985,10.242,-625,-1.032,18.420,71,71,810
2004,3327,23126,23571,362890,361229,1320,5.549,1754,7.373,43685,8595,35090,2.379,12.093,40353,11408,28945,3.158,11.171,3332,0.922,22.342,1308,1312,6946
2004,3328,5376,5915,132451,133931,351,5.891,437,7.335,14916,3925,10991,2.931,11.137,17850,6050,11800,4.517,13.328,-2934,-2.191,22.274,296,310,3029
2004,3329,5679,6216,268071,270629,453,7.274,477,7.659,24903,4882,20021,1.804,9.202,30493,10578,19915,3.909,11.267,-5590,-2.066,18.404,337,338,4752
2004,3331,2477,2774,171997,171956,188,6.813,159,5.762,15497,3376,12121,1.963,9.012,15706,4715,10991,2.742,9.134,-209,-0.122,18.024,102,102,1324
2004,3332,3694,3910,137706,141115,258,6.547,320,8.120,13794,4227,9567,2.995,9.775,20547,7143,13404,5.062,14.560,-6753,-4.785,19.550,229,230,2149
2004,3333,2072,2229,101512,103678,153,6.795,198,8.794,10029,2544,7485,2.454,9.673,14112,2515,11597,2.426,13.611,-4083,-3.938,19.347,139,140,1613
2004,3334,1437,1730,147845,150655,102,5.857,125,7.178,11572,2491,9081,1.653,7.681,17678,4732,12946,3.141,11.734,-6106,-4.053,15.362,83,85,919
2004,3335,7857,8161,176207,179952,380,4.579,657,7.916,16891,4070,12821,2.262,9.386,24516,9056,15460,5.032,13.624,-7625,-4.237,18.773,476,480,4158
2004,3336,733,881,88674,90492,45,5.108,45,5.108,5150,261,4889,0.288,5.691,8744,1715,7029,1.895,9.663,-3594,-3.972,11.382,28,28,299
2004,3339,5484,6169,280667,284016,356,5.741,421,6.789,23359,7282,16077,2.564,8.225,30146,10553,19593,3.716,10.614,-6787,-2.390,16.449,280,285,4915
2004,3341,1298,1385,110767,118120,158,11.338,175,12.558,8779,1980,6799,1.676,7.432,23687,7998,15689,6.771,20.053,-14908,-12.621,14.865,132,134,2290
2004,3342,1583,1792,143209,148573,141,7.790,177,9.779,19596,4770,14826,3.211,13.190,31180,14888,16292,10.021,20.986,-11584,-7.797,26.379,103,103,2380
2004,3343,470,486,23085,23549,42,8.528,55,11.168,1998,387,1611,1.643,8.485,2919,753,2166,3.198,12.396,-921,-3.911,16.969,41,41,329
2004,3344,4198,4761,366730,376102,266,5.464,481,9.880,33223,7091,26132,1.885,8.834,51694,17769,33925,4.725,13.745,-18471,-4.911,17.667,318,324,7115
2004,3345,4291,4946,403955,400272,339,6.844,353,7.127,42388,10242,32146,2.559,10.590,34020,10841,23179,2.708,8.499,8368,2.091,16.998,230,234,2964
2004,3346,741,792,33612,35021,79,9.820,104,12.927,3560,1040,2520,2.970,10.165,6312,2833,3479,8.090,18.024,-2752,-7.858,20.331,80,80,671
2004,3351,1057,1154,60698,61512,77,6.629,92,7.921,4779,1374,3405,2.234,7.769,6430,1673,4757,2.720,10.453,-1651,-2.684,15.539,70,70,704
2004,3352,264,321,87126,88822,31,9.779,23,7.256,4536,122,4414,0.137,5.107,7673,1151,6522,1.296,8.639,-3137,-3.532,10.214,17,17,153
2004,3353,2010,2353,137681,141779,134,5.628,190,7.980,10947,4007,6940,2.826,7.721,19047,5844,13203,4.122,13.434,-8100,-5.713,15.442,113,118,1456
2004,3359,1845,2170,152622,155464,154,7.071,170,7.805,14265,3123,11142,2.009,9.176,19965,7773,12192,5.000,12.842,-5700,-3.666,18.352,91,92,1148
2004,3361,282,355,214805,210905,40,11.511,25,7.194,26911,11991,14920,5.686,12.760,18713,6133,12580,2.908,8.873,8198,3.887,17.745,20,20,299
2004,3362,1809,2052,142558,137538,180,8.813,161,7.882,21535,5459,16076,3.969,15.658,11597,3977,7620,2.892,8.432,9938,7.226,16.864,122,123,2193
2004,3363,4332,5449,681802,684631,335,6.128,370,6.768,57665,12898,44767,1.884,8.423,62502,13966,48536,2.040,9.129,-4837,-0.707,16.846,233,248,4214
2004,3364,1162,1517,362383,367851,115,7.621,99,6.561,20751,6541,14210,1.778,5.641,31807,4168,27639,1.133,8.647,-11056,-3.006,11.282,67,69,1212
2004,3365,143,193,24802,25217,13,6.650,18,9.207,2790,605,2185,2.399,11.064,3610,1239,2371,4.913,14.316,-820,-3.252,22.128,11,11,656
2004,3366,1530,1653,140868,138049,165,10.000,159,9.636,15196,3354,11842,2.430,11.008,9459,3329,6130,2.411,6.852,5737,4.156,13.704,106,106,1627
2004,3369,736,767,39344,39190,108,14.239,91,11.997,4861,1299,3562,3.315,12.404,4613,1112,3501,2.837,11.771,248,0.633,23.542,68,68,520
2004,3371,14537,15039,363542,365644,1258,8.289,1534,10.107,40935,10034,30901,2.744,11.195,44581,16048,28533,4.389,12.192,-3646,-0.997,22.391,1158,1166,8309
2004,3372,3833,4029,150067,153004,250,6.126,354,8.674,14983,3644,11339,2.382,9.793,20737,5350,15387,3.497,13.553,-5754,-3.761,19.585,286,288,3256
2004,3379,909,1043,46938,46340,75,7.167,82,7.836,6322,1836,4486,3.962,13.643,5067,1599,3468,3.451,10.935,1255,2.708,21.869,64,64,616
2004,3391,10712,11435,296586,296867,816,7.166,720,6.323,32374,5442,26932,1.833,10.905,33233,8975,24258,3.023,11.195,-859,-0.289,21.810,534,535,3875
2004,3399,17699,18186,392830,398598,1578,8.669,1611,8.850,43346,11922,31424,2.991,10.875,54639,14910,39729,3.741,13.708,-11293,-2.833,21.749,1275,1278,9306
2004,4231,17885,24177,362291,360229,1927,7.979,1872,7.752,42535,12534,30001,3.479,11.808,38265,12073,26192,3.351,10.622,4270,1.185,21.245,1192,1276,6695
2004,4232,11232,12777,160895,161591,1294,10.205,1100,8.675,21358,6910,14448,4.276,13.217,22737,6112,16625,3.782,14.071,-1379,-0.853,26.435,815,837,3580
2004,4233,11704,17036,245434,238126,1434,8.504,1088,6.452,37882,10622,27260,4.461,15.908,23263,7932,15331,3.331,9.769,14619,6.139,19.538,712,730,4370
2004,4234,25849,34571,709371,705155,4518,13.223,3711,10.861,124369,59755,64614,8.474,17.637,117198,41074,76124,5.825,16.620,7171,1.017,33.240,2273,2367,16563
2004,4235,7348,10000,146998,146842,617,6.124,767,7.613,16831,4069,12762,2.771,11.462,16686,5200,11486,3.541,11.363,145,0.099,22.726,453,461,2656
2004,4236,20010,29183,465568,465498,2540,8.670,2766,9.442,76595,30859,45736,6.629,16.454,77344,30111,47233,6.469,16.615,-749,-0.161,32.909,1436,1485,7953
2004,4237,11208,18010,215987,213158,1223,6.787,1243,6.898,28195,6753,21442,3.168,13.227,22496,8312,14184,3.899,10.554,5699,2.674,21.107,601,617,3145
2004,4238,43316,58026,689788,688838,3579,6.128,4333,7.419,82874,22560,60314,3.275,12.031,80806,30641,50165,4.448,11.731,2068,0.300,23.462,2663,2843,17935
2004,4239,28594,31463,331164,326599,3634,11.610,3309,10.572,52667,15821,36846,4.844,16.126,43790,17885,25905,5.476,13.408,8877,2.718,26.816,2552,2599,12447
2004,4241,9555,12183,205254,212536,943,7.753,903,7.424,25683,11385,14298,5.357,12.084,39053,25066,13987,11.794,18.375,-13370,-6.291,24.168,592,602,3499
2004,4242,5690,7317,269544,260885,878,12.222,612,8.519,43658,12200,31458,4.676,16.735,26576,8075,18501,3.095,10.187,17082,6.548,20.374,443,448,3470
2004,4243,14090,15208,195911,195983,1828,12.056,1738,11.462,31021,9476,21545,4.835,15.828,31326,10437,20889,5.325,15.984,-305,-0.156,31.657,1328,1345,6430
2004,4244,26281,32297,771791,765789,3091,9.613,2803,8.718,114455,31964,82491,4.174,14.946,102512,45442,57070,5.934,13.386,11943,1.560,26.773,2073,2094,15077
2004,4245,4251,6783,64404,64500,351,5.136,453,6.629,8181,2519,5662,3.905,12.684,8480,2322,6158,3.600,13.147,-299,-0.464,25.368,261,271,1199
2004,4246,8656,12179,144777,145646,753,6.129,966,7.863,19944,7204,12740,4.946,13.693,21622,6979,14643,4.792,14.846,-1678,-1.152,27.387,556,568,2752
2004,4247,5205,7251,107277,106655,470,6.371,723,9.800,16922,6569,10353,6.159,15.866,15674,6148,9526,5.764,14.696,1248,1.170,29.392,358,378,2451
2004,4248,3228,4025,169864,168048,288,7.194,245,6.120,16189,4230,11959,2.517,9.634,12690,4116,8574,2.449,7.551,3499,2.082,15.103,186,197,2766
2004,4249,23375,29143,384672,381841,3024,10.387,2965,10.184,58853,19515,39338,5.111,15.413,53747,18791,34956,4.921,14.076,5106,1.337,28.152,2204,2244,11389
2004,4251,32135,34049,272247,268519,4052,12.065,3123,9.299,43851,15072,28779,5.613,16.331,36180,11495,24685,4.281,13.474,7671,2.857,26.948,2197,2218,7251
2004,4411,44010,48306,1298532,1292502,4721,9.824,4225,8.791,137500,48928,88572,3.786,10.638,125351,43690,81661,3.380,9.698,12149,0.940,19.397,3367,3418,33605
2004,4412,13392,14819,159681,153766,1645,11.224,1320,9.006,29981,9593,20388,6.239,19.498,18076,8061,10015,5.242,11.756,11905,7.742,23.511,1033,1062,5995
2004,4413,32252,55981,492217,488311,3906,6.991,3692,6.608,67437,21327,46110,4.368,13.810,60121,19288,40833,3.950,12.312,7316,1.498,24.624,2466,2623,12168
2004,4421,19117,26559,271187,268873,2654,10.042,2394,9.058,43660,17245,26415,6.414,16.238,38823,15469,23354,5.753,14.439,4837,1.799,28.878,1654,1862,11971
2004,4422,25428,34349,305221,301313,3386,9.884,3204,9.353,56001,19752,36249,6.555,18.586,47476,16781,30695,5.569,15.756,8525,2.829,31.513,2192,2276,8707
2004,4431,30499,49480,499411,484310,5847,11.768,6260,12.599,96567,29020,67547,5.992,19.939,67070,30675,36395,6.334,13.849,29497,6.091,27.697,3823,4084,16444
2004,4441,44683,64207,1078307,1059302,4215,6.566,4192,6.530,114521,37330,77191,3.524,10.811,76574,25609,50965,2.418,7.229,37947,3.582,14.457,2874,3118,16686
2004,4442,15590,18834,173549,172628,1434,7.608,1463,7.762,26009,6624,19385,3.837,15.067,24388,6819,17569,3.950,14.128,1621,0.939,28.255,1043,1077,4685
2004,4451,61196,88094,2650729,2610608,10395,11.905,8836,10.120,357243,131872,225371,5.051,13.684,273914,88985,184929,3.409,10.492,83329,3.192,20.985,6531,6628,38864
2004,4452,17383,22000,150521,148886,4509,21.011,3429,15.979,36704,19264,17440,12.939,24.653,33927,16109,17818,10.820,22.787,2777,1.865,45.575,2499,2544,11769
2004,4453,23682,27008,143684,141707,2821,10.548,2292,8.570,25635,9916,15719,6.998,18.090,21794,7821,13973,5.519,15.380,3841,2.711,30.759,1830,1844,6345
2004,4461,40063,79789,1033192,995010,6961,8.797,5650,7.140,189344,62984,126360,6.330,19.029,115505,43453,72052,4.367,11.608,73839,7.421,23.217,3046,3128,15150
2004,4471,61732,111200,930897,932825,8808,7.859,10550,9.414,156284,52447,103837,5.622,16.754,160322,67029,93293,7.186,17.187,-4038,-0.433,33.508,5649,6631,40675
2004,4481,35091,85831,1184516,1143480,9350,10.972,8128,9.538,224063,71035,153028,6.212,19.595,140791,50320,90471,4.401,12.313,83272,7.282,24.625,4132,4727,20348
2004,4482,6144,26391,196909,193900,1628,6.147,1819,6.868,35558,8740,26818,4.507,18.338,29445,7993,21452,4.122,15.186,6113,3.153,30.371,584,689,2791
2004,4483,18538,28317,165266,164138,2379,8.423,2233,7.906,25653,8487,17166,5.171,15.629,23205,7946,15259,4.841,14.138,2448,1.491,28.275,1402,1452,4251
2004,4511,28109,38248,410495,407330,3930,10.270,3966,10.364,59454,24345,35109,5.977,14.596,53568,18833,34735,4.624,13.151,5886,1.445,26.302,2731,2809,10562
2004,4512,6293,11834,146616,144589,989,8.291,1178,9.876,23316,10480,12836,7.248,16.126,18761,5876,12885,4.064,12.975,4555,3.150,25.951,738,744,3090
2004,4522,129,5200,738856,755290,171,3.240,326,6.177,44309,15756,28553,2.086,5.866,74707,25992,48715,3.441,9.891,-30398,-4.025,11.733,50,64,1342
2004,4523,8731,35879,1997880,1915346,3999,11.427,2236,6.389,267413,62339,205074,3.255,13.962,105551,35424,70127,1.849,5.511,161862,8.451,11.022,1117,1151,5134
2004,4531,18969,19828,109710,111555,1728,8.607,2226,11.087,17623,5897,11726,5.286,15.798,21349,7054,14295,6.323,19.138,-3726,-3.340,31.595,1821,1835,5741
2004,4532,27486,38495,322920,325047,4284,11.030,4974,12.806,51301,20144,31157,6.197,15.783,55966,25060,30906,7.710,17.218,-4665,-1.435,31.565,3499,3711,14367
2004,4533,12223,16388,127565,127401,1593,9.701,1660,10.109,17860,6920,10940,5.432,14.019,17723,5522,12201,4.334,13.911,137,0.108,27.822,1314,1339,4017
2004,4539,31577,39999,254940,254587,4946,12.349,5049,12.607,48010,20785,27225,8.164,18.858,47361,17851,29510,7.012,18.603,649,0.255,37.206,3358,3918,12809
2004,4541,13778,14679,269295,269664,2158,14.987,1599,11.105,51079,19610,31469,7.272,18.942,51101,20364,30737,7.552,18.950,-22,-0.008,37.883,1127,1137,8199
2004,4542,4408,5005,54928,58486,523,10.349,620,12.269,6857,2618,4239,4.476,11.724,14265,3353,10912,5.733,24.390,-7408,-12.666,23.448,451,452,2017
2004,4543,22872,28713,234250,237236,2449,8.528,2459,8.563,29431,8479,20952,3.574,12.406,35539,14324,21215,6.038,14.980,-6108,-2.575,24.812,1630,1647,7729
2004,4811,585,3159,438119,460269,449,14.447,347,11.165,37174,18824,18350,4.090,8.077,81701,22199,59502,4.823,17.751,-44527,-9.674,16.153,62,65,721
2004,4812,1902,2069,37822,36753,327,16.140,241,11.895,6048,1730,4318,4.707,16.456,3988,1427,2561,3.883,10.851,2060,5.605,21.702,185,190,1225
2004,4831,785,1139,46643,46977,104,8.973,144,12.425,6203,1988,4215,4.232,13.204,6788,1490,5298,3.172,14.450,-585,-1.245,26.409,75,86,525
2004,4832,451,508,19303,19470,49,9.487,66,12.778,2075,327,1748,1.680,10.658,2468,506,1962,2.599,12.676,-393,-2.019,21.315,52,52,429
2004,4841,42867,52207,998423,983362,9081,17.606,7823,15.167,155443,63210,92233,6.428,15.807,124286,46416,77870,4.720,12.639,31157,3.168,25.278,5881,5960,29741
2004,4842,41576,44935,449289,445968,5871,13.067,5863,13.049,81668,27423,54245,6.149,18.313,74680,26614,48066,5.968,16.746,6988,1.567,33.491,4323,4381,18971
2004,4851,627,888,48688,48036,73,8.134,92,10.251,5828,786,5042,1.636,12.133,4743,2369,2374,4.932,9.874,1085,2.259,19.748,57,57,629
2004,4852,202,488,18172,17956,63,12.923,62,12.718,2402,950,1452,5.291,13.377,1968,742,1226,4.132,10.960,434,2.417,21.920,31,33,485
2004,4853,5830,5961,64070,64177,877,14.715,875,14.681,11458,4435,7023,6.911,17.854,11625,4991,6634,7.777,18.114,-167,-0.260,35.708,721,721,4299
2004,4854,3001,4152,180203,180347,221,5.272,301,7.180,21135,6820,14315,3.782,11.719,21597,9405,12192,5.215,11.975,-462,-0.256,23.438,185,185,2718
2004,4855,1046,1156,30008,29623,114,9.777,134,11.492,5298,903,4395,3.048,17.885,4477,1808,2669,6.103,15.114,821,2.772,30.227,104,108,1193
2004,4859,2525,2761,57660,56943,415,15.034,414,14.997,10905,3569,7336,6.268,19.151,9297,4412,4885,7.748,16.327,1608,2.824,32.654,323,324,3379
2004,4861,58,333,6290,6220,60,19.386,13,4.200,740,387,353,6.222,11.898,621,151,470,2.428,9.985,119,1.913,19.969,D,D,D
2004,4862,131,1620,24901,26634,373,21.266,641,36.545,7651,4938,2713,18.540,28.726,11152,7591,3561,28.501,41.871,-3501,-13.145,57.453,6,13,231
2004,4869,57,538,6018,5869,77,14.709,48,9.169,1196,927,269,15.795,20.378,915,505,410,8.605,15.590,281,4.788,31.181,3,3,170
2004,4871,441,492,8703,8861,68,13.906,62,12.679,1163,520,643,5.868,13.125,1448,588,860,6.636,16.341,-285,-3.216,26.250,41,42,289
2004,4872,1160,1196,11429,11353,205,17.388,171,14.504,2055,815,1240,7.179,18.101,1885,842,1043,7.417,16.604,170,1.497,33.207,119,119,671
2004,4879,123,126,2025,1852,11,8.661,13,10.236,512,201,311,10.853,27.646,150,25,125,1.350,8.099,362,19.546,16.199,8,8,17
2004,4881,3383,4811,145956,138966,552,11.626,426,8.972,29916,17357,12559,12.490,21.528,15287,5348,9939,3.848,11.001,14629,10.527,22.001,278,286,2223
2004,4882,441,874,26644,26291,70,8.005,71,8.119,3821,1204,2617,4.580,14.534,3010,1108,1902,4.214,11.449,811,3.085,22.898,39,47,756
2004,4883,1633,2145,82913,81119,169,7.882,167,7.789,12236,2567,9669,3.164,15.084,8734,1846,6888,2.276,10.767,3502,4.317,21.534,106,109,1412
2004,4884,7227,7657,63971,61649,1211,16.167,878,11.722,16350,8370,7980,13.577,26.521,11595,4794,6801,7.776,18.808,4755,7.713,37.616,683,687,3253
2004,4885,11557,16016,179437,176483,1846,11.712,1336,8.477,29347,11630,17717,6.590,16.629,23304,9966,13338,5.647,13.205,6043,3.424,26.409,874,914,4718
2004,4889,1151,1268,21697,21171,282,23.296,167,13.796,4146,1447,2699,6.835,19.583,3094,821,2273,3.878,14.614,1052,4.969,29.229,140,140,717
2004,4921,2837,8496,531844,500467,835,9.773,931,10.897,102409,25607,76802,5.117,20.463,42416,26681,15735,5.331,8.475,59993,11.987,16.951,392,400,1900
2004,4922,4067,4557,47112,48542,597,13.028,648,14.141,8106,2916,5190,6.007,16.699,10762,3456,7306,7.120,22.171,-2656,-5.472,33.398,534,536,2843
2004,4931,6789,12883,577005,563657,1724,13.792,958,7.664,99345,42318,57027,7.508,17.625,72669,21685,50984,3.847,12.892,26676,4.733,25.785,392,403,3624
2004,5111,15035,20776,702397,701245,2167,10.506,1869,9.061,75019,26925,48094,3.840,10.698,72188,21991,50197,3.136,10.294,2831,0.404,20.589,1206,1244,8365
2004,5112,6044,8439,326492,330147,933,10.937,1117,13.093,41101,13385,27716,4.054,12.449,48501,19856,28645,6.014,14.691,-7400,-2.241,24.899,578,617,8156
2004,5121,11940,15315,280655,279144,2195,14.328,2204,14.387,55092,20345,34747,7.288,19.736,51517,22700,28817,8.132,18.455,3575,1.281,36.911,1213,1234,5656
2004,5122,2585,2863,25322,25906,420,14.807,367,12.938,3271,1424,1847,5.497,12.627,4460,1438,3022,5.551,17.216,-1189,-4.590,25.253,272,273,787
2004,5151,4542,8977,243768,247604,796,8.779,976,10.764,28174,10267,17907,4.147,11.379,35946,10306,25640,4.162,14.518,-7772,-3.139,22.757,362,378,4149
2004,5152,335,858,43585,43842,384,44.342,400,46.189,16292,8508,7784,19.406,37.161,16421,15094,1327,34.428,37.455,-129,-0.294,74.321,36,36,859
2004,5173,6811,44081,1291759,1341050,6895,15.730,6400,14.601,234173,63414,170759,4.729,17.462,329984,98074,231910,7.313,24.606,-95811,-7.144,34.924,996,1161,12421
2004,5174,424,554,13334,13690,109,19.604,113,20.324,2605,1754,851,12.813,19.029,3339,1146,2193,8.371,24.391,-734,-5.362,38.058,67,67,420
2004,5179,5013,5806,69275,73645,1391,23.514,1610,27.217,17309,7249,10060,9.843,23.503,25980,13584,12396,18.445,35.277,-8671,-11.774,47.007,1169,1175,5994
2004,5182,7049,13190,378083,389722,2722,21.200,2021,15.740,78503,39879,38624,10.233,20.143,101732,46715,55017,11.987,26.104,-23229,-5.960,40.287,518,530,4560
2004,5191,4575,5502,97760,96359,684,12.756,404,7.535,15016,3589,11427,3.725,15.583,11923,2760,9163,2.864,12.374,3093,3.210,24.747,256,267,1509
2004,5211,19,57,21505,21882,5,9.009,D,D,650,435,215,1.988,2.971,1428,D,1423,D,6.526,-778,-3.556,5.941,D,D,D
2004,5221,16556,114149,2079114,2075512,6316,5.543,5918,5.194,287628,76394,211234,3.681,13.858,283458,75921,207537,3.658,13.657,4170,0.201,27.315,511,660,6466
2004,5222,18840,49726,758409,741497,9399,19.249,7606,15.577,208857,116223,92634,15.674,28.167,176118,87036,89082,11.738,23.752,32739,4.415,47.503,1800,1884,9693
2004,5223,22682,35087,318609,312701,6946,20.992,2950,8.915,83468,38468,45000,12.302,26.693,70631,28126,42505,8.995,22.587,12837,4.105,45.175,1765,1833,9569
2004,5231,12110,38248,512507,518384,6953,17.165,11472,28.321,143231,52730,90501,10.172,27.630,153558,79763,73795,15.387,29.622,-10327,-1.992,55.261,981,1010,4412
2004,5232,47,53,6654,6844,18,31.579,26,45.614,591,261,330,3.814,8.636,960,544,416,7.949,14.028,-369,-5.392,17.272,19,19,99
2004,5239,31218,35062,339648,350013,6274,18.406,4322,12.680,63942,31192,32750,8.912,18.268,86334,48495,37839,13.855,24.666,-22392,-6.397,36.537,2958,2976,19565
2004,5241,5895,31252,1488702,1496333,5048,16.574,3457,11.351,186354,75112,111242,5.020,12.454,202856,72740,130116,4.861,13.557,-16502,-1.103,24.908,365,391,6797
2004,5242,116427,129082,881663,874371,11957,9.319,10396,8.103,131199,48127,83072,5.504,15.005,116912,47113,69799,5.388,13.371,14287,1.634,26.742,7056,7249,24771
2004,5259,891,932,6691,6811,215,23.382,190,20.663,2054,656,1398,9.631,30.157,2223,1452,771,21.318,32.638,-169,-2.481,60.314,146,146,837
2004,5311,87354,104808,553742,547294,10525,10.099,9352,8.973,96181,40860,55321,7.466,17.574,83045,37015,46030,6.763,15.174,13136,2.400,30.347,7058,7266,27896
2004,5312,63681,71635,319346,308258,12786,18.569,7226,10.495,70455,34180,36275,11.088,22.856,48636,21110,27526,6.848,15.778,21819,7.078,31.555,4712,4802,13518
2004,5313,55604,62127,584034,575320,10018,16.570,6681,11.051,107280,49278,58002,8.565,18.647,89387,37526,51861,6.523,15.537,17893,3.110,31.074,4274,4363,23062
2004,5321,4147,10513,166889,167812,1262,12.068,1151,11.006,16280,7154,9126,4.263,9.701,17963,8119,9844,4.838,10.704,-1683,-1.003,19.403,489,547,2951
2004,5322,12407,31701,259640,265478,2934,9.323,2474,7.861,42764,16025,26739,6.036,16.108,52462,14792,37670,5.572,19.761,-9698,-3.653,32.217,1269,1670,7698
2004,5323,3262,5019,33035,32944,505,10.210,359,7.258,5890,2069,3821,6.280,17.879,5680,1633,4047,4.957,17.241,210,0.637,34.483,232,239,989
2004,5324,7339,12394,154642,151830,1725,14.193,1244,10.236,30996,10647,20349,7.012,20.415,25645,10197,15448,6.716,16.891,5351,3.524,33.781,624,641,3216
2004,5331,2053,2139,31433,29405,327,15.706,213,10.231,7772,3021,4751,10.274,26.431,3631,1529,2102,5.200,12.348,4141,14.083,24.697,147,148,992
2004,5411,160435,168968,1215016,1202580,15617,9.341,12052,7.209,161028,53058,107970,4.412,13.390,136231,47963,88268,3.988,11.328,24797,2.062,22.656,8821,8951,30678
2004,5412,91125,104198,1224364,1220604,11499,11.174,8917,8.665,239578,79036,160542,6.475,19.628,232215,89455,142760,7.329,19.025,7363,0.603,38.049,5613,5702,45359
2004,5413,84047,96403,1262917,1255573,10472,10.969,8605,9.013,195263,67804,127459,5.400,15.552,180238,70776,109462,5.637,14.355,15025,1.197,28.710,5447,5540,25559
2004,5414,25733,26007,118737,118288,3835,14.823,3565,13.779,22737,9354,13383,7.908,19.222,21859,9483,12376,8.017,18.480,878,0.742,36.959,2555,2564,6910
2004,5415,73665,84312,1099046,1091802,17097,20.457,15623,18.693,222989,93676,129313,8.580,20.424,209788,90380,119408,8.278,19.215,13201,1.209,38.430,10223,10312,44952
2004,5416,84691,90617,764327,751332,18404,20.769,14395,16.245,174566,79171,95395,10.537,23.234,150050,61651,88399,8.206,19.971,24516,3.263,39.942,10103,10163,39002
2004,5417,10738,14072,627489,616711,2087,15.203,1399,10.191,90485,22782,67703,3.694,14.672,69479,19265,50214,3.124,11.266,21006,3.406,22.532,853,872,7346
2004,5418,30104,33454,390013,396926,3904,11.707,3691,11.068,64582,19693,44889,4.961,16.271,79626,22076,57550,5.562,20.061,-15044,-3.790,32.541,2766,2783,14433
2004,5419,52629,60716,544339,539972,7572,12.661,5747,9.610,90270,31530,58740,5.839,16.718,81079,32323,48756,5.986,15.015,9191,1.702,30.031,4190,4235,24675
2004,5511,26130,46664,2776612,2809314,4195,8.989,4206,9.012,426541,145898,280643,5.193,15.183,489311,161932,327379,5.764,17.417,-62770,-2.234,30.366,1146,1201,20610
2004,5611,19904,21777,435151,422400,4722,22.702,2768,13.308,102511,48184,54327,11.407,24.269,76952,35711,41241,8.454,18.218,25559,6.051,36.436,1881,1901,23411
2004,5612,1636,3912,164181,153299,1127,32.017,343,9.744,44056,22932,21124,14.959,28.739,23361,10360,13001,6.758,15.239,20695,13.500,30.478,132,155,3242
2004,5613,26414,43270,3769751,3774234,6549,15.124,6615,15.276,979322,252692,726630,6.695,25.948,1005456,357844,647612,9.481,26.640,-26134,-0.692,51.895,3150,3384,134907
2004,5614,26384,31920,776876,766667,4287,13.538,3782,11.943,153149,56532,96617,7.374,19.976,132218,53403,78815,6.966,17.246,20931,2.730,34.492,2749,2830,25619
2004,5615,16618,22480,262460,270720,1870,8.079,3202,13.834,32989,10679,22310,3.945,12.186,49782,17364,32418,6.414,18.389,-16793,-6.203,24.371,1884,1948,8279
2004,5616,16810,21247,739624,736691,2538,12.041,2201,10.442,126341,30304,96037,4.114,17.150,119131,35066,84065,4.760,16.171,7210,0.979,32.342,1522,1588,21448
2004,5617,124613,130641,1595415,1570415,21289,16.567,17012,13.239,311093,95834,215259,6.102,19.810,262331,98872,163459,6.296,16.705,48762,3.105,33.409,11711,11743,62075
2004,5619,16682,18777,344947,348271,2074,11.051,2054,10.945,56360,17367,38993,4.987,16.183,62039,19601,42438,5.628,17.813,-5679,-1.631,32.366,1404,1420,10364
2004,5621,6343,8165,179849,178114,794,9.824,628,7.770,20044,6619,13425,3.716,11.253,16480,5343,11137,3.000,9.253,3564,2.001,18.505,474,479,3484
2004,5622,1450,2451,54391,53578,229,9.412,193,7.933,7734,2793,4941,5.213,14.435,6204,2307,3897,4.306,11.579,1530,2.856,23.159,113,115,818
2004,5629,6375,7023,110425,107440,788,11.333,648,9.320,25643,6808,18835,6.337,23.867,20065,5087,14978,4.735,18.676,5578,5.192,37.351,443,450,3102
2004,6111,17951,20049,809140,803119,1026,5.152,761,3.821,65624,14088,51536,1.754,8.171,53394,12606,40788,1.570,6.648,12230,1.523,13.297,547,548,10097
2004,6112,548,876,92792,91440,73,8.508,37,4.312,11462,3148,8314,3.443,12.535,8799,2767,6032,3.026,9.623,2663,2.912,19.245,24,25,2245
2004,6113,2423,3306,1504915,1472109,222,6.799,140,4.288,113512,8939,104573,0.607,7.711,47679,6758,40921,0.459,3.239,65833,4.472,6.478,80,81,5658
2004,6114,5945,6481,62780,63264,892,13.740,914,14.079,11168,4087,7081,6.460,17.653,12148,4197,7951,6.634,19.202,-980,-1.549,35.306,634,645,2782
2004,6115,5850,6937,99373,96900,833,12.164,655,9.565,19693,7094,12599,7.321,20.323,14758,5353,9405,5.524,15.230,4935,5.093,30.460,458,478,3946
2004,6116,26057,27963,253495,244532,4166,15.299,2701,9.919,56106,19561,36545,7.999,22.944,38098,12500,25598,5.112,15.580,18008,7.364,31.160,1979,1999,9066
2004,6117,4214,4676,56002,52781,815,17.991,523,11.545,13509,4879,8630,9.244,25.595,6984,2527,4457,4.788,13.232,6525,12.363,26.464,367,368,1421
2004,6211,170178,193683,2034451,2000179,16245,8.462,12845,6.691,289149,86587,202562,4.329,14.456,220812,67883,152929,3.394,11.040,68337,3.417,22.079,9195,9407,43058
2004,6212,110547,115315,802431,787101,6343,5.548,4371,3.823,112929,31445,81484,3.995,14.347,82488,20168,62320,2.562,10.480,30441,3.867,20.960,3530,3611,16415
2004,6213,92043,101108,547094,530848,12149,12.305,7393,7.488,109555,42348,67207,7.977,20.638,77449,27240,50209,5.131,14.590,32106,6.048,29.179,5399,5466,19725
2004,6214,12370,24619,638641,629956,1912,7.848,1397,5.734,76176,22289,53887,3.538,12.092,58459,18854,39605,2.993,9.280,17717,2.812,18.560,706,767,7434
2004,6215,6657,10154,212760,208082,1386,13.918,994,9.982,32515,12903,19612,6.201,15.626,23098,8239,14859,3.960,11.100,9417,4.526,22.201,577,598,4456
2004,6216,12060,17257,861907,831367,2762,16.477,1773,10.577,154518,46049,108469,5.539,18.586,94160,29967,64193,3.605,11.326,60358,7.260,22.652,1193,1246,17295
2004,6219,5411,8227,232337,227412,797,9.698,780,9.491,36981,10109,26872,4.445,16.262,27048,11008,16040,4.841,11.894,9933,4.368,23.788,402,474,5151
2004,6221,3278,5362,4816932,4791404,180,3.371,134,2.510,221247,21019,200228,0.439,4.618,170604,48127,122477,1.004,3.561,50643,1.057,7.121,49,49,13562
2004,6222,510,652,214777,214296,52,8.125,28,4.375,9077,3788,5289,1.768,4.236,8099,3372,4727,1.574,3.779,978,0.456,7.559,19,20,2872
2004,6223,456,789,195376,190586,164,22.466,46,6.301,18087,7992,10095,4.193,9.490,8950,1744,7206,0.915,4.696,9137,4.794,9.392,26,26,795
2004,6231,8516,15901,1609454,1606141,1033,6.515,943,5.947,152695,64904,87791,4.041,9.507,145966,59925,86041,3.731,9.088,6729,0.419,18.176,458,492,30856
2004,6232,7938,28845,529349,522157,2095,7.385,1141,4.022,67902,22578,45324,4.324,13.004,53950,12592,41358,2.412,10.332,13952,2.672,20.664,386,478,5965
2004,6233,12754,17023,604419,599854,1784,10.511,1685,9.927,72303,28807,43496,4.802,12.053,63477,26983,36494,4.498,10.582,8826,1.471,21.164,1181,1211,15982
2004,6239,3499,6085,156755,157429,469,7.793,335,5.567,18205,6074,12131,3.858,11.564,19492,5568,13924,3.537,12.381,-1287,-0.818,23.128,170,179,2287
2004,6241,35605,49421,971030,953886,4402,9.023,3137,6.430,143528,46139,97389,4.837,15.047,107873,23743,84130,2.489,11.309,35655,3.738,22.618,1869,1960,13003
2004,6242,9166,12401,152191,152826,663,5.379,512,4.154,16200,3759,12441,2.460,10.600,17462,3005,14457,1.966,11.426,-1262,-0.826,21.201,293,302,1610
2004,6243,4952,7931,322409,323715,437,5.485,509,6.389,43759,10157,33602,3.138,13.518,46476,7453,39023,2.302,14.357,-2717,-0.839,27.036,222,245,2250
2004,6244,52227,65541,779804,777080,7011,10.748,6390,9.796,115209,42787,72422,5.506,14.826,109915,38511,71404,4.956,14.145,5294,0.681,28.289,4661,4727,27537
2004,7111,7392,7550,127046,129271,826,10.873,919,12.098,21481,6749,14732,5.221,16.617,26356,7019,19337,5.430,20.388,-4875,-3.771,33.234,601,605,4685
2004,7112,3166,3328,111649,111554,536,16.157,515,15.524,19069,4158,14911,3.727,17.094,18839,6849,11990,6.140,16.888,230,0.206,33.776,381,381,3104
2004,7113,4337,4655,103301,100693,651,14.236,487,10.649,23330,7906,15424,7.852,23.169,18368,6403,11965,6.359,18.242,4962,4.928,36.483,340,340,2566
2004,7114,2614,2682,15792,15874,412,15.463,377,14.149,2981,1519,1462,9.569,18.779,3152,1405,1747,8.851,19.856,-171,-1.077,37.558,284,284,874
2004,7115,11547,11567,43582,43038,2496,22.100,1950,17.266,13971,6700,7271,15.568,32.462,13026,5164,7862,11.999,30.267,945,2.196,60.533,1196,1196,2839
2004,7121,5837,6264,118860,119431,443,7.138,328,5.285,9125,1241,7884,1.039,7.640,10261,1922,8339,1.609,8.592,-1136,-0.951,15.281,200,200,1519
2004,7131,1741,2320,138082,135544,326,13.852,393,16.699,20145,5194,14951,3.832,14.862,15674,3452,12222,2.547,11.564,4471,3.299,23.128,224,227,2440
2004,7132,1610,2065,171432,167624,244,12.005,179,8.807,22046,5964,16082,3.558,13.152,14529,5675,8854,3.386,8.668,7517,4.484,17.335,151,151,2774
2004,7139,48723,53917,1055800,1038868,7577,14.420,4832,9.196,163938,60193,103745,5.794,15.780,129772,39974,89798,3.848,12.492,34166,3.289,24.983,3622,3651,29264
2004,7211,36305,46247,1778385,1763031,4660,10.116,4295,9.324,221325,91956,129369,5.216,12.554,191154,73922,117232,4.193,10.842,30171,1.711,21.685,2900,2965,41580
2004,7212,4977,5417,37650,37407,489,8.986,538,9.887,6574,1936,4638,5.176,17.574,6154,2063,4091,5.515,16.451,420,1.123,32.903,340,369,1548
2004,7213,2222,2291,13583,13549,128,5.444,248,10.549,2231,433,1798,3.196,16.467,2117,1013,1104,7.477,15.625,114,0.841,31.251,180,180,846
2004,7223,11154,27837,525022,536808,5007,18.073,4741,17.113,124701,68445,56256,12.750,23.230,154432,60128,94304,11.201,28.769,-29731,-5.538,46.460,1284,1301,9360
2004,7224,42159,42714,358157,355389,5008,11.617,5797,13.447,78619,38320,40299,10.783,22.122,73254,31776,41478,8.941,20.612,5365,1.510,41.225,4782,4786,26512
2004,7225,291135,397502,8021706,7880736,51170,13.038,41103,10.473,1437852,686078,751774,8.706,18.245,1157843,442461,715382,5.614,14.692,280009,3.553,29.384,31072,32069,302140
2004,8111,139644,152366,899439,896607,14439,9.486,14137,9.288,149967,54411,95556,6.069,16.726,144350,53601,90749,5.978,16.100,5617,0.626,32.199,11001,11127,41756
2004,8112,11124,12592,130212,131067,1251,9.820,1545,12.128,21913,6940,14973,5.295,16.719,23538,9446,14092,7.207,17.959,-1625,-1.240,33.438,1124,1128,3980
2004,8113,20590,21895,177966,175319,2183,9.970,2183,9.970,33246,12574,20672,7.172,18.963,28202,9680,18522,5.521,16.086,5044,2.877,32.172,1627,1631,6505
2004,8114,20443,21605,108481,108579,2592,11.945,2782,12.820,16995,6350,10645,5.848,15.652,17209,8349,8860,7.689,15.849,-214,-0.197,31.304,2114,2120,5650
2004,8121,79284,92687,580677,566595,12529,13.682,10296,11.244,120037,53097,66940,9.371,21.186,91984,39742,52242,7.014,16.235,28053,4.951,32.469,8181,8332,29108
2004,8122,14739,20780,145351,145272,835,4.008,938,4.503,13871,3781,10090,2.603,9.548,13761,3970,9791,2.733,9.473,110,0.076,18.945,481,543,1860
2004,8123,32030,38657,380127,378809,4281,11.111,4024,10.444,62812,28265,34547,7.462,16.581,60767,20186,40581,5.329,16.042,2045,0.540,32.083,3134,3211,13400
2004,8129,21191,32626,234864,233284,5671,17.678,4578,14.271,57199,26932,30267,11.545,24.519,54216,24273,29943,10.405,23.240,2983,1.279,46.481,2957,3010,13572
2004,8131,167967,168195,1656285,1655847,8146,4.862,6812,4.066,162773,24328,138445,1.469,9.830,160444,37969,122475,2.293,9.690,2329,0.141,19.379,4517,4520,13055
2004,8132,12254,14217,142682,142994,1109,7.853,919,6.508,16483,5039,11444,3.524,11.527,16986,4336,12650,3.032,11.879,-503,-0.352,23.054,632,643,2277
2004,8133,10131,12245,114809,112723,1136,9.363,912,7.517,17951,6301,11650,5.590,15.925,13893,3292,10601,2.920,12.325,4058,3.600,24.650,541,547,2045
2004,8134,27750,29778,318566,319109,1426,4.777,1576,5.279,33893,5558,28335,1.742,10.621,34951,6084,28867,1.907,10.953,-1058,-0.332,21.242,1128,1138,4059
2004,8139,59488,61407,528595,525519,3022,4.912,3261,5.300,67502,14380,53122,2.736,12.845,60823,13307,47516,2.532,11.574,6679,1.271,23.148,2201,2217,9295
2005,1131,336,383,4313,4372,48,12.632,42,11.053,454,105,349,2.402,10.385,553,178,375,4.072,12.650,-99,-2.265,20.771,25,25,51
2005,1132,133,186,1727,1720,27,14.754,21,11.475,404,174,230,10.116,23.488,397,130,267,7.558,23.081,7,0.407,46.163,17,17,27
2005,1133,9084,9160,63460,65018,1032,11.192,1154,12.515,10509,3258,7251,5.011,16.163,13692,4503,9189,6.926,21.059,-3183,-4.896,32.327,849,852,3526
2005,1141,1157,1170,5557,5721,182,15.346,214,18.044,938,413,525,7.219,16.396,1245,563,682,9.841,21.762,-307,-5.366,32.791,135,135,372
2005,1142,268,268,1666,1697,41,15.472,35,13.208,232,79,153,4.655,13.671,292,107,185,6.305,17.207,-60,-3.536,27.342,31,31,98
2005,1151,3440,3763,57345,56998,437,11.616,435,11.563,10928,3576,7352,6.274,19.173,10178,3008,7170,5.277,17.857,750,1.316,35.714,281,281,1844
2005,1152,3498,3563,18648,18528,574,16.400,448,12.800,3335,1534,1801,8.279,18.000,3122,1114,2008,6.013,16.850,213,1.150,33.700,344,344,831
2005,1153,1258,1305,14447,14374,206,16.132,150,11.746,2723,867,1856,6.032,18.944,2592,565,2027,3.931,18.033,131,0.911,36.065,95,95,407
2005,2111,5549,6636,83592,82787,634,9.623,539,8.181,15984,4482,11502,5.414,19.307,14466,5735,8731,6.927,17.474,1518,1.834,34.948,313,317,1395
2005,2121,617,1022,74076,71982,121,11.886,113,11.100,12513,5644,6869,7.841,17.384,8337,1890,6447,2.626,11.582,4176,5.801,23.164,60,62,990
2005,2122,190,259,26255,25073,40,15.564,36,14.008,3595,1899,1696,7.574,14.338,1290,753,537,3.003,5.145,2305,9.193,10.290,31,31,629
2005,2123,3207,5256,96116,95228,392,7.497,338,6.464,13245,3659,9586,3.842,13.909,11526,4254,7272,4.467,12.104,1719,1.805,24.207,192,192,1534
2005,2131,7441,8892,213303,204699,1073,12.285,757,8.667,42435,9607,32828,4.693,20.730,24772,6620,18152,3.234,12.102,17663,8.629,24.203,457,482,3340
2005,2211,1573,9367,512499,508205,582,6.142,801,8.452,50592,16561,34031,3.259,9.955,42812,17531,25281,3.450,8.424,7780,1.531,16.848,43,52,178
2005,2212,489,2411,79155,80571,135,5.565,165,6.801,5804,1304,4500,1.618,7.204,8559,2211,6348,2.744,10.623,-2755,-3.419,14.407,23,25,185
2005,2213,4161,4955,41221,41489,318,6.385,369,7.409,5612,1826,3786,4.401,13.527,6081,2483,3598,5.985,14.657,-469,-1.130,27.053,159,160,663
2005,2361,156530,157745,905052,882298,30259,19.636,22962,14.901,240055,104034,136021,11.791,27.208,195264,75510,119754,8.558,22.131,44791,5.077,44.263,15712,15714,52723
2005,2362,38734,39768,697591,703848,4564,11.566,3947,10.003,127507,27727,99780,3.939,18.116,139284,39029,100255,5.545,19.789,-11777,-1.673,36.231,2798,2800,23779
2005,2371,18192,19127,450347,451990,1792,9.368,1797,9.394,88426,18036,70390,3.990,19.564,92926,24304,68622,5.377,20.559,-4500,-0.996,39.127,1247,1252,9893
2005,2372,9843,9927,68253,66366,1577,16.073,1346,13.719,16562,5178,11384,7.802,24.956,12609,5825,6784,8.777,18.999,3953,5.956,37.999,1013,1013,4294
2005,2373,9799,10501,311355,312516,760,7.178,934,8.821,45427,6386,39041,2.043,14.536,47898,7292,40606,2.333,15.327,-2471,-0.791,29.072,566,569,4083
2005,2379,4234,4431,81112,81092,612,13.887,564,12.798,18339,5969,12370,7.361,22.615,17953,5095,12858,6.283,22.139,386,0.476,44.278,362,362,2619
2005,2381,94803,95351,1067544,1054949,14112,14.910,12703,13.422,256942,75484,181458,7.155,24.356,231716,66118,165598,6.267,21.965,25226,2.391,43.929,8749,8755,49733
2005,2382,153517,156790,1816515,1801076,19181,12.425,14355,9.299,333360,94583,238777,5.251,18.509,302122,75889,226233,4.214,16.775,31238,1.734,33.549,10467,10486,54785
2005,2383,106237,107300,896708,880534,18823,17.903,14499,13.790,216604,70992,145612,8.062,24.599,183804,57792,126012,6.563,20.874,32800,3.725,41.748,10353,10357,41718
2005,2389,54654,55115,493654,481078,9940,18.564,6801,12.701,115821,41071,74750,8.537,24.075,90281,27578,62703,5.733,18.766,25540,5.309,37.533,4542,4544,19874
2005,3111,1138,1700,47367,47074,117,6.890,113,6.655,5584,1832,3752,3.892,11.862,4907,1515,3392,3.218,10.424,677,1.438,20.848,60,62,440
2005,3112,462,783,54542,54373,43,5.481,46,5.864,3683,1024,2659,1.883,6.774,3301,634,2667,1.166,6.071,382,0.703,12.142,32,32,144
2005,3113,1528,1695,73495,75664,137,8.056,148,8.703,5790,1373,4417,1.815,7.652,10160,3477,6683,4.595,13.428,-4370,-5.776,15.305,115,115,975
2005,3114,1247,1620,163022,164331,101,6.175,132,8.071,14896,2408,12488,1.465,9.065,17480,6327,11153,3.850,10.637,-2584,-1.572,18.129,75,75,2316
2005,3115,1003,1500,133120,133573,81,5.354,107,7.072,10658,2562,8096,1.918,7.979,11778,4599,7179,3.443,8.818,-1120,-0.838,15.958,66,67,1158
2005,3116,3004,3635,495803,494517,211,5.748,283,7.709,33109,8924,24185,1.805,6.695,30492,7334,23158,1.483,6.166,2617,0.529,12.332,193,194,3100
2005,3117,542,641,37560,37749,48,7.425,59,9.126,4418,946,3472,2.506,11.704,4857,1449,3408,3.839,12.867,-439,-1.163,23.408,43,44,557
2005,3118,8984,9783,295783,298823,830,8.342,1163,11.689,32531,8655,23876,2.896,10.886,38449,11728,26721,3.925,12.867,-5918,-1.980,21.773,911,923,6728
2005,3119,2520,2947,161387,160947,287,9.749,281,9.545,17122,4993,12129,3.102,10.638,16116,6194,9922,3.848,10.013,1006,0.625,20.027,198,199,2203
2005,3121,2468,3008,133398,132845,367,12.466,239,8.118,13247,3743,9504,2.818,9.972,12146,3283,8863,2.471,9.143,1101,0.829,18.286,160,162,1373
2005,3122,92,130,21010,21407,18,13.953,16,12.403,1129,145,984,0.677,5.274,1977,257,1720,1.201,9.236,-848,-3.961,10.548,13,13,176
2005,3131,315,471,51644,53226,23,4.728,54,11.100,2975,381,2594,0.716,5.589,6137,3105,3032,5.834,11.530,-3162,-5.941,11.179,30,30,830
2005,3132,1201,1398,106338,110196,84,5.862,154,10.747,8509,1613,6896,1.464,7.722,16306,7043,9263,6.391,14.797,-7797,-7.076,15.443,109,112,1808
2005,3133,1270,1344,50950,52193,88,6.423,140,10.219,5368,1342,4026,2.571,10.285,7912,3177,4735,6.087,15.159,-2544,-4.874,20.570,104,104,1560
2005,3141,2398,2561,87624,89986,179,6.899,246,9.482,8138,1789,6349,1.988,9.044,12668,4466,8202,4.963,14.078,-4530,-5.034,18.087,185,186,1647
2005,3149,4334,4464,83410,84222,334,7.376,462,10.203,10000,2024,7976,2.403,11.873,11538,3907,7631,4.639,13.700,-1538,-1.826,23.747,360,362,3026
2005,3151,491,539,33337,35714,30,5.268,91,15.979,2681,309,2372,0.865,7.507,7371,2369,5002,6.633,20.639,-4690,-13.132,15.014,73,74,1209
2005,3152,7282,7457,180431,186212,1192,15.479,1680,21.815,37869,13223,24646,7.101,20.337,48936,23837,25099,12.801,26.280,-11067,-5.943,40.673,1483,1485,18939
2005,3159,889,920,19347,19976,73,7.709,127,13.411,2091,398,1693,1.992,10.468,3350,1311,2039,6.563,16.771,-1259,-6.303,20.936,100,100,662
2005,3161,211,219,6733,7233,18,8.219,18,8.219,446,96,350,1.327,6.167,1413,383,1030,5.296,19.537,-967,-13.370,12.333,13,13,56
2005,3162,255,286,16228,16529,23,7.877,35,11.986,831,117,714,0.708,5.028,1399,388,1011,2.347,8.464,-568,-3.436,10.055,27,27,198
2005,3169,763,775,15971,16010,77,9.834,93,11.877,2053,534,1519,3.336,12.824,2100,684,1416,4.272,13.117,-47,-0.294,25.647,75,75,512
2005,3211,3573,4010,115972,114908,307,7.643,320,7.967,12622,3553,9069,3.092,10.984,10391,3071,7320,2.673,9.043,2231,1.942,18.086,243,245,2007
2005,3212,1441,1832,118590,115476,142,7.768,134,7.330,15481,3756,11725,3.253,13.406,9395,4013,5382,3.475,8.136,6086,5.270,16.272,81,83,1549
2005,3219,9174,10056,330297,323628,834,8.257,922,9.129,47124,12403,34721,3.832,14.561,33601,10674,22927,3.298,10.383,13523,4.179,20.765,684,694,6479
2005,3221,288,591,146536,148411,27,4.523,39,6.533,6925,2639,4286,1.778,4.666,10597,3871,6726,2.608,7.140,-3672,-2.474,9.332,17,17,282
2005,3222,3016,4558,311098,314963,177,3.832,299,6.473,21584,3868,17716,1.228,6.853,29270,10578,18692,3.358,9.293,-7686,-2.440,13.706,161,162,2636
2005,3231,31114,32704,660966,668593,1979,5.977,2790,8.427,62001,14981,47020,2.241,9.273,77212,27706,49506,4.144,11.548,-15211,-2.275,18.547,2238,2254,15505
2005,3241,1026,2248,99964,100023,168,7.493,156,6.958,9300,2054,7246,2.054,9.298,9346,4598,4748,4.597,9.344,-46,-0.046,18.596,40,40,357
2005,3251,1179,2291,163482,165923,108,4.702,120,5.224,9919,2114,7805,1.274,5.978,14981,3912,11069,2.358,9.029,-5062,-3.051,11.956,47,49,586
2005,3252,735,1064,96576,97068,67,6.339,53,5.014,7335,1189,6146,1.225,7.557,8250,1928,6322,1.986,8.499,-915,-0.943,15.113,19,19,308
2005,3253,620,869,29677,29975,65,7.471,67,7.701,3008,1073,1935,3.580,10.035,3657,1501,2156,5.008,12.200,-649,-2.165,20.070,27,27,240
2005,3254,1358,1762,255429,249169,133,7.583,117,6.670,32866,5391,27475,2.164,13.190,20247,4362,15885,1.751,8.126,12619,5.064,16.252,71,72,980
2005,3255,1444,1837,63492,64210,77,4.148,116,6.248,4582,1041,3541,1.621,7.136,6017,1743,4274,2.715,9.371,-1435,-2.235,14.272,75,76,627
2005,3256,1942,2157,105275,105626,151,6.957,178,8.201,9425,1235,8190,1.169,8.923,10124,3435,6689,3.252,9.585,-699,-0.662,17.846,110,110,1367
2005,3259,2044,2633,108611,111575,172,6.453,237,8.891,8808,2012,6796,1.803,7.894,14607,3942,10665,3.533,13.092,-5799,-5.197,15.788,124,126,954
2005,3261,9478,12004,735748,735640,567,4.688,749,6.193,74979,14461,60518,1.966,10.192,74740,20903,53837,2.841,10.160,239,0.032,20.320,513,517,8992
2005,3262,1688,2175,160542,161625,94,4.273,144,6.545,11557,1851,9706,1.145,7.151,13664,4334,9330,2.682,8.454,-2107,-1.304,14.301,83,87,1763
2005,3271,1264,1465,54138,55016,130,8.844,140,9.524,5355,1000,4355,1.818,9.734,7048,1967,5081,3.575,12.811,-1693,-3.077,19.467,106,106,689
2005,3272,1682,2005,102265,105220,148,7.305,190,9.378,7456,1596,5860,1.517,7.086,13232,4521,8711,4.297,12.576,-5776,-5.489,14.172,139,139,1362
2005,3273,4925,9275,216576,213073,561,6.103,394,4.287,31072,7847,23225,3.683,14.583,24142,4642,19500,2.179,11.330,6930,3.252,22.661,207,217,2353
2005,3274,214,336,17782,18177,19,5.663,18,5.365,1428,251,1177,1.381,7.856,2376,70,2306,0.385,13.071,-948,-5.215,15.712,16,16,61
2005,3279,2551,2968,76632,75265,299,10.231,208,7.117,10039,2440,7599,3.242,13.338,7311,1985,5326,2.637,9.714,2728,3.625,19.427,136,145,1270
2005,3311,482,603,109092,110330,79,13.244,66,11.065,4909,996,3913,0.903,4.449,7465,1597,5868,1.447,6.766,-2556,-2.317,8.899,47,48,930
2005,3312,490,624,44943,44743,41,6.555,44,7.034,4197,1645,2552,3.677,9.380,3811,1216,2595,2.718,8.518,386,0.863,17.035,24,24,140
2005,3313,411,570,66021,65024,47,8.356,32,5.689,6127,2302,3825,3.540,9.423,4231,1193,3038,1.835,6.507,1896,2.916,13.014,19,19,244
2005,3314,713,905,61581,60994,44,4.806,65,7.100,5696,710,4986,1.164,9.339,4599,1305,3294,2.140,7.540,1097,1.799,15.080,47,47,589
2005,3315,1922,2181,166277,164639,84,3.801,142,6.425,16225,2508,13717,1.523,9.855,13129,3847,9282,2.337,7.974,3096,1.880,15.949,97,100,1965
2005,3321,2404,2665,127087,124867,112,4.185,135,5.044,13912,2882,11030,2.308,11.141,9572,2644,6928,2.117,7.666,4340,3.476,15.332,87,87,976
2005,3322,1308,1438,55393,56917,73,5.040,94,6.489,4369,1204,3165,2.115,7.676,7422,1907,5515,3.351,13.040,-3053,-5.364,15.352,62,62,933
2005,3323,11761,12668,374532,371695,872,6.875,902,7.112,48192,12491,35701,3.361,12.965,42606,12917,29689,3.475,11.463,5586,1.503,22.925,633,637,8709
2005,3324,1238,1512,86922,87671,68,4.443,105,6.861,8367,1020,7347,1.163,9.544,9955,2829,7126,3.227,11.355,-1588,-1.811,19.087,61,62,1052
2005,3325,694,770,47390,49322,33,4.212,60,7.658,4335,347,3988,0.704,8.789,8069,4264,3805,8.645,16.360,-3734,-7.571,17.579,40,41,715
2005,3326,1466,1655,56340,57072,52,3.069,131,7.731,5246,578,4668,1.013,9.192,6684,2097,4587,3.674,11.712,-1438,-2.520,18.384,98,98,1318
2005,3327,23007,23432,374447,367351,1425,6.066,1548,6.589,51518,9462,42056,2.576,14.024,37318,11938,25380,3.250,10.159,14200,3.866,20.317,1170,1173,7660
2005,3328,5398,5962,135965,135035,347,5.804,380,6.356,17479,4425,13054,3.277,12.944,15613,4819,10794,3.569,11.562,1866,1.382,23.124,297,298,3577
2005,3329,5486,6022,267719,268031,428,7.073,487,8.048,27391,5935,21456,2.214,10.219,27778,8969,18809,3.346,10.364,-387,-0.144,20.439,333,333,2919
2005,3331,2472,2773,182242,177043,180,6.525,151,5.474,22618,3554,19064,2.007,12.775,11961,4161,7800,2.350,6.756,10657,6.019,13.512,103,105,1934
2005,3332,3550,3766,136073,135177,211,5.551,281,7.393,15523,4586,10937,3.393,11.484,13769,5330,8439,3.943,10.186,1754,1.298,20.372,204,204,2337
2005,3333,2049,2205,98686,100611,145,6.537,171,7.710,8726,2083,6643,2.070,8.673,12181,2973,9208,2.955,12.107,-3455,-3.434,17.346,119,120,1238
2005,3334,1462,1768,149830,149407,124,7.035,113,6.411,14636,3545,11091,2.373,9.796,13613,5106,8507,3.418,9.111,1023,0.685,18.223,67,68,1208
2005,3335,7789,8090,177089,176112,381,4.666,532,6.515,18906,4358,14548,2.475,10.735,16967,5162,11805,2.931,9.634,1939,1.101,19.268,411,411,3087
2005,3336,732,885,97235,93663,50,5.653,49,5.540,10391,2213,8178,2.363,11.094,3404,777,2627,0.830,3.634,6987,7.460,7.269,31,31,295
2005,3339,5449,6107,280772,280635,324,5.276,393,6.399,27449,5925,21524,2.111,9.781,26986,9846,17140,3.508,9.616,463,0.165,19.232,261,262,2839
2005,3341,1179,1249,104220,106390,105,8.232,158,12.387,9825,1269,8556,1.193,9.235,13663,3363,10300,3.161,12.842,-3838,-3.607,18.470,113,113,1579
2005,3342,1539,1733,122574,127254,129,7.334,181,10.290,12511,3600,8911,2.829,9.832,21730,7262,14468,5.707,17.076,-9219,-7.245,19.663,126,131,2755
2005,3343,424,441,19067,19898,40,8.869,60,13.304,1552,161,1391,0.809,7.800,3208,2040,1168,10.253,16.123,-1656,-8.323,15.600,46,46,718
2005,3344,4111,4647,360712,363754,238,5.049,372,7.891,31893,4387,27506,1.206,8.768,37833,11987,25846,3.295,10.401,-5940,-1.633,17.536,247,252,3508
2005,3345,4278,4943,399079,395348,307,6.193,336,6.778,41675,5797,35878,1.466,10.541,33913,15144,18769,3.831,8.578,7762,1.963,17.156,205,205,2096
2005,3346,732,780,35011,35740,75,9.452,102,12.854,4118,1042,3076,2.916,11.522,5497,1812,3685,5.070,15.381,-1379,-3.858,23.045,80,81,1626
2005,3351,1058,1150,59729,60439,65,5.616,80,6.911,4543,551,3992,0.912,7.517,5937,1730,4207,2.862,9.823,-1394,-2.306,15.033,63,63,859
2005,3352,287,343,82619,84058,47,13.988,33,9.821,7268,1404,5864,1.670,8.646,9914,2877,7037,3.423,11.794,-2646,-3.148,17.293,22,22,130
2005,3353,1983,2341,139150,138492,138,5.867,160,6.803,13762,3375,10387,2.437,9.937,12369,4877,7492,3.522,8.931,1393,1.006,17.862,109,109,1445
2005,3359,1769,2108,146550,149443,152,7.207,154,7.302,11979,3778,8201,2.528,8.016,17817,5357,12460,3.585,11.922,-5838,-3.907,16.032,105,105,1734
2005,3361,284,357,208288,212654,40,11.331,32,9.065,18445,7139,11306,3.357,8.674,28911,3633,25278,1.708,13.595,-10466,-4.922,17.347,25,25,125
2005,3362,1774,2028,149130,144584,156,7.636,186,9.104,20305,3230,17075,2.234,14.044,11559,4306,7253,2.978,7.995,8746,6.049,15.989,140,141,2467
2005,3363,4304,5421,670557,674381,338,6.217,370,6.805,65177,14347,50830,2.127,9.665,72862,15476,57386,2.295,10.804,-7685,-1.140,19.329,246,250,5836
2005,3364,1178,1524,394243,387369,83,5.416,100,6.525,33695,2536,31159,0.655,8.698,19427,2562,16865,0.661,5.015,14268,3.683,10.030,66,66,814
2005,3365,147,199,28238,26367,13,6.616,8,4.071,4923,328,4595,1.244,18.671,1211,247,964,0.937,4.593,3712,14.078,9.186,6,6,209
2005,3366,1532,1656,144275,143147,147,8.871,149,8.992,13109,1963,11146,1.371,9.158,11037,2502,8535,1.748,7.710,2072,1.447,15.421,112,113,2120
2005,3369,788,820,44587,42634,124,15.607,73,9.188,7948,927,7021,2.174,18.643,3748,1137,2611,2.667,8.791,4200,9.851,17.582,55,55,346
2005,3371,14529,14989,358375,360275,1335,8.866,1471,9.770,42693,12125,30568,3.365,11.850,46454,16529,29925,4.588,12.894,-3761,-1.044,23.700,1123,1127,8291
2005,3372,3790,3989,146367,147966,246,6.113,316,7.853,16225,3535,12690,2.389,10.965,19422,5366,14056,3.627,13.126,-3197,-2.161,21.931,240,240,2774
2005,3379,898,1035,46599,46435,67,6.445,76,7.311,5161,1683,3478,3.624,11.114,4875,1496,3379,3.222,10.499,286,0.616,20.997,56,57,944
2005,3391,10649,11431,306968,303761,760,6.633,815,7.113,34838,8983,25855,2.957,11.469,28264,6647,21617,2.188,9.305,6574,2.164,18.609,604,607,3540
2005,3399,17173,17639,376181,380691,1495,8.428,1695,9.555,42353,10944,31409,2.875,11.125,51325,16916,34409,4.444,13.482,-8972,-2.357,22.251,1312,1318,9995
2005,4231,17453,24039,367954,365195,1876,7.801,1893,7.872,45930,15029,30901,4.115,12.577,40631,12387,28244,3.392,11.126,5299,1.451,22.252,1340,1392,7482
2005,4232,10968,12591,161964,162033,1228,9.750,1237,9.821,22688,6472,16216,3.994,14.002,22872,7254,15618,4.477,14.116,-184,-0.114,28.004,951,980,5208
2005,4233,11757,17621,262311,254017,1764,10.164,1233,7.104,43241,15063,28178,5.930,17.023,26758,10232,16526,4.028,10.534,16483,6.489,21.068,811,853,5457
2005,4234,25232,34309,720635,722553,2960,8.552,3564,10.297,98720,27590,71130,3.818,13.663,102339,32962,69377,4.562,14.164,-3619,-0.501,27.325,2210,2274,14378
2005,4235,7373,10076,151392,148793,712,7.091,643,6.403,20220,5676,14544,3.815,13.589,15066,4664,10402,3.135,10.125,5154,3.464,20.251,380,394,2454
2005,4236,19516,28771,469515,471268,2489,8.643,2546,8.840,65196,18633,46563,3.954,13.834,68073,22209,45864,4.713,14.445,-2877,-0.610,27.668,1388,1514,8634
2005,4237,11001,18238,219386,217774,1326,7.331,1023,5.656,27972,9033,18939,4.148,12.845,24638,6181,18457,2.838,11.314,3334,1.531,22.627,605,630,3264
2005,4238,42349,57486,689984,689278,3630,6.293,4032,6.989,84745,23196,61549,3.365,12.295,83976,32228,51748,4.676,12.183,769,0.112,24.366,2576,2715,14113
2005,4239,27936,30901,332610,329836,3435,11.170,3137,10.201,50973,17625,33348,5.344,15.454,45585,14425,31160,4.373,13.821,5388,1.634,27.641,2439,2461,9993
2005,4241,9222,11945,203285,203663,777,6.471,901,7.504,23096,7922,15174,3.890,11.340,23824,5251,18573,2.578,11.698,-728,-0.357,22.681,622,631,3161
2005,4242,5730,7502,260221,264871,819,11.001,704,9.457,35057,15500,19557,5.852,13.235,44698,18116,26582,6.840,16.875,-9641,-3.640,26.471,500,504,3246
2005,4243,13554,14703,204222,204123,1681,11.387,1799,12.187,31510,9578,21932,4.692,15.437,31152,8872,22280,4.346,15.261,358,0.175,30.523,1424,1435,6503
2005,4244,25522,31574,767593,770556,2719,8.559,3103,9.768,93313,30356,62957,3.939,12.110,98575,28063,70512,3.642,12.793,-5262,-0.683,24.220,2219,2260,14355
2005,4245,4102,6579,63833,63847,311,4.682,437,6.579,7944,1560,6384,2.443,12.442,8037,2007,6030,3.143,12.588,-93,-0.146,24.885,244,269,1055
2005,4246,8390,12158,146248,144838,880,7.223,930,7.634,22120,8361,13759,5.773,15.272,19197,6441,12756,4.447,13.254,2923,2.018,26.508,511,527,2220
2005,4247,5061,7190,106560,107340,429,5.936,502,6.947,13697,3475,10222,3.237,12.760,15363,4368,10995,4.069,14.312,-1666,-1.552,25.521,309,321,2227
2005,4248,3140,3922,171107,170405,270,6.871,285,7.253,15807,3411,12396,2.002,9.276,14354,5355,8999,3.143,8.423,1453,0.853,16.847,197,201,2760
2005,4249,23014,28962,379840,382120,2979,10.308,2857,9.885,48679,15248,33431,3.990,12.739,53427,17255,36172,4.516,13.982,-4748,-1.243,25.478,2133,2169,11811
2005,4251,37633,39658,297442,293544,5251,13.486,3807,9.778,53439,18800,34639,6.405,18.205,45202,14329,30873,4.881,15.399,8237,2.806,30.797,2756,2791,9849
2005,4411,43836,48302,1288043,1293240,4691,9.732,4488,9.311,139823,52745,87078,4.079,10.812,149972,51446,98526,3.978,11.597,-10149,-0.785,21.624,3588,3630,39011
2005,4412,13508,15072,163126,161632,1618,10.854,1287,8.634,26358,11133,15225,6.888,16.307,23369,7773,15596,4.809,14.458,2989,1.849,28.916,986,1002,5893
2005,4413,31737,56252,493842,492739,4091,7.301,3660,6.531,64518,24510,40008,4.974,13.094,62397,20590,41807,4.179,12.663,2121,0.430,25.327,2522,2627,11294
2005,4421,19039,26782,273234,273105,2724,10.203,2554,9.567,42210,17677,24533,6.473,15.456,41719,14019,27700,5.133,15.276,491,0.180,30.552,1833,1954,9273
2005,4422,25218,34443,297215,300832,3512,10.240,3218,9.383,44857,19536,25321,6.494,14.911,51772,13859,37913,4.607,17.210,-6915,-2.299,29.822,2319,2392,8830
2005,4431,30068,50318,508337,503259,6821,13.705,5722,11.497,99745,36565,63180,7.266,19.820,86755,26478,60277,5.261,17.239,12990,2.581,34.477,3730,3943,15003
2005,4441,43874,64145,1111892,1089162,4504,7.062,3776,5.920,136152,48666,87486,4.468,12.501,91211,23368,67843,2.146,8.374,44941,4.126,16.749,2750,2893,15218
2005,4442,15418,18546,168534,171633,1233,6.578,1632,8.706,21741,5905,15836,3.440,12.667,28083,8760,19323,5.104,16.362,-6342,-3.695,25.334,1032,1054,4392
2005,4451,59503,85761,2612705,2623177,9692,11.295,9792,11.411,286444,123217,163227,4.697,10.920,306626,106936,199690,4.077,11.689,-20182,-0.769,21.839,6936,7104,41240
2005,4452,17256,20864,143969,144859,3415,16.178,3905,18.499,31912,15996,15916,11.042,22.030,33581,13979,19602,9.650,23.182,-1669,-1.152,44.059,2231,2259,9257
2005,4453,23730,27122,136829,139592,2833,10.502,2540,9.416,22419,10133,12286,7.259,16.060,27798,8710,19088,6.240,19.914,-5379,-3.853,32.121,1936,1953,6792
2005,4461,40010,80058,1016315,1022565,6320,7.926,5680,7.123,132170,53139,79031,5.197,12.925,147141,30495,116646,2.982,14.389,-14971,-1.464,25.851,3252,3352,16879
2005,4471,62988,111901,910518,924488,9473,8.439,10177,9.066,141730,56639,85091,6.127,15.331,168334,58680,109654,6.347,18.208,-26604,-2.878,30.661,6298,6848,37311
2005,4481,35255,86640,1181377,1182072,8840,10.260,7874,9.139,185379,66191,119188,5.600,15.683,187925,54165,133760,4.582,15.898,-2546,-0.215,31.365,4006,4340,20138
2005,4482,6094,25278,185767,191512,1445,5.591,2581,9.986,30385,8150,22235,4.256,15.866,41970,16029,25941,8.370,21.915,-11585,-6.049,31.732,628,829,4104
2005,4483,18160,28878,169644,167021,3075,10.804,2240,7.871,27220,12042,15178,7.210,16.297,22182,7824,14358,4.684,13.281,5038,3.016,26.562,1469,1500,4677
2005,4511,28210,38065,416013,412505,3978,10.417,4226,11.066,64416,27985,36431,6.784,15.616,57920,21716,36204,5.264,14.041,6496,1.575,28.082,2843,3038,12291
2005,4512,6127,11688,140295,142492,909,7.726,1063,9.035,14821,4989,9832,3.501,10.401,18835,5746,13089,4.033,13.218,-4014,-2.817,20.803,721,748,3480
2005,4522,159,5238,712274,725993,118,2.255,106,2.026,31824,8685,23139,1.196,4.384,60336,8087,52249,1.114,8.311,-28512,-3.927,8.767,18,18,68
2005,4523,8939,37795,2038951,2018195,3616,9.800,1820,4.933,189931,74152,115779,3.674,9.411,149154,11993,137161,0.594,7.390,40777,2.020,14.781,1230,1271,5057
2005,4531,18523,19375,101756,106004,1745,8.882,2290,11.655,15074,5725,9349,5.401,14.220,23618,7338,16280,6.922,22.280,-8544,-8.060,28.440,1888,1905,5778
2005,4532,27075,38274,319588,320804,4370,11.368,4705,12.239,51030,21482,29548,6.696,15.907,53455,19816,33639,6.177,16.663,-2425,-0.756,31.814,3576,3667,12972
2005,4533,12310,16580,128263,128505,1673,10.079,1712,10.314,19092,7292,11800,5.675,14.857,19631,6066,13565,4.720,15.277,-539,-0.419,29.714,1338,1348,4023
2005,4539,31861,40403,258552,256958,4852,12.044,4617,11.461,48341,18971,29370,7.383,18.813,44746,15339,29407,5.969,17.414,3595,1.399,34.828,3304,3593,11601
2005,4541,14505,15436,268646,268228,2501,16.605,1753,11.639,48372,19869,28503,7.408,18.034,47474,18014,29460,6.716,17.699,898,0.335,35.398,1322,1336,6818
2005,4542,4320,4899,52921,53813,497,10.073,567,11.492,5440,1810,3630,3.364,10.109,7292,2781,4511,5.168,13.551,-1852,-3.442,20.218,444,448,2179
2005,4543,21581,27136,216863,221539,2658,9.702,3177,11.597,32449,13799,18650,6.229,14.647,41315,18412,22903,8.311,18.649,-8866,-4.002,29.294,2126,2180,8002
2005,4811,572,3139,434609,435965,252,8.034,247,7.875,23033,4704,18329,1.079,5.283,25627,3369,22258,0.773,5.878,-2594,-0.595,10.566,48,60,449
2005,4812,1980,2144,38914,37958,297,14.016,247,11.656,6423,2120,4303,5.585,16.921,4461,2190,2271,5.770,11.752,1962,5.169,23.505,192,196,1566
2005,4831,771,1169,47656,46572,141,12.277,100,8.707,7744,2930,4814,6.291,16.628,5565,867,4698,1.862,11.949,2179,4.679,23.899,71,71,599
2005,4832,469,523,19074,19442,74,14.383,57,11.079,3561,814,2747,4.187,18.316,4499,2944,1555,15.142,23.141,-938,-4.825,36.632,37,37,2672
2005,4841,44955,54236,1022838,1005396,9512,17.848,7629,14.315,153245,43131,110114,4.290,15.242,117252,41429,75823,4.121,11.662,35993,3.580,23.325,5712,5842,25045
2005,4842,41805,45447,457650,454647,6196,13.692,5807,12.832,80959,29023,51936,6.384,17.807,74542,25208,49334,5.545,16.396,6417,1.411,32.791,4352,4374,17337
2005,4851,598,887,51262,50351,98,11.042,99,11.155,7409,4360,3049,8.659,14.715,5679,2089,3590,4.149,11.279,1730,3.436,22.558,72,72,1187
2005,4852,193,499,17177,17531,71,14.639,43,8.866,1959,1164,795,6.640,11.174,2679,859,1820,4.900,15.282,-720,-4.107,22.349,19,19,377
2005,4853,5871,5992,63575,63604,943,15.834,870,14.608,11699,4784,6915,7.522,18.393,11773,4947,6826,7.778,18.510,-74,-0.116,36.787,725,725,3605
2005,4854,2983,4122,183022,181860,277,6.686,319,7.700,22637,9294,13343,5.111,12.448,20458,7777,12681,4.276,11.249,2179,1.198,22.499,203,203,2445
2005,4855,1060,1161,27626,28442,139,11.896,154,13.179,4282,1377,2905,4.842,15.055,5928,2498,3430,8.783,20.843,-1646,-5.787,30.111,114,117,1436
2005,4859,2578,2819,57777,57950,420,14.939,405,14.405,9906,4216,5690,7.275,17.094,10384,4151,6233,7.163,17.919,-478,-0.825,34.188,313,314,2914
2005,4861,53,402,6087,6438,30,7.576,18,4.545,1139,570,569,8.854,17.693,1916,196,1720,3.045,29.763,-777,-12.070,35.386,4,4,40
2005,4862,127,1583,23507,23741,67,4.191,98,6.131,2084,941,1143,3.964,8.778,2512,1260,1252,5.307,10.581,-428,-1.803,17.556,11,12,94
2005,4869,55,620,6719,6565,79,13.244,32,5.365,1206,736,470,11.211,18.370,896,240,656,3.656,13.648,310,4.722,27.296,5,5,28
2005,4871,460,513,8732,8632,77,15.263,60,11.893,1255,352,903,4.078,14.539,1070,405,665,4.692,12.396,185,2.143,24.791,50,50,254
2005,4872,1167,1203,11256,11315,183,15.136,195,16.129,1766,622,1144,5.497,15.608,1904,547,1357,4.835,16.828,-138,-1.220,31.217,130,130,396
2005,4879,133,138,2247,2172,20,14.981,11,8.240,338,56,282,2.579,15.565,199,19,180,0.875,9.164,139,6.401,18.328,7,7,15
2005,4881,3427,4745,145583,142695,504,10.573,548,11.496,25902,10638,15264,7.455,18.152,20291,7895,12396,5.533,14.220,5611,3.932,28.440,256,263,2209
2005,4882,472,932,26681,26772,105,11.583,54,5.957,4602,2180,2422,8.143,17.190,4801,998,3803,3.728,17.933,-199,-0.743,34.380,24,31,669
2005,4883,1622,2129,89524,89138,178,8.316,201,9.390,11954,3049,8905,3.421,13.411,11078,2992,8086,3.357,12.428,876,0.983,24.856,120,120,764
2005,4884,7546,8049,66268,65813,1189,15.030,913,11.541,13710,6243,7467,9.486,20.832,12573,4270,8303,6.488,19.104,1137,1.728,38.209,705,707,3177
2005,4885,11889,16669,187202,183716,2087,12.772,1431,8.757,32199,12002,20197,6.533,17.527,25414,10505,14909,5.718,13.833,6785,3.693,27.667,842,883,4404
2005,4889,1187,1286,28382,28276,279,22.609,175,14.182,3818,1033,2785,3.653,13.503,3539,968,2571,3.423,12.516,279,0.987,25.032,125,125,577
2005,4921,2866,8058,501641,522850,926,11.171,1388,16.745,59147,33773,25374,6.459,11.312,99053,13828,85225,2.645,18.945,-39906,-7.632,22.625,342,371,1885
2005,4922,4052,4550,45504,46243,634,13.949,624,13.729,7735,2854,4881,6.172,16.727,9245,3232,6013,6.989,19.992,-1510,-3.265,33.454,504,505,2610
2005,4931,6733,13047,595745,592791,1102,8.458,1067,8.189,81697,28290,53407,4.772,13.782,76781,24113,52668,4.068,12.952,4916,0.829,25.905,392,401,4344
2005,5111,15030,20987,699731,701815,1970,9.414,1848,8.831,69828,23473,46355,3.345,9.950,73811,24744,49067,3.526,10.517,-3983,-0.568,19.899,1184,1214,10528
2005,5112,5918,8328,329043,324148,911,10.872,1014,12.101,51430,13787,37643,4.253,15.866,42078,18405,23673,5.678,12.981,9352,2.885,25.962,532,569,7818
2005,5121,12009,15511,281846,281042,2232,14.512,1970,12.809,41329,19018,22311,6.767,14.706,39755,13423,26332,4.776,14.146,1574,0.560,28.291,1227,1240,6677
2005,5122,2608,2824,22298,23764,400,13.979,475,16.600,3867,1633,2234,6.872,16.273,6708,4256,2452,17.910,28.228,-2841,-11.955,32.546,287,287,884
2005,5151,4397,8958,245174,244995,713,7.944,747,8.323,25938,11097,14841,4.529,10.587,25542,9591,15951,3.915,10.426,396,0.162,20.851,365,390,4662
2005,5152,332,585,39028,38872,113,17.698,220,34.456,6805,4671,2134,12.017,17.506,6373,3446,2927,8.865,16.395,432,1.111,32.790,32,37,1053
2005,5173,6046,43891,1206163,1246919,5433,12.409,5215,11.911,165794,57830,107964,4.638,13.296,246828,78204,168624,6.272,19.795,-81034,-6.499,26.593,928,1168,10760
2005,5174,453,577,11450,11737,124,22.222,86,15.412,1746,842,904,7.174,14.876,2348,1084,1264,9.236,20.005,-602,-5.129,29.752,46,46,303
2005,5179,4963,5670,76295,73314,1213,21.230,1300,22.753,26843,19169,7674,26.147,36.614,21808,10521,11287,14.351,29.746,5035,6.868,59.492,869,896,6219
2005,5182,7321,14035,390762,389359,2045,14.892,1439,10.479,65487,26950,38537,6.922,16.819,63185,19224,43961,4.937,16.228,2302,0.591,32.456,659,676,6409
2005,5191,4862,5896,104598,101783,773,13.383,533,9.228,18436,6540,11896,6.425,18.113,12566,3788,8778,3.722,12.346,5870,5.767,24.692,369,370,2252
2005,5211,19,54,20090,20863,3,5.357,7,12.500,571,10,561,0.048,2.737,2194,403,1791,1.932,10.516,-1623,-7.780,5.474,D,D,D
2005,5221,16117,113621,2060881,2072012,9377,8.237,9804,8.613,270829,100122,170707,4.832,13.071,291636,145118,146518,7.004,14.075,-20807,-1.004,26.142,550,803,8738
2005,5222,18785,50691,786366,771904,8381,16.764,6987,13.976,179875,78284,101591,10.142,23.303,152331,67615,84716,8.760,19.734,27544,3.568,39.469,2003,2093,12005
2005,5223,24660,39434,328698,325097,7721,20.578,3896,10.383,77371,31820,45551,9.788,23.799,69245,20761,48484,6.386,21.300,8126,2.500,42.600,2474,2561,12850
2005,5231,12304,35710,480546,496789,5618,15.166,8286,22.368,122296,86643,35653,17.441,24.617,152803,95160,57643,19.155,30.758,-30507,-6.141,49.235,1061,1094,6940
2005,5232,55,60,6814,6785,12,20.870,7,12.174,327,65,262,0.958,4.819,280,33,247,0.486,4.127,47,0.693,8.254,6,6,31
2005,5239,32385,36391,354407,344033,6551,18.496,4606,13.005,79297,45096,34201,13.108,23.049,58673,24004,34669,6.977,17.054,20624,5.995,34.109,3019,3051,11461
2005,5241,6247,32191,1405599,1444697,6494,20.461,5590,17.612,138614,55827,82787,3.864,9.595,215194,81596,133598,5.648,14.895,-76580,-5.301,19.189,459,490,10286
2005,5242,118381,132023,921918,910715,13483,10.321,10706,8.195,159660,68970,90690,7.573,17.531,136342,50772,85570,5.575,14.971,23318,2.560,29.942,7284,7456,27248
2005,5259,773,815,6406,5613,196,24.685,154,19.395,3075,810,2265,14.431,54.784,1623,731,892,13.023,28.915,1452,25.869,57.830,112,114,551
2005,5311,86749,104909,543339,545265,11798,11.312,10566,10.131,96125,47559,48566,8.722,17.629,100637,39056,61581,7.163,18.457,-4512,-0.827,35.258,7776,8264,28880
2005,5312,71454,80010,339675,330748,16322,21.387,8940,11.714,85649,47578,38071,14.385,25.896,68090,24575,43515,7.430,20.587,17559,5.309,41.173,5655,5721,14190
2005,5313,58135,65984,606257,594610,11301,17.717,6902,10.821,113107,57131,55976,9.608,19.022,89505,31071,58434,5.225,15.053,23602,3.969,30.105,4562,4621,19325
2005,5321,4083,11968,171110,169366,2530,22.580,1003,8.952,30070,18148,11922,10.715,17.754,25963,5163,20800,3.048,15.330,4107,2.425,30.659,552,571,2766
2005,5322,11979,32069,264067,263243,2946,9.198,2862,8.936,40330,16467,23863,6.255,15.320,38906,12324,26582,4.682,14.780,1424,0.541,29.559,1487,1789,6609
2005,5323,3213,4966,32493,32726,378,7.577,424,8.499,4739,1601,3138,4.892,14.481,5127,2094,3033,6.399,15.667,-388,-1.186,28.962,239,276,1261
2005,5324,7418,12279,152873,154743,1315,10.749,1225,10.013,26889,9672,17217,6.250,17.377,30264,11049,19215,7.140,19.558,-3375,-2.181,34.753,624,654,3213
2005,5331,1924,1989,28632,28638,251,12.680,232,11.720,5747,1741,4006,6.079,20.068,5698,2811,2887,9.816,19.897,49,0.171,39.794,167,170,789
2005,5411,162343,171314,1201759,1209592,15154,8.894,13297,7.804,133677,45511,88166,3.763,11.051,149099,43023,106076,3.557,12.326,-15422,-1.275,22.103,9722,9826,30624
2005,5412,92941,106411,1204476,1211333,11023,10.464,8895,8.444,215009,76647,138362,6.327,17.750,224484,65208,159276,5.383,18.532,-9475,-0.782,35.500,5857,5939,37544
2005,5413,86048,98612,1293227,1278711,10972,11.257,8691,8.916,192946,57497,135449,4.496,15.089,163869,57285,106584,4.480,12.815,29077,2.274,25.630,5444,5548,26328
2005,5414,26437,26712,119547,118839,4133,15.642,3553,13.447,23019,9282,13737,7.811,19.370,21734,9433,12301,7.938,18.289,1285,1.081,36.577,2531,2538,6672
2005,5415,77038,87444,1141614,1122715,17539,20.383,14749,17.140,245306,93173,152133,8.299,21.849,207112,87965,119147,7.835,18.447,38194,3.402,36.895,9400,9518,38600
2005,5416,89936,95780,818903,791535,19345,20.694,14750,15.778,194101,77797,116304,9.829,24.522,140386,59188,81198,7.478,17.736,53715,6.786,35.472,10277,10358,37776
2005,5417,10917,14280,634722,630776,1874,13.203,1702,11.991,90624,27448,63176,4.351,14.367,82545,25669,56876,4.069,13.086,8079,1.281,26.173,938,957,9245
2005,5418,30790,34012,414398,402452,4051,11.933,3921,11.550,90815,27714,63101,6.886,22.565,65986,26573,39413,6.603,16.396,24829,6.169,32.792,2630,2648,11022
2005,5419,52924,61129,554616,549804,6686,11.041,5544,9.155,94011,28095,65916,5.110,17.099,84588,23488,61100,4.272,15.385,9423,1.714,30.770,3835,3891,15322
2005,5511,25901,47717,2836320,2839140,4662,9.871,3685,7.802,421067,140498,280569,4.949,14.831,427533,119272,308261,4.201,15.059,-6466,-0.228,29.662,1061,1102,16602
2005,5611,20267,22170,436782,429456,4324,20.234,2723,12.742,96345,46049,50296,10.723,22.434,81605,32867,48738,7.653,19.002,14740,3.432,38.004,1994,2015,20439
2005,5612,1643,4129,172588,169348,536,13.285,347,8.601,28792,11348,17444,6.701,17.002,22532,7065,15467,4.172,13.305,6260,3.697,26.610,138,141,1473
2005,5613,26962,44072,4273561,4035933,6423,14.707,5627,12.884,1199966,326420,873546,8.088,29.732,720888,251095,469793,6.221,17.862,479078,11.870,35.723,2990,3141,155684
2005,5614,26779,32712,779027,780710,4356,13.418,3858,11.884,148883,58827,90056,7.535,19.070,152773,53971,98802,6.913,19.568,-3890,-0.498,38.140,2729,2768,23098
2005,5615,16146,21692,252999,256673,2090,9.456,2911,13.170,43653,21606,22047,8.418,17.007,51364,17782,33582,6.928,20.011,-7711,-3.004,34.014,1550,1594,6467
2005,5616,16912,21386,758322,751363,2558,11.991,2451,11.490,124611,35259,89352,4.693,16.585,110759,36458,74301,4.852,14.741,13852,1.844,29.482,1590,1662,21117
2005,5617,128348,134515,1614475,1605475,21603,16.248,18493,13.909,315369,108155,207214,6.737,19.643,298645,101975,196670,6.352,18.602,16724,1.042,37.203,12744,12786,66417
2005,5619,17039,19228,346839,348005,2107,11.002,1953,10.198,59457,16684,42773,4.794,17.085,62969,24223,38746,6.961,18.094,-3512,-1.009,34.170,1321,1333,9341
2005,5621,6575,8284,172992,176458,846,10.209,851,10.270,21290,6029,15261,3.417,12.065,27464,17064,10400,9.670,15.564,-6174,-3.499,24.130,467,469,2829
2005,5622,1456,2425,54048,54854,215,8.802,250,10.235,7341,2346,4995,4.277,13.383,8792,4804,3988,8.758,16.028,-1451,-2.645,26.766,94,94,535
2005,5629,6568,7239,108316,110174,809,11.288,665,9.279,22086,6963,15123,6.320,20.047,25623,6297,19326,5.716,23.257,-3537,-3.210,40.093,446,447,2554
2005,6111,17203,19407,782925,773404,1171,6.097,770,4.009,72522,21163,51359,2.736,9.377,53278,11597,41681,1.499,6.889,19244,2.488,13.778,547,553,7271
2005,6112,471,827,84341,79803,64,7.848,41,5.028,14627,5718,8909,7.165,18.329,5556,587,4969,0.736,6.962,9071,11.367,13.924,33,33,440
2005,6113,2276,3448,1513538,1507845,450,13.682,132,4.013,105392,30444,74948,2.019,6.990,93817,7147,86670,0.474,6.222,11575,0.768,12.444,62,62,1158
2005,6114,5927,6436,61064,61227,896,13.867,947,14.656,11495,4583,6912,7.485,18.775,11934,4752,7182,7.761,19.492,-439,-0.717,37.549,656,672,3251
2005,6115,5891,7057,105868,104260,742,10.579,656,9.353,18553,5499,13054,5.274,17.795,15328,4231,11097,4.058,14.702,3225,3.093,29.403,482,492,2820
2005,6116,27444,29523,270848,263773,4525,15.695,3140,10.891,59115,22931,36184,8.693,22.411,45331,13981,31350,5.300,17.186,13784,5.226,34.371,2229,2240,9506
2005,6117,4659,5099,61841,60053,904,18.270,602,12.167,13690,6542,7148,10.894,22.797,10239,3075,7164,5.121,17.050,3451,5.747,34.100,402,405,2118
2005,6211,173135,197454,2027327,2035188,16183,8.253,13441,6.855,252057,86952,165105,4.272,12.385,267645,70869,196776,3.482,13.151,-15588,-0.766,24.770,9689,9897,45946
2005,6212,111765,116844,787413,794482,6367,5.487,4744,4.089,94236,30556,63680,3.846,11.861,108519,22024,86495,2.772,13.659,-14283,-1.798,23.723,3878,3954,18720
2005,6213,95319,104480,551996,548924,11431,11.119,8089,7.868,100358,36473,63885,6.644,18.283,94399,29576,64823,5.388,17.197,5959,1.086,34.394,5548,5634,20099
2005,6214,12656,25455,643617,640078,2358,9.440,1406,5.629,79395,30724,48671,4.800,12.404,72960,17401,55559,2.719,11.399,6435,1.005,22.797,750,782,7908
2005,6215,6906,10946,217249,215081,1724,16.387,873,8.298,33883,13226,20657,6.149,15.754,29658,11416,18242,5.308,13.789,4225,1.964,27.579,545,557,3805
2005,6216,12563,18291,908530,881941,3218,18.351,1708,9.740,162092,47146,114946,5.346,18.379,109735,31328,78407,3.552,12.442,52357,5.937,24.885,1131,1188,17162
2005,6219,5480,8309,247269,239933,792,9.591,689,8.344,42560,12397,30163,5.167,17.738,28089,9031,19058,3.764,11.707,14471,6.031,23.414,361,374,4704
2005,6221,3260,5231,4843585,4823199,127,2.433,105,2.011,201882,34502,167380,0.715,4.186,160937,42556,118381,0.882,3.337,40945,0.849,6.673,43,44,8282
2005,6222,524,664,211511,212643,49,7.458,35,5.327,8321,2732,5589,1.285,3.913,10543,6554,3989,3.082,4.958,-2222,-1.045,7.826,19,20,2921
2005,6223,547,884,203034,199998,122,14.429,45,5.322,16177,4889,11288,2.445,8.089,10381,2328,8053,1.164,5.191,5796,2.898,10.381,24,24,756
2005,6231,8480,16066,1603963,1605045,1357,8.536,1020,6.416,148259,70644,77615,4.401,9.237,150755,67499,83256,4.205,9.393,-2496,-0.156,18.474,514,531,27601
2005,6232,8015,30190,554585,544724,2605,8.811,1356,4.586,75536,25539,49997,4.688,13.867,56026,14078,41948,2.584,10.285,19510,3.582,20.570,366,453,4588
2005,6233,13191,17631,624280,613733,1878,10.726,1635,9.338,84348,38664,45684,6.300,13.743,63336,25319,38017,4.125,10.320,21012,3.424,20.640,1151,1211,15450
2005,6239,3558,6131,156467,157112,447,7.297,436,7.118,16896,4703,12193,2.993,10.754,17977,5227,12750,3.327,11.442,-1081,-0.688,21.508,235,247,2485
2005,6241,36988,51250,1040517,1015607,4614,9.131,3179,6.291,155519,41980,113539,4.133,15.313,106299,24867,81432,2.448,10.467,49220,4.846,20.933,1970,2019,14443
2005,6242,9254,12480,156281,154549,595,4.779,536,4.305,18806,3526,15280,2.281,12.168,15435,3091,12344,2.000,9.987,3371,2.181,19.974,277,281,1757
2005,6243,4872,7937,333210,328099,508,6.409,486,6.132,50401,11035,39366,3.363,15.362,40132,7401,32731,2.256,12.232,10269,3.130,24.463,245,270,3029
2005,6244,53059,66654,800416,795174,7639,11.539,6735,10.173,124376,49805,74571,6.263,15.641,113757,40205,73552,5.056,14.306,10619,1.335,28.612,4975,5080,28630
2005,7111,7379,7524,133125,129456,897,11.875,957,12.669,30143,12504,17639,9.659,23.284,22216,6778,15438,5.236,17.161,7927,6.123,34.322,636,640,4689
2005,7112,3293,3468,116938,114283,523,15.226,457,13.304,21138,6714,14424,5.875,18.496,15918,3867,12051,3.384,13.929,5220,4.568,27.857,336,337,2248
2005,7113,4504,4825,105638,105912,601,12.535,540,11.263,19697,4152,15545,3.920,18.598,20247,3844,16403,3.629,19.117,-550,-0.519,37.195,376,376,2462
2005,7114,2645,2707,18941,17118,434,16.209,375,14.006,6300,4991,1309,29.157,36.804,2890,1074,1816,6.274,16.883,3410,19.921,33.767,271,275,848
2005,7115,12178,12195,42878,43481,2610,21.906,2049,17.198,13272,6228,7044,14.323,30.524,14505,5448,9057,12.530,33.359,-1233,-2.836,61.047,1208,1211,3146
2005,7121,5931,6351,121108,120370,433,6.886,307,4.882,10742,1604,9138,1.333,8.924,9328,939,8389,0.780,7.749,1414,1.175,15.499,184,184,578
2005,7131,1824,2347,146221,143085,368,15.710,359,15.326,17237,4818,12419,3.367,12.047,10999,2813,8186,1.966,7.687,6238,4.360,15.374,228,231,2115
2005,7132,1687,2181,187269,182558,290,13.609,190,8.916,24789,8653,16136,4.740,13.579,15831,2866,12965,1.570,8.672,8958,4.907,17.344,140,140,1417
2005,7139,49955,55336,1065302,1059260,7307,13.402,5681,10.419,164022,62565,101457,5.906,15.485,152263,48700,103563,4.598,14.374,11759,1.110,28.749,4347,4379,34499
2005,7211,36918,46769,1788705,1788841,5012,10.743,4784,10.254,234500,104660,129840,5.851,13.109,234558,106127,128431,5.933,13.112,-58,-0.003,26.218,3160,3346,57475
2005,7212,5013,5487,37712,37660,531,9.685,522,9.521,6853,2309,4544,6.131,18.197,6799,2116,4683,5.619,18.054,54,0.143,36.107,348,351,1399
2005,7213,2164,2233,12420,12866,141,6.227,204,9.009,1661,455,1206,3.537,12.910,2571,1155,1416,8.977,19.984,-910,-7.073,25.821,141,143,980
2005,7223,11270,29369,559725,541916,4385,15.365,2724,9.545,119527,69152,50375,12.761,22.056,85179,31341,53838,5.783,15.718,34348,6.338,31.436,1439,1482,10438
2005,7224,41934,42507,352723,356708,5172,12.078,5800,13.545,76111,40786,35325,11.434,21.337,83888,34029,49859,9.540,23.517,-7777,-2.180,42.674,4782,4800,28183
2005,7225,301367,411030,8280577,8157193,56267,13.891,44300,10.937,1530535,806691,723844,9.889,18.763,1289063,453546,835517,5.560,15.803,241472,2.960,31.606,34295,35169,327732
2005,8111,139401,152428,875353,887852,15192,9.959,15415,10.106,145427,62939,82488,7.089,16.380,170182,57533,112649,6.480,19.168,-24755,-2.788,32.759,11828,12022,43886
2005,8112,10933,12362,129472,129786,1290,10.315,1578,12.618,21799,8960,12839,6.904,16.796,22566,7064,15502,5.443,17.387,-767,-0.591,33.592,1126,1148,3736
2005,8113,20907,22309,181892,181126,2222,10.030,1911,8.626,28216,8132,20084,4.490,15.578,26879,7870,19009,4.345,14.840,1337,0.738,29.680,1417,1430,5442
2005,8114,19944,21067,103403,105400,2468,11.638,2746,12.949,16494,6728,9766,6.383,15.649,20494,7539,12955,7.153,19.444,-4000,-3.795,31.298,2012,2064,5418
2005,8121,81660,95616,591327,587260,13738,14.558,11237,11.908,108312,56399,51913,9.604,18.444,100170,39681,60489,6.757,17.057,8142,1.386,34.114,9063,9259,32798
2005,8122,14735,20436,136630,140834,943,4.577,1281,6.217,16110,3559,12551,2.527,11.439,24783,5894,18889,4.185,17.597,-8673,-6.158,22.878,472,491,1634
2005,8123,31998,38554,368579,374637,4244,10.974,4482,11.589,49131,19772,29359,5.278,13.114,61116,21940,39176,5.856,16.313,-11985,-3.199,26.229,3269,3375,14528
2005,8129,20663,31708,226594,227942,5080,16.083,4835,15.308,49003,22305,26698,9.785,21.498,51458,21809,29649,9.568,22.575,-2455,-1.077,42.996,2680,2721,10817
2005,8131,165167,165546,1615541,1619394,8380,5.089,6630,4.026,156102,27419,128683,1.693,9.640,164326,22980,141346,1.419,10.147,-8224,-0.508,19.279,4168,4168,11998
2005,8132,13722,15646,152747,151471,1284,8.313,884,5.723,17144,4127,13017,2.725,11.318,14606,3680,10926,2.430,9.643,2538,1.676,19.286,555,568,2593
2005,8133,11537,13664,121827,120991,1138,8.425,824,6.101,17109,4318,12791,3.569,14.141,15572,3155,12417,2.608,12.870,1537,1.270,25.741,496,496,1944
2005,8134,28197,30265,321422,323413,1442,4.753,1589,5.238,34057,5721,28336,1.769,10.531,37902,6163,31739,1.906,11.719,-3845,-1.189,21.061,1109,1112,4380
2005,8139,60400,62311,529154,535567,2636,4.201,3498,5.575,58443,9360,49083,1.748,10.912,71076,15952,55124,2.979,13.271,-12633,-2.359,21.825,2364,2375,10199
2006,1131,326,371,2713,3512,46,12.416,45,12.146,430,175,255,4.984,12.245,2108,1873,235,53.339,60.031,-1678,-47.786,24.491,32,32,338
2006,1132,131,186,1920,1785,30,16.620,19,10.526,517,279,238,15.630,28.964,246,133,113,7.451,13.782,271,15.182,27.563,13,13,101
2006,1133,8937,9005,61632,62464,981,10.815,1113,12.270,9963,3448,6515,5.520,15.950,11517,4167,7350,6.671,18.438,-1554,-2.488,31.900,828,828,2746
2006,1141,1161,1173,5501,5451,249,21.466,223,19.224,1180,534,646,9.797,21.649,1071,453,618,8.311,19.650,109,2.000,39.299,132,132,272
2006,1142,270,270,1819,1742,44,16.635,33,12.476,336,105,231,6.028,19.288,185,62,123,3.559,10.620,151,8.668,21.240,27,27,54
2006,1151,3404,3722,58184,57787,480,12.964,441,11.911,11650,3929,7721,6.799,20.160,10796,3198,7598,5.534,18.682,854,1.478,37.365,323,323,2259
2006,1152,3487,3557,18658,18475,574,16.233,532,15.045,3421,1406,2015,7.610,18.517,3010,1377,1633,7.454,16.293,411,2.225,32.585,422,422,1151
2006,1153,1282,1355,13774,13900,225,16.936,172,12.947,3117,1021,2096,7.345,22.424,3354,1214,2140,8.734,24.129,-237,-1.705,44.849,121,121,934
2006,2111,5729,6860,91114,86955,778,11.532,551,8.167,19476,7956,11520,9.150,22.398,10938,4694,6244,5.398,12.579,8538,9.819,25.158,349,352,1434
2006,2121,627,1044,78023,76012,122,11.787,104,10.048,12503,3802,8701,5.002,16.449,8448,3289,5159,4.327,11.114,4055,5.335,22.228,58,63,1281
2006,2122,188,260,27921,27054,33,12.741,31,11.969,2744,187,2557,0.691,10.143,969,316,653,1.168,3.582,1775,6.561,7.164,21,21,48
2006,2123,3293,5459,99064,97744,501,9.314,341,6.339,14016,4526,9490,4.630,14.340,11422,3205,8217,3.279,11.686,2594,2.654,23.371,193,195,1060
2006,2131,8101,9652,254721,234774,1548,16.659,828,8.911,66608,25179,41429,10.725,28.371,26399,12416,13983,5.289,11.244,40209,17.127,22.489,497,511,4535
2006,2211,1582,9393,497123,504799,575,6.138,524,5.594,37663,13901,23762,2.754,7.461,52802,8531,44271,1.690,10.460,-15139,-2.999,14.922,54,56,1546
2006,2212,466,2420,80481,80466,255,10.524,261,10.772,9312,3352,5960,4.166,11.573,9183,4207,4976,5.228,11.412,129,0.160,22.825,28,31,154
2006,2213,4061,4862,41025,40755,295,6.051,321,6.585,5123,1671,3452,4.100,12.570,4575,1517,3058,3.722,11.226,548,1.345,22.451,176,176,1000
2006,2361,165927,167248,986358,945615,33790,20.781,24493,15.063,272477,113549,158928,12.008,28.815,191742,80400,111342,8.502,20.277,80735,8.538,40.554,18057,18110,58252
2006,2362,37420,38579,728014,704740,4801,12.638,3618,9.524,150683,31988,118695,4.539,21.381,104296,22623,81673,3.210,14.799,46387,6.582,29.598,2700,2711,15936
2006,2371,18695,19710,500615,476939,1980,10.135,1634,8.364,112742,25089,87653,5.260,23.639,65943,17591,48352,3.688,13.826,46799,9.812,27.653,1140,1145,8673
2006,2372,10326,10414,75465,71414,1859,18.288,1361,13.389,19940,6607,13333,9.252,27.922,11802,5308,6494,7.433,16.526,8138,11.396,33.053,1059,1062,4209
2006,2373,9870,10624,325947,318504,925,8.760,795,7.529,59301,11327,47974,3.556,18.619,44521,8812,35709,2.767,13.978,14780,4.640,27.956,509,510,4061
2006,2379,4364,4581,87756,84138,668,14.911,466,10.402,19020,4700,14320,5.586,22.606,11678,2343,9335,2.785,13.880,7342,8.726,27.759,322,323,1437
2006,2381,98464,99143,1170561,1120790,15646,16.067,12124,12.450,300168,85418,214750,7.621,26.782,200744,59824,140920,5.338,17.911,99424,8.871,35.822,8930,8936,45025
2006,2382,160081,163605,1952919,1886673,20712,12.911,14352,8.946,397038,95011,302027,5.036,21.044,265248,72352,192896,3.835,14.059,131790,6.985,28.118,10805,10849,52039
2006,2383,112211,113410,976583,937682,20202,18.250,14779,13.351,250467,80787,169680,8.616,26.711,173708,55120,118588,5.878,18.525,76759,8.186,37.051,11098,11101,42188
2006,2389,59389,59933,557013,525604,11486,19.935,6854,11.896,143329,49220,94109,9.364,27.269,80500,27207,53293,5.176,15.316,62829,11.954,30.631,4986,4987,19310
2006,3111,1164,1727,48117,47623,120,6.991,99,5.768,5238,1237,4001,2.597,10.999,4206,1112,3094,2.335,8.832,1032,2.167,17.664,58,60,384
2006,3112,456,778,55285,55764,39,5.003,42,5.388,3246,593,2653,1.063,5.821,4232,614,3618,1.101,7.589,-986,-1.768,11.642,25,25,217
2006,3113,1504,1676,71686,72945,149,8.864,159,9.459,6196,991,5205,1.359,8.494,8727,2437,6290,3.341,11.964,-2531,-3.470,16.988,134,134,1021
2006,3114,1220,1589,162878,162532,104,6.462,145,9.009,15578,3455,12123,2.126,9.585,14947,4018,10929,2.472,9.196,631,0.388,18.393,89,89,1321
2006,3115,995,1488,130676,131885,89,5.957,101,6.760,9173,2645,6528,2.006,6.955,11585,4610,6975,3.495,8.784,-2412,-1.829,13.911,55,56,1420
2006,3116,2945,3557,497336,496465,197,5.490,260,7.245,34059,4581,29478,0.923,6.860,33045,8680,24365,1.748,6.656,1014,0.204,13.312,193,193,2144
2006,3117,514,606,35759,36627,43,6.897,78,12.510,3896,1013,2883,2.766,10.637,5535,2022,3513,5.521,15.112,-1639,-4.475,21.274,51,51,733
2006,3118,8875,9643,293027,293760,888,9.134,1046,10.759,32592,8998,23594,3.063,11.095,33930,11995,21935,4.083,11.550,-1338,-0.455,22.190,824,837,6319
2006,3119,2535,2969,159834,159730,282,9.561,243,8.239,15673,4783,10890,2.994,9.812,15447,5189,10258,3.249,9.671,226,0.141,19.341,182,184,3175
2006,3121,2624,3176,134728,133969,382,12.368,207,6.702,12841,2509,10332,1.873,9.585,11518,2453,9065,1.831,8.598,1323,0.988,17.195,149,149,1341
2006,3122,84,115,21223,21523,16,13.853,17,14.719,925,172,753,0.799,4.298,1494,240,1254,1.115,6.942,-569,-2.644,8.596,9,9,32
2006,3131,290,432,48097,49919,29,6.488,59,13.199,4280,1319,2961,2.642,8.574,8004,3651,4353,7.314,16.034,-3724,-7.460,17.148,32,32,276
2006,3132,1128,1307,93037,98301,59,4.377,141,10.460,6613,2383,4230,2.424,6.727,17491,6530,10961,6.643,17.793,-10878,-11.066,13.455,93,94,1137
2006,3133,1233,1300,49135,50512,102,7.713,147,11.115,5009,1777,3232,3.518,9.916,7765,3165,4600,6.266,15.373,-2756,-5.456,19.833,111,113,1815
2006,3141,2300,2443,80818,83790,186,7.436,303,12.113,5803,1395,4408,1.665,6.926,11788,5167,6621,6.167,14.069,-5985,-7.143,13.851,242,244,1765
2006,3149,4214,4340,80579,81875,359,8.134,506,11.465,9780,2124,7656,2.594,11.945,12459,5030,7429,6.144,15.217,-2679,-3.272,23.890,415,415,2815
2006,3151,439,482,30466,31734,26,5.138,74,14.625,3196,1836,1360,5.786,10.071,5654,2096,3558,6.605,17.817,-2458,-7.746,20.142,58,58,979
2006,3152,7121,7265,158359,166381,1345,18.308,1508,20.527,28195,14066,14129,8.454,16.946,44124,20858,23266,12.536,26.520,-15929,-9.574,33.892,1347,1352,15725
2006,3159,816,842,16724,17818,69,7.872,138,15.744,1663,583,1080,3.272,9.333,3858,1716,2142,9.631,21.652,-2195,-12.319,18.667,112,112,605
2006,3161,214,221,5685,6205,22,10.046,18,8.219,537,114,423,1.837,8.655,1535,918,617,14.796,24.740,-998,-16.085,17.310,13,13,113
2006,3162,239,263,15328,15674,16,5.893,33,12.155,1202,376,826,2.399,7.669,1864,762,1102,4.862,11.893,-662,-4.224,15.338,20,22,365
2006,3169,753,764,16022,16282,69,8.903,91,11.742,2004,390,1614,2.395,12.308,2553,1338,1215,8.218,15.680,-549,-3.372,24.617,71,71,547
2006,3211,3588,4030,118072,117059,323,8.008,330,8.181,13021,3733,9288,3.189,11.123,10933,3876,7057,3.311,9.340,2088,1.784,18.680,260,260,2359
2006,3212,1474,1885,125168,123032,148,7.938,107,5.739,14248,4133,10115,3.359,11.581,9993,2302,7691,1.871,8.122,4255,3.458,16.245,68,68,1098
2006,3219,9213,10160,342692,335814,960,9.489,874,8.639,49929,14284,35645,4.254,14.868,35885,11495,24390,3.423,10.686,14044,4.182,21.372,680,686,6449
2006,3221,274,565,138037,142167,30,5.213,51,8.862,3403,880,2523,0.619,2.394,11902,6006,5896,4.225,8.372,-8499,-5.978,4.787,16,16,707
2006,3222,2977,4467,303963,307124,192,4.253,287,6.357,22824,7029,15795,2.289,7.432,29339,10524,18815,3.427,9.553,-6515,-2.121,14.863,146,146,2283
2006,3231,30402,32009,646552,654633,1990,6.129,2913,8.971,62085,18936,43149,2.893,9.484,78150,27834,50316,4.252,11.938,-16065,-2.454,18.968,2406,2411,16518
2006,3241,1035,2270,100086,100449,193,8.593,145,6.456,8157,2504,5653,2.493,8.121,8986,3964,5022,3.946,8.946,-829,-0.825,16.241,47,47,812
2006,3251,1232,2320,162903,163669,171,7.409,147,6.369,10939,3676,7263,2.246,6.684,12579,2600,9979,1.589,7.686,-1640,-1.002,13.367,52,53,401
2006,3252,749,1066,89070,90741,80,7.544,69,6.506,5622,1154,4468,1.272,6.196,8935,2681,6254,2.955,9.847,-3313,-3.651,12.391,40,41,1198
2006,3253,630,879,28846,29355,65,7.403,63,7.175,1894,453,1441,1.543,6.452,2872,899,1973,3.063,9.784,-978,-3.332,12.904,33,33,220
2006,3254,1394,1807,246745,244519,154,8.603,120,6.704,20254,2790,17464,1.141,8.283,15765,3620,12145,1.480,6.447,4489,1.836,12.895,74,74,1312
2006,3255,1448,1848,63943,64120,112,6.062,111,6.008,5660,1664,3996,2.595,8.827,6133,1738,4395,2.711,9.565,-473,-0.738,17.655,72,72,746
2006,3256,1946,2169,103679,104023,146,6.742,139,6.419,8627,2588,6039,2.488,8.293,9334,2197,7137,2.112,8.973,-707,-0.680,16.587,102,102,1266
2006,3259,2069,2657,107383,108148,214,8.094,188,7.110,9144,1919,7225,1.774,8.455,10608,2540,8068,2.349,9.809,-1464,-1.354,16.910,116,116,957
2006,3261,9383,11936,737803,737798,626,5.216,755,6.291,70875,17535,53340,2.377,9.606,71115,21145,49970,2.866,9.639,-240,-0.033,19.213,501,509,8461
2006,3262,1685,2182,156610,157942,121,5.557,112,5.144,9103,2376,6727,1.504,5.764,11622,2859,8763,1.810,7.358,-2519,-1.595,11.527,71,71,603
2006,3271,1237,1440,52964,53711,131,9.007,160,11.000,4485,987,3498,1.838,8.350,5975,1648,4327,3.068,11.124,-1490,-2.774,16.700,119,119,540
2006,3272,1658,1980,102241,102363,155,7.789,175,8.794,9140,1401,7739,1.369,8.929,9194,2919,6275,2.852,8.982,-54,-0.053,17.858,134,134,940
2006,3273,4937,9727,229000,223138,900,9.450,494,5.187,39032,14190,24842,6.359,17.492,27165,6132,21033,2.748,12.174,11867,5.318,24.348,228,245,2581
2006,3274,209,336,17945,17930,17,5.022,22,6.499,1278,227,1051,1.266,7.128,1239,158,1081,0.881,6.910,39,0.218,13.821,15,15,113
2006,3279,2711,3167,81940,79332,368,11.929,204,6.613,12423,4122,8301,5.196,15.660,7134,2411,4723,3.039,8.993,5289,6.667,17.985,148,148,1766
2006,3311,397,514,106490,106883,39,7.464,56,10.718,4655,1004,3651,0.939,4.355,5619,2504,3115,2.343,5.257,-964,-0.902,8.710,38,38,415
2006,3312,470,610,45596,45753,35,5.719,39,6.373,3397,686,2711,1.499,7.425,3684,1150,2534,2.513,8.052,-287,-0.627,14.849,26,26,243
2006,3313,417,570,64144,65137,37,6.497,36,6.321,3623,940,2683,1.443,5.562,5599,1757,3842,2.697,8.596,-1976,-3.034,11.124,20,20,124
2006,3314,723,918,61455,61708,52,5.699,41,4.493,3499,805,2694,1.305,5.670,4085,498,3587,0.807,6.620,-586,-0.950,11.341,27,27,103
2006,3315,1877,2133,166976,165811,99,4.626,113,5.280,14256,2474,11782,1.492,8.598,11936,3070,8866,1.852,7.199,2320,1.399,14.397,82,83,1465
2006,3321,2391,2643,126598,126701,129,4.883,127,4.807,11757,3129,8628,2.470,9.279,11822,3355,8467,2.648,9.331,-65,-0.051,18.559,87,89,1854
2006,3322,1295,1412,53770,54908,83,5.825,109,7.649,3895,509,3386,0.927,7.094,6187,2529,3658,4.606,11.268,-2292,-4.174,14.187,73,73,398
2006,3323,12024,12972,397278,386387,980,7.603,816,6.330,57370,11426,45944,2.957,14.848,35364,9565,25799,2.475,9.152,22006,5.695,18.305,597,598,4654
2006,3324,1247,1508,88387,87369,65,4.283,84,5.535,8234,989,7245,1.132,9.424,6200,1583,4617,1.812,7.096,2034,2.328,14.193,58,66,854
2006,3325,693,776,44785,46172,41,5.284,41,5.284,2903,737,2166,1.596,6.287,5687,2159,3528,4.676,12.317,-2784,-6.030,12.575,30,30,643
2006,3326,1405,1585,54522,54971,54,3.346,112,6.939,4928,819,4109,1.490,8.965,5920,1586,4334,2.885,10.769,-992,-1.805,17.929,75,75,619
2006,3327,23235,23674,390135,383768,1517,6.413,1479,6.252,47461,10091,37370,2.629,12.367,34716,9795,24921,2.552,9.046,12745,3.321,18.092,1173,1177,6753
2006,3328,5390,5941,136916,136473,324,5.419,399,6.674,15466,3761,11705,2.756,11.333,14686,4324,10362,3.168,10.761,780,0.572,21.522,305,309,2473
2006,3329,5594,6131,274721,270492,502,8.282,362,5.973,30181,8674,21507,3.207,11.158,21833,6725,15108,2.486,8.072,8348,3.086,16.143,246,246,3031
2006,3331,2503,2822,194919,188831,199,7.112,151,5.397,26328,4166,22162,2.206,13.943,13471,4129,9342,2.187,7.134,12857,6.809,14.268,104,105,941
2006,3332,3511,3708,133286,133722,206,5.502,278,7.425,12335,2656,9679,1.986,9.224,13109,4989,8120,3.731,9.803,-774,-0.579,18.449,186,187,1899
2006,3333,2050,2200,98363,98878,149,6.754,161,7.298,8329,2533,5796,2.562,8.424,9247,2846,6401,2.878,9.352,-918,-0.928,16.847,120,120,1208
2006,3334,1455,1755,152181,150860,113,6.430,118,6.714,14343,1683,12660,1.116,9.508,11808,4257,7551,2.822,7.827,2535,1.680,15.654,82,84,1456
2006,3335,7570,7863,173764,173477,333,4.191,499,6.280,16363,2675,13688,1.542,9.432,15684,5415,10269,3.121,9.041,679,0.391,18.082,396,396,3248
2006,3336,743,900,101646,100242,58,6.484,47,5.254,8002,960,7042,0.958,7.983,5030,1536,3494,1.532,5.018,2972,2.965,10.036,28,28,352
2006,3339,5426,6069,284602,283025,364,5.984,392,6.444,27510,5635,21875,1.991,9.720,24429,9491,14938,3.353,8.631,3081,1.089,17.263,264,264,2727
2006,3341,1118,1182,98177,95393,114,9.524,144,12.030,17217,7674,9543,8.045,18.048,10958,2616,8342,2.742,11.487,6259,6.561,22.974,108,110,1305
2006,3342,1531,1737,146158,143441,129,7.403,140,8.034,23186,3235,19951,2.255,16.164,18566,6032,12534,4.205,12.943,4620,3.221,25.887,97,98,1596
2006,3343,429,449,18667,19330,53,12.100,31,7.078,1652,446,1206,2.307,8.546,2996,712,2284,3.683,15.499,-1344,-6.953,17.093,28,28,185
2006,3344,4086,4618,366277,362835,290,6.269,306,6.615,39323,7455,31868,2.055,10.838,32074,9748,22326,2.687,8.840,7249,1.998,17.680,201,201,2934
2006,3345,4341,5042,388222,392103,381,7.610,310,6.192,35897,8658,27239,2.208,9.155,43551,9557,33994,2.437,11.107,-7654,-1.952,18.310,201,203,2428
2006,3346,703,749,32995,33779,66,8.753,76,10.080,2144,468,1676,1.385,6.347,3712,1112,2600,3.292,10.989,-1568,-4.642,12.694,52,52,807
2006,3351,1044,1133,57329,58218,67,5.852,91,7.948,4631,912,3719,1.567,7.955,6523,2014,4509,3.459,11.205,-1892,-3.250,15.909,62,62,805
2006,3352,275,328,74425,77577,34,10.272,40,12.085,2548,309,2239,0.398,3.284,9114,1463,7651,1.886,11.748,-6566,-8.464,6.569,30,30,361
2006,3353,1996,2331,139262,139198,115,4.927,121,5.184,11631,1473,10158,1.058,8.356,11330,3443,7887,2.473,8.139,301,0.216,16.279,70,70,780
2006,3359,1761,2109,149195,147595,151,7.170,145,6.885,15582,4869,10713,3.299,10.557,12300,4913,7387,3.329,8.334,3282,2.224,16.667,91,91,1332
2006,3361,264,335,205734,206775,25,7.257,44,12.772,21471,3084,18387,1.491,10.384,24179,6669,17510,3.225,11.693,-2708,-1.310,20.768,31,31,400
2006,3362,1796,2079,157820,153674,186,9.012,156,7.558,21610,4356,17254,2.835,14.062,13507,4538,8969,2.953,8.789,8103,5.273,17.579,118,118,2825
2006,3363,4328,5459,640934,654417,385,7.061,372,6.823,52638,15385,37253,2.351,8.043,78861,20290,58571,3.100,12.051,-26223,-4.007,16.087,246,260,7883
2006,3364,1200,1569,398241,390128,119,7.663,87,5.602,52621,7834,44787,2.008,13.488,36156,3693,32463,0.947,9.268,16465,4.220,18.535,64,65,1569
2006,3365,159,217,29699,29210,11,5.116,7,3.256,3051,187,2864,0.640,10.445,2094,286,1808,0.979,7.169,957,3.276,14.338,3,3,17
2006,3366,1514,1641,144791,144331,175,10.694,166,10.144,10771,1974,8797,1.368,7.463,9808,3068,6740,2.126,6.796,963,0.667,13.591,129,129,1242
2006,3369,844,876,45398,45416,129,15.123,83,9.730,5252,1812,3440,3.990,11.564,5509,1134,4375,2.497,12.130,-257,-0.566,23.129,66,66,901
2006,3371,14737,15169,355291,357461,1407,9.272,1418,9.345,38084,8903,29181,2.491,10.654,41934,16091,25843,4.501,11.731,-3850,-1.077,21.308,1116,1121,7466
2006,3372,3801,3985,145453,145453,264,6.612,279,6.988,16233,3574,12659,2.457,11.160,16098,4893,11205,3.364,11.068,135,0.093,22.135,207,208,2191
2006,3379,869,1002,46230,46590,56,5.504,87,8.550,5376,796,4580,1.709,11.539,5961,1935,4026,4.153,12.795,-585,-1.256,23.078,61,64,728
2006,3391,10707,11516,315058,310407,790,6.856,803,6.969,34129,6832,27297,2.201,10.995,24671,6172,18499,1.988,7.948,9458,3.047,15.896,607,610,4229
2006,3399,17300,17789,372366,372547,1756,9.909,1620,9.142,45649,13435,32214,3.606,12.253,46292,13552,32740,3.638,12.426,-643,-0.173,24.506,1298,1303,9040
2006,4231,17416,24329,376250,372871,2146,8.864,1906,7.873,51336,18795,32541,5.041,13.768,44855,15280,29575,4.098,12.030,6481,1.738,24.059,1286,1358,7681
2006,4232,11095,12856,165695,164210,1387,10.892,1144,8.983,23380,7221,16159,4.397,14.238,20487,6423,14064,3.911,12.476,2893,1.762,24.952,875,900,4672
2006,4233,12121,18369,276672,269241,1799,9.990,1076,5.975,44275,15328,28947,5.693,16.444,29501,7816,21685,2.903,10.957,14774,5.487,21.914,673,700,4560
2006,4234,25139,34421,726319,721550,3542,10.297,3495,10.161,106926,36692,70234,5.085,14.819,98169,34635,63534,4.800,13.605,8757,1.214,27.211,1962,2051,12561
2006,4235,7488,10319,157976,154514,756,7.405,536,5.250,20200,5418,14782,3.506,13.073,13272,3094,10178,2.002,8.590,6928,4.484,17.179,341,346,1610
2006,4236,19727,29096,471952,472613,2765,9.543,2519,8.694,68765,20362,48403,4.308,14.550,69511,29437,40074,6.229,14.708,-746,-0.158,29.100,1295,1393,9344
2006,4237,11032,18956,231206,224911,1883,10.127,1158,6.228,38016,17154,20862,7.627,16.903,24410,9528,14882,4.236,10.853,13606,6.050,21.706,544,606,3398
2006,4238,42351,58089,718218,704878,4060,7.018,3591,6.207,95083,29582,65501,4.197,13.489,68556,22824,45732,3.238,9.726,26527,3.763,19.452,2309,2400,12823
2006,4239,27843,30898,340620,336625,3426,11.130,3192,10.370,52302,18044,34258,5.360,15.537,44409,16233,28176,4.822,13.192,7893,2.345,26.385,2429,2463,11672
2006,4241,9008,11696,181910,192283,903,7.629,1185,10.011,22072,7501,14571,3.901,11.479,42398,12575,29823,6.540,22.050,-20326,-10.571,22.958,638,659,3985
2006,4242,5758,7640,258731,259590,931,12.278,816,10.762,41533,16871,24662,6.499,15.999,42151,16351,25800,6.299,16.238,-618,-0.238,31.999,565,571,7392
2006,4243,13617,14849,205621,208077,1847,12.500,1702,11.518,31228,11723,19505,5.634,15.008,36309,8751,27558,4.206,17.450,-5081,-2.442,30.016,1361,1378,6525
2006,4244,25364,31529,776918,771151,2873,9.106,2918,9.248,101402,26989,74413,3.500,13.149,91064,25165,65899,3.263,11.809,10338,1.341,23.618,2151,2175,14120
2006,4245,3945,6457,62169,62726,342,5.253,449,6.897,7861,2320,5541,3.699,12.532,8950,2670,6280,4.257,14.268,-1089,-1.736,25.065,257,283,1277
2006,4246,8325,12277,142589,143994,975,7.978,863,7.062,18046,5246,12800,3.643,12.532,20912,8494,12418,5.899,14.523,-2866,-1.990,25.065,524,532,2587
2006,4247,4938,7055,104871,105598,417,5.856,549,7.710,13075,3645,9430,3.452,12.382,14527,5036,9491,4.769,13.757,-1452,-1.375,24.764,287,297,1834
2006,4248,3135,3937,176399,173319,329,8.391,297,7.575,18974,5392,13582,3.111,10.947,12685,5877,6808,3.391,7.319,6289,3.629,14.638,221,223,3298
2006,4249,22732,28837,372137,375222,3123,10.848,3025,10.508,47347,17460,29887,4.653,12.618,53575,16803,36772,4.478,14.278,-6228,-1.660,25.237,2231,2262,9909
2006,4251,38741,40835,298212,298874,5663,13.986,4973,12.282,46448,16653,29795,5.572,15.541,48692,22379,26313,7.488,16.292,-2244,-0.751,31.082,3876,3901,15259
2006,4411,43724,48474,1284835,1286073,4796,9.925,4493,9.298,143406,58899,84507,4.580,11.151,145842,43621,102221,3.392,11.340,-2436,-0.189,22.301,3585,3627,32340
2006,4412,13757,15460,166813,164908,1720,11.265,1338,8.763,26204,9544,16660,5.787,15.890,22191,6763,15428,4.101,13.457,4013,2.433,26.913,1089,1100,4890
2006,4413,31098,56432,490455,491208,3897,6.928,3525,6.267,55584,21537,34047,4.384,11.316,56814,14229,42585,2.897,11.566,-1230,-0.250,22.632,2528,2645,9594
2006,4421,18826,26865,277189,275493,2892,10.772,2856,10.638,47370,20340,27030,7.383,17.195,44146,14737,29409,5.349,16.024,3224,1.170,32.049,2033,2213,10397
2006,4422,24974,34297,297096,297459,3469,10.114,3471,10.120,43031,18493,24538,6.217,14.466,44193,14389,29804,4.837,14.857,-1162,-0.391,28.932,2412,2474,8305
2006,4431,29049,49149,510952,509543,5286,10.660,6163,12.429,89090,28071,61019,5.509,17.484,85725,39208,46517,7.695,16.824,3365,0.660,33.648,4075,4217,19145
2006,4441,43821,65603,1214646,1161575,5491,8.485,3709,5.732,200375,109217,91158,9.402,17.250,96516,24148,72368,2.079,8.309,103859,8.941,16.618,2689,2760,13033
2006,4442,15240,18555,171120,170192,1485,8.017,1422,7.677,25251,8463,16788,4.973,14.837,23349,6790,16559,3.990,13.719,1902,1.118,27.438,1041,1054,4782
2006,4451,58268,84550,2595735,2609143,9132,10.784,9388,11.087,278417,110669,167748,4.242,10.671,306864,100282,206582,3.843,11.761,-28447,-1.090,21.342,6920,7022,41038
2006,4452,17092,20569,144602,144567,3291,16.006,3276,15.933,31656,15716,15940,10.871,21.897,31245,14161,17084,9.795,21.613,411,0.284,43.226,2336,2368,9030
2006,4453,24105,27596,141301,138672,3066,11.216,2548,9.321,26021,10969,15052,7.910,18.764,20730,8618,12112,6.215,14.949,5291,3.815,29.898,2005,2023,7081
2006,4461,40087,83114,1088597,1054334,8664,10.609,5775,7.071,183876,86395,97481,8.194,17.440,117296,34868,82428,3.307,11.125,66580,6.315,22.250,3342,3537,16281
2006,4471,63583,112750,919986,917763,10779,9.567,10607,9.415,160489,68998,91491,7.518,17.487,155804,59055,96749,6.435,16.977,4685,0.510,33.953,6704,7130,36843
2006,4481,35700,89258,1248057,1215078,10717,12.186,8093,9.202,216475,92005,124470,7.572,17.816,153493,44117,109376,3.631,12.632,62982,5.183,25.265,4302,5080,18912
2006,4482,6213,25587,202748,194270,1966,7.729,1667,6.553,50907,12889,38018,6.635,26.204,33059,8461,24598,4.355,17.017,17848,9.187,34.034,566,761,2732
2006,4483,17800,27660,167810,167472,2215,7.907,2923,10.434,27762,8235,19527,4.917,16.577,26287,9711,16576,5.799,15.696,1475,0.881,31.393,1617,1644,4338
2006,4511,27937,38166,432452,424511,4299,11.283,4172,10.949,77490,38933,38557,9.171,18.254,60491,22464,38027,5.292,14.250,16999,4.004,28.499,3139,3224,11613
2006,4512,5781,11515,146804,143240,992,8.564,1130,9.755,23190,10000,13190,6.981,16.190,15509,5332,10177,3.722,10.827,7681,5.362,21.655,816,838,3345
2006,4522,131,5418,735690,724754,308,5.782,125,2.347,61871,30334,31537,4.185,8.537,39958,6410,33548,0.884,5.513,21913,3.024,11.027,32,46,1013
2006,4523,8674,38655,2151464,2095662,3295,8.621,2430,6.358,223179,81442,141737,3.886,10.650,111952,15408,96544,0.735,5.342,111227,5.307,10.684,1515,1609,6966
2006,4531,17772,18638,97672,99797,1694,8.908,2451,12.889,15286,5333,9953,5.344,15.317,19271,7018,12253,7.032,19.310,-3985,-3.993,30.634,2067,2073,5914
2006,4532,26179,37392,314976,317530,4237,11.207,5065,13.397,48604,19889,28715,6.264,15.307,53673,19407,34266,6.112,16.903,-5069,-1.596,30.614,3813,3946,13576
2006,4533,11981,16385,133382,131161,1745,10.567,2001,12.118,22834,8809,14025,6.716,17.409,18260,6875,11385,5.242,13.922,4574,3.487,27.844,1587,1618,4570
2006,4539,31532,40310,260067,258861,4921,12.217,4859,12.063,49208,20777,28431,8.026,19.009,46858,17749,29109,6.857,18.102,2350,0.908,36.203,3676,3790,12403
2006,4541,15638,16616,285425,277271,2907,18.056,1874,11.640,55646,21420,34226,7.725,20.069,39008,14713,24295,5.306,14.069,16638,6.001,28.137,1493,1497,7377
2006,4542,4146,4715,51981,52605,455,9.492,612,12.767,5866,2209,3657,4.199,11.151,7149,2478,4671,4.711,13.590,-1283,-2.439,22.302,496,507,1936
2006,4543,20951,26341,210861,213489,2428,9.130,2932,11.025,28063,9394,18669,4.400,13.145,33228,13112,20116,6.142,15.564,-5165,-2.419,26.290,2079,2116,7961
2006,4811,505,2989,423246,429150,234,7.719,319,10.523,33167,8042,25125,1.874,7.729,46165,13442,32723,3.132,10.757,-12998,-3.029,15.457,53,54,1987
2006,4812,1990,2191,41908,40318,325,15.029,268,12.393,7649,2239,5410,5.553,18.972,4372,1080,3292,2.679,10.844,3277,8.128,21.688,206,206,746
2006,4831,772,1148,52704,50011,115,9.987,122,10.595,10270,2803,7467,5.605,20.535,4898,1121,3777,2.242,9.794,5372,10.742,19.588,54,55,361
2006,4832,470,523,19893,19327,65,12.500,59,11.346,2346,316,2030,1.635,12.138,1241,456,785,2.359,6.421,1105,5.717,12.842,42,42,381
2006,4841,47130,56613,1055101,1039467,10725,19.365,8268,14.928,159139,57829,101310,5.563,15.310,127606,48079,79527,4.625,12.276,31533,3.034,24.552,6239,6360,28013
2006,4842,42659,46542,474622,466331,6798,14.746,5916,12.833,88760,32479,56281,6.965,19.034,72298,24171,48127,5.183,15.504,16462,3.530,31.007,4626,4643,16911
2006,4851,582,888,51441,51593,109,12.337,100,11.319,8085,6089,1996,11.802,15.671,8513,2980,5533,5.776,16.500,-428,-0.830,31.341,52,53,645
2006,4852,197,527,17260,17271,74,14.411,47,9.153,2040,665,1375,3.850,11.812,2041,499,1542,2.889,11.817,-1,-0.006,23.623,19,20,133
2006,4853,5796,5887,67420,65827,992,16.751,1062,17.933,13689,5597,8092,8.503,20.795,10395,5543,4852,8.421,15.791,3294,5.004,31.583,851,887,4080
2006,4854,2929,4132,192310,188291,287,6.949,283,6.852,23818,9123,14695,4.845,12.650,15748,5418,10330,2.877,8.364,8070,4.286,16.727,190,190,2855
2006,4855,1068,1171,28436,28126,145,12.425,137,11.740,4258,1367,2891,4.860,15.139,3676,1193,2483,4.242,13.070,582,2.069,26.140,114,115,986
2006,4859,2687,2950,60934,59599,485,16.724,385,13.276,12942,6615,6327,11.099,21.715,10344,4998,5346,8.386,17.356,2598,4.359,34.712,319,322,4131
2006,4861,45,329,5766,5916,50,13.755,119,32.737,1239,695,544,11.748,20.943,1482,1086,396,18.357,25.051,-243,-4.108,41.886,3,3,306
2006,4862,127,1520,22850,23310,247,15.946,305,19.690,4901,3103,1798,13.312,21.026,6011,4460,1551,19.134,25.788,-1110,-4.762,42.052,12,12,46
2006,4869,59,675,7126,7240,89,13.414,66,9.947,964,522,442,7.210,13.315,1178,385,793,5.318,16.271,-214,-2.956,26.630,D,D,D
2006,4871,469,524,8827,8823,70,13.487,60,11.561,1420,352,1068,3.990,16.094,1343,249,1094,2.822,15.222,77,0.873,30.443,42,42,195
2006,4872,1214,1248,11378,11230,238,19.373,199,16.199,2081,698,1383,6.215,18.531,1784,605,1179,5.387,15.886,297,2.645,31.772,138,140,371
2006,4879,137,145,2314,2280,21,14.789,15,10.563,414,188,226,8.246,18.158,356,122,234,5.351,15.614,58,2.544,31.228,10,10,46
2006,4881,3542,4898,157115,151715,640,13.238,513,10.611,31019,10638,20381,7.012,20.446,20235,5813,14422,3.832,13.338,10784,7.108,26.675,271,279,2309
2006,4882,479,962,28015,27078,113,11.939,82,8.663,5024,1847,3177,6.821,18.554,3143,1266,1877,4.675,11.607,1881,6.947,23.215,32,39,727
2006,4883,1644,2138,92324,90927,189,8.859,180,8.437,13120,2332,10788,2.565,14.429,10551,2689,7862,2.957,11.604,2569,2.825,23.208,101,101,842
2006,4884,7730,8265,68065,67593,1253,15.332,1068,13.068,13459,6364,7095,9.415,19.912,12652,4331,8321,6.408,18.718,807,1.194,37.436,831,847,3085
2006,4885,12501,17968,212176,201399,2635,15.165,1450,8.345,49084,26448,22636,13.132,24.372,26545,11558,14987,5.739,13.180,22539,11.191,26.361,860,911,5712
2006,4889,1167,1272,28132,28183,221,17.723,171,13.713,3122,864,2258,3.066,11.078,3135,1249,1886,4.432,11.124,-13,-0.046,22.155,129,131,922
2006,4921,2907,8080,527744,515076,951,11.781,935,11.583,54418,9928,44490,1.927,10.565,29359,12125,17234,2.354,5.700,25059,4.865,11.400,356,372,2288
2006,4922,3984,4495,44119,45084,607,13.463,634,14.062,8021,2946,5075,6.535,17.791,9983,4860,5123,10.780,22.143,-1962,-4.352,35.583,528,533,3881
2006,4931,6805,13431,629454,619168,1364,10.234,1157,8.681,116046,52570,63476,8.490,18.742,96560,26411,70149,4.266,15.595,19486,3.147,31.190,392,415,5248
2006,5111,15111,21482,693259,695946,2270,10.661,1891,8.881,67297,25002,42295,3.593,9.670,72436,21091,51345,3.031,10.408,-5139,-0.738,19.340,1240,1257,9046
2006,5112,5783,8347,344829,337437,967,11.583,970,11.619,58346,19248,39098,5.704,17.291,44503,20737,23766,6.145,13.189,13843,4.102,26.377,492,519,7037
2006,5121,12548,16020,313580,305324,2579,16.387,2016,12.809,62810,25054,37756,8.206,20.572,46147,16080,30067,5.267,15.114,16663,5.457,30.228,1219,1230,5450
2006,5122,2678,2906,22462,22385,498,17.304,442,15.358,5046,2301,2745,10.279,22.542,4771,2532,2239,11.311,21.313,275,1.229,42.627,293,301,828
2006,5151,4340,9493,257736,251838,1158,12.543,637,6.900,41377,16992,24385,6.747,16.430,29279,7422,21857,2.947,11.626,12098,4.804,23.252,328,341,2876
2006,5152,339,612,42027,40854,123,20.483,100,16.653,7900,2214,5686,5.419,19.337,5595,2756,2839,6.746,13.695,2305,5.642,27.391,36,39,395
2006,5173,5571,43692,1152287,1180065,5926,13.548,6023,13.770,171498,77642,93856,6.579,14.533,231519,66101,165418,5.601,19.619,-60021,-5.086,29.066,794,983,13902
2006,5174,486,602,11537,11472,110,18.739,80,13.629,1533,388,1145,3.382,13.364,1425,401,1024,3.496,12.422,108,0.941,24.844,54,54,294
2006,5179,4706,5305,76988,76822,1003,18.524,1222,22.569,17436,5486,11950,7.141,22.697,17131,7390,9741,9.620,22.300,305,0.397,44.599,852,869,4363
2006,5182,7407,15362,405569,396306,2703,18.416,1334,9.089,73417,26909,46508,6.790,18.525,55655,17134,38521,4.323,14.043,17762,4.482,28.087,712,727,6465
2006,5191,5120,6417,118707,111515,1148,18.633,636,10.323,26695,8529,18166,7.648,23.939,12401,4983,7418,4.468,11.121,14294,12.818,22.241,418,423,1885
2006,5211,21,55,19859,19971,5,9.346,D,D,1155,43,1112,0.215,5.784,1386,D,1373,D,6.940,-231,-1.157,11.567,D,D,D
2006,5221,15790,118862,2132156,2092155,13888,11.966,8292,7.144,375608,167885,207723,8.025,17.953,300291,117493,182798,5.616,14.353,75317,3.600,28.706,504,614,6724
2006,5222,18882,52239,795357,791410,9267,18.047,7487,14.581,203329,96533,106796,12.198,25.692,195964,94035,101929,11.882,24.761,7365,0.931,49.523,2065,2183,10946
2006,5223,26440,43364,343792,336699,8373,20.152,4744,11.418,85795,35611,50184,10.577,25.481,71271,28912,42359,8.587,21.168,14524,4.314,42.335,2984,3057,14142
2006,5231,12414,38435,508046,494736,6738,18.180,3994,10.776,94223,54030,40193,10.921,19.045,65865,26280,39585,5.312,13.313,28358,5.732,26.626,1102,1125,5166
2006,5232,43,124,7336,7135,82,92.135,12,13.483,852,578,274,8.101,11.942,433,42,391,0.589,6.069,419,5.873,12.138,10,10,37
2006,5239,33733,38333,388676,370166,7329,19.702,5061,13.605,94181,42312,51869,11.431,25.443,56705,26741,29964,7.224,15.319,37476,10.124,30.638,3400,3424,11608
2006,5241,6349,32979,1435620,1423148,3651,11.200,2892,8.871,170960,67638,103322,4.753,12.013,144344,42803,101541,3.008,10.143,26616,1.870,20.285,505,515,2936
2006,5242,120458,135334,941231,929905,14561,10.895,11186,8.370,153609,65371,88238,7.030,16.519,129697,51200,78497,5.506,13.947,23912,2.571,27.895,7718,7828,24977
2006,5259,632,663,6440,6300,145,20.700,220,31.406,1729,1101,628,17.476,27.444,1429,919,510,14.587,22.683,300,4.762,45.365,181,182,699
2006,5311,84874,104835,552399,546925,12935,12.362,12533,11.978,104712,52590,52122,9.616,19.146,94202,46939,47263,8.582,17.224,10510,1.922,34.448,9241,9350,31360
2006,5312,78919,88321,370136,356004,19061,22.616,10978,13.026,88442,44757,43685,12.572,24.843,59841,26840,33001,7.539,16.809,28601,8.034,33.618,7716,7778,18084
2006,5313,61491,70970,630693,616996,12544,18.315,7584,11.073,123748,58034,65714,9.406,20.057,96002,34682,61320,5.621,15.560,27746,4.497,31.119,5277,5303,21484
2006,5321,4093,12289,171541,171395,1568,12.935,1234,10.180,23975,6350,17625,3.705,13.988,23424,10451,12973,6.098,13.667,551,0.321,27.333,481,505,2771
2006,5322,11338,32191,254153,260259,3049,9.484,2966,9.226,38181,15024,23157,5.773,14.670,50316,14372,35944,5.522,19.333,-12135,-4.663,29.341,1644,1832,7261
2006,5323,3118,5009,34367,33307,537,10.791,472,9.485,7310,2971,4339,8.920,21.948,5058,2014,3044,6.047,15.186,2252,6.761,30.372,257,286,1211
2006,5324,7499,12650,157701,153055,1577,12.718,1077,8.685,29579,9899,19680,6.468,19.326,20042,7177,12865,4.689,13.095,9537,6.231,26.189,666,683,3272
2006,5331,1910,1987,29077,28533,268,13.639,224,11.399,5107,2159,2948,7.567,17.899,4178,1298,2880,4.549,14.643,929,3.256,29.285,165,166,804
2006,5411,163969,173413,1218631,1210492,16039,9.304,13978,8.109,147835,51754,96081,4.275,12.213,130636,41613,89023,3.438,10.792,17199,1.421,21.584,10398,10525,31137
2006,5412,93870,108981,1287308,1251239,13279,12.325,10800,10.024,277364,100951,176413,8.068,22.167,206770,63784,142986,5.098,16.525,70594,5.642,33.050,6838,6867,34100
2006,5413,88739,102431,1381834,1333506,12611,12.550,8714,8.672,248033,73653,174380,5.523,18.600,151334,49014,102320,3.676,11.349,96699,7.251,22.697,5726,5792,23759
2006,5414,27579,27847,127106,123382,4688,17.161,3629,13.285,27603,10714,16889,8.684,22.372,20010,9837,10173,7.973,16.218,7593,6.154,32.436,2683,2690,6837
2006,5415,81309,94170,1225619,1182757,20860,22.966,14178,15.610,283552,102266,181286,8.646,23.974,197492,84826,112666,7.172,16.698,86060,7.276,33.395,9493,9618,42420
2006,5416,97943,104004,871202,842272,22971,22.922,15389,15.356,207309,88855,118454,10.549,24.613,149710,71505,78205,8.490,17.775,57599,6.839,35.549,10814,10870,40975
2006,5417,11322,14810,652587,650425,2047,14.050,1566,10.748,92063,25363,66700,3.899,14.154,88001,23773,64228,3.655,13.530,4062,0.625,27.060,909,921,5657
2006,5418,31658,35024,453361,434034,4626,13.355,3857,11.135,96671,26369,70302,6.075,22.273,57525,22025,35500,5.074,13.254,39146,9.019,26.507,2764,2775,14286
2006,5419,53067,61595,567951,559134,7095,11.633,5889,9.655,99235,33038,66197,5.909,17.748,82443,28448,53995,5.088,14.745,16792,3.003,29.490,4115,4145,17069
2006,5511,26249,49228,2917518,2917628,5477,11.258,4318,8.876,483322,149498,333824,5.124,16.566,486133,125251,360882,4.293,16.662,-2811,-0.096,33.131,1091,1125,13906
2006,5611,21202,23808,453192,444349,4427,19.228,2858,12.413,93521,38384,55137,8.638,21.047,76304,31356,44948,7.057,17.172,17217,3.875,34.344,2103,2117,21805
2006,5612,1668,5094,192886,181491,1450,31.763,392,8.587,47863,28206,19657,15.541,26.372,25878,9210,16668,5.075,14.259,21985,12.114,28.517,107,110,1461
2006,5613,27504,46442,4774467,4534510,7761,17.149,5390,11.910,1274031,337257,936774,7.438,28.096,797097,239950,557147,5.292,17.578,476934,10.518,35.157,2895,2977,129177
2006,5614,27153,33632,805815,790033,4761,14.322,3981,11.976,166131,59658,106473,7.551,21.028,134851,55959,78892,7.083,17.069,31280,3.959,34.138,2848,2926,20632
2006,5615,15757,21582,257678,255255,2183,10.088,2298,10.619,38980,14504,24476,5.682,15.271,34165,11247,22918,4.406,13.385,4815,1.886,26.769,1477,1507,6537
2006,5616,17265,22365,786706,771758,3349,15.275,2467,11.253,162402,71460,90942,9.259,21.043,133584,38186,95398,4.948,17.309,28818,3.734,34.618,1642,1667,16396
2006,5617,134666,141151,1706128,1666822,24914,18.055,18587,13.470,359532,121274,238258,7.276,21.570,281414,101861,179553,6.111,16.883,78118,4.687,33.767,13546,13580,60720
2006,5619,17012,19218,350085,349916,2257,11.765,2188,11.406,63517,16546,46971,4.729,18.152,62730,20491,42239,5.856,17.927,787,0.225,35.854,1558,1592,9387
2006,5621,6871,8601,178814,176320,905,10.670,667,7.864,21554,7627,13927,4.326,12.224,16424,6515,9909,3.695,9.315,5130,2.909,18.630,470,477,3280
2006,5622,1461,2610,56865,56814,244,9.434,197,7.616,8465,3250,5215,5.720,14.899,8401,3005,5396,5.289,14.787,64,0.113,29.574,125,128,1758
2006,5629,6922,7670,112991,111179,1009,13.461,660,8.805,25165,9225,15940,8.297,22.635,21333,5834,15499,5.247,19.188,3832,3.447,38.376,455,465,3398
2006,6111,17368,19739,801960,791936,1225,6.262,874,4.468,77538,23130,54408,2.921,9.791,57604,12502,45102,1.579,7.274,19934,2.517,14.548,632,648,9816
2006,6112,460,856,85919,84505,72,8.602,34,4.062,10049,2357,7692,2.789,11.892,7337,810,6527,0.959,8.682,2712,3.209,17.365,22,22,569
2006,6113,2227,3639,1538433,1526129,364,10.301,153,4.330,97128,11151,85977,0.731,6.364,71966,3409,68557,0.223,4.716,25162,1.649,9.431,88,88,2314
2006,6114,5958,6497,65429,63149,890,13.728,862,13.296,14910,5209,9701,8.249,23.611,10404,4497,5907,7.121,16.475,4506,7.136,32.951,611,635,3040
2006,6115,6027,7379,119599,113041,988,13.675,680,9.412,26803,10901,15902,9.643,23.711,13731,4477,9254,3.961,12.147,13072,11.564,24.294,495,507,2814
2006,6116,28931,31148,293790,282652,4950,16.280,3465,11.396,66388,24465,41923,8.656,23.488,44365,15110,29255,5.346,15.696,22023,7.792,31.392,2614,2641,11583
2006,6117,5007,5688,75038,70261,1198,22.081,673,12.404,19321,6790,12531,9.664,27.499,9584,2524,7060,3.592,13.641,9737,13.858,27.281,509,509,1774
2006,6211,175582,201761,2115282,2072227,17493,8.752,13729,6.869,304104,111996,192108,5.405,14.675,216707,68543,148164,3.308,10.458,87397,4.218,20.915,9855,10083,44148
2006,6212,113180,118707,816425,802086,7033,5.973,5099,4.331,113763,36607,77156,4.564,14.183,85222,23571,61651,2.939,10.625,28541,3.558,21.250,4088,4120,17977
2006,6213,97880,108269,588362,571429,12668,11.902,8999,8.455,116129,47467,68662,8.307,20.323,81815,29377,52438,5.141,14.318,34314,6.005,28.635,6283,6395,19270
2006,6214,13119,27060,671628,657971,3074,11.697,1513,5.757,100163,40287,59876,6.123,15.223,72384,21300,51084,3.237,11.001,27779,4.222,22.002,712,771,7835
2006,6215,7001,11287,223332,221285,1518,13.676,1143,10.298,36133,14492,21641,6.549,16.329,31748,13575,18173,6.135,14.347,4385,1.982,28.694,650,681,4738
2006,6216,13351,19782,970981,940739,3424,18.054,1791,9.443,177362,61002,116360,6.484,18.853,117139,36203,80936,3.848,12.452,60223,6.402,24.904,1208,1242,18406
2006,6219,5511,8441,252436,249878,839,10.039,672,8.041,39726,11986,27740,4.797,15.898,34566,11511,23055,4.607,13.833,5160,2.065,27.666,380,416,5209
2006,6221,3136,5132,4923069,4887404,99,1.927,108,2.103,201218,25813,175405,0.528,4.117,130225,32435,97790,0.664,2.665,70993,1.453,5.329,52,52,13333
2006,6222,450,601,215615,215132,28,4.663,27,4.496,7069,1944,5125,0.904,3.286,6067,3030,3037,1.408,2.820,1002,0.466,5.640,16,16,2243
2006,6223,383,803,213647,209618,143,18.644,71,9.257,28331,16825,11506,8.027,13.516,19747,8811,10936,4.203,9.420,8584,4.095,18.841,34,34,2233
2006,6231,8398,16043,1618246,1614123,1033,6.444,1010,6.300,151417,63073,88344,3.908,9.381,143339,62655,80684,3.882,8.880,8078,0.500,17.761,513,546,29289
2006,6232,8102,31248,566430,557970,2731,8.889,1685,5.484,80605,31129,49476,5.579,14.446,63442,16940,46502,3.036,11.370,17163,3.076,22.740,372,446,6143
2006,6233,13701,18386,651364,639527,2174,12.023,1565,8.655,85508,39547,45961,6.184,13.371,61440,21236,40204,3.321,9.607,24068,3.763,19.214,1145,1168,15624
2006,6239,3612,6266,156868,156163,563,9.078,434,6.998,21393,7210,14183,4.617,13.699,20186,5437,14749,3.482,12.926,1207,0.773,25.852,198,208,2590
2006,6241,38211,53528,1090846,1063719,5831,11.117,3679,7.014,175550,58667,116883,5.515,16.503,121899,29709,92190,2.793,11.460,53651,5.044,22.919,2197,2262,15154
2006,6242,9483,13032,161157,159489,1028,8.020,599,4.673,20040,5964,14076,3.739,12.565,16518,3425,13093,2.147,10.357,3522,2.208,20.714,332,338,1546
2006,6243,4789,8077,338333,335865,682,8.529,521,6.515,50551,14028,36523,4.177,15.051,45087,8130,36957,2.421,13.424,5464,1.627,26.848,248,261,2630
2006,6244,53334,69121,851952,826021,9603,14.155,7041,10.379,159948,78586,81362,9.514,19.364,106292,40086,66206,4.853,12.868,53656,6.496,25.736,5397,5499,30718
2006,7111,7399,7552,132240,132249,952,12.632,921,12.221,21372,6088,15284,4.603,16.160,21449,5772,15677,4.365,16.219,-77,-0.058,32.321,598,599,4278
2006,7112,3390,3561,122814,119921,601,17.103,507,14.428,20252,4944,15308,4.123,16.888,14435,3029,11406,2.526,12.037,5817,4.851,24.074,373,374,2025
2006,7113,4763,5106,110456,107894,766,15.392,507,10.188,20779,5134,15645,4.758,19.259,15430,4425,11005,4.101,14.301,5349,4.958,28.602,370,371,3188
2006,7114,2628,2682,15593,15259,402,15.006,396,14.782,3224,1397,1827,9.155,21.129,2567,1414,1153,9.267,16.823,657,4.306,33.646,283,283,912
2006,7115,12981,12999,46733,44571,2992,23.725,2216,17.572,15332,7647,7685,17.157,34.399,11037,4806,6231,10.783,24.763,4295,9.636,49.525,1414,1414,3110
2006,7121,5994,6471,123099,122266,524,8.175,401,6.256,11774,2241,9533,1.833,9.630,10073,1300,8773,1.063,8.239,1701,1.391,16.477,238,239,617
2006,7131,1910,2453,142762,144587,488,20.291,392,16.299,13525,5054,8471,3.495,9.354,17013,5885,11128,4.070,11.767,-3488,-2.412,18.709,260,266,2867
2006,7132,1749,2305,191069,189951,285,12.586,204,9.009,22069,7939,14130,4.180,11.618,19642,5686,13956,2.993,10.341,2427,1.278,20.681,155,158,4035
2006,7139,50775,56469,1096764,1081728,7629,13.659,6401,11.460,175132,67826,107306,6.270,16.190,145384,48428,96956,4.477,13.440,29748,2.750,26.880,5073,5108,37360
2006,7211,37498,47407,1827726,1812812,5624,11.924,5137,10.892,263223,119339,143884,6.583,14.520,234406,100843,133563,5.563,12.931,28817,1.590,25.861,3606,3676,54179
2006,7212,5145,5615,38390,38151,681,12.238,580,10.423,6855,2184,4671,5.725,17.968,6344,2159,4185,5.659,16.629,511,1.339,33.258,358,360,1206
2006,7213,2087,2157,11960,12108,136,6.213,200,9.137,1599,436,1163,3.601,13.206,1888,635,1253,5.244,15.593,-289,-2.387,26.412,143,143,506
2006,7223,11436,29609,557572,559750,3408,11.576,3072,10.434,101792,34762,67030,6.210,18.185,105500,34540,70960,6.171,18.848,-3708,-0.662,36.371,1521,1537,9976
2006,7224,41522,42123,361168,356690,5410,12.764,5935,14.002,80950,42619,38331,11.948,22.695,71377,32014,39363,8.975,20.011,9573,2.684,40.022,4966,4971,27274
2006,7225,310682,426187,8623440,8456126,59974,14.316,45465,10.853,1596246,851197,745049,10.066,18.877,1262857,455102,807755,5.382,14.934,333389,3.943,29.868,36029,36946,333660
2006,8111,139048,152301,884108,880729,15430,10.116,15903,10.426,152949,63209,89740,7.177,17.366,146426,55659,90767,6.320,16.626,6523,0.741,33.251,12192,12488,43308
2006,8112,10815,12270,127674,129036,1373,11.122,1522,12.329,20318,7436,12882,5.763,15.746,22932,8151,14781,6.317,17.772,-2614,-2.026,31.492,1157,1185,4311
2006,8113,20919,22379,193308,187250,2276,10.201,2143,9.604,35444,10463,24981,5.588,18.929,23259,8056,15203,4.302,12.421,12185,6.507,24.843,1590,1599,5412
2006,8114,19375,20483,96083,99554,2389,11.537,2837,13.701,16560,6360,10200,6.388,16.634,23633,11325,12308,11.376,23.739,-7073,-7.105,33.268,2145,2160,5240
2006,8121,83066,98146,619041,605862,14677,15.135,12328,12.713,124393,66818,57575,11.029,20.532,98545,42996,55549,7.097,16.265,25848,4.266,32.531,10054,10368,36821
2006,8122,14743,20199,135915,136351,972,4.783,1222,6.013,13338,3734,9604,2.739,9.782,14345,4645,9700,3.407,10.521,-1007,-0.739,19.564,592,605,1930
2006,8123,31501,37890,358325,363713,4013,10.491,4735,12.379,47363,18428,28935,5.067,13.022,57339,24321,33018,6.687,15.765,-9976,-2.743,26.044,3546,3628,14513
2006,8129,20420,30806,230097,226667,4606,14.914,4760,15.413,48174,21354,26820,9.421,21.253,41235,20265,20970,8.940,18.192,6939,3.061,36.384,2671,2708,10481
2006,8131,165024,165433,1629054,1621407,8661,5.211,10238,6.159,166041,25899,140142,1.597,10.241,150600,26630,123970,1.642,9.288,15441,0.952,18.576,5831,5831,16003
2006,8132,13631,15621,157192,155383,1286,8.302,1025,6.617,18398,4282,14116,2.756,11.840,14873,4314,10559,2.776,9.572,3525,2.269,19.144,633,667,2563
2006,8133,11700,13776,123604,122303,1306,9.578,1025,7.517,18195,4823,13372,3.943,14.877,15608,3491,12117,2.854,12.762,2587,2.115,25.523,576,578,1685
2006,8134,26414,28604,321600,320744,1531,5.238,2784,9.524,35776,7269,28507,2.266,11.154,34194,7943,26251,2.476,10.661,1582,0.493,21.322,2076,2076,5437
2006,8139,58683,60820,542239,535530,3458,5.654,4147,6.780,72022,14389,57633,2.687,13.449,58596,14234,44362,2.658,10.942,13426,2.507,21.883,2865,2873,9294
2007,1131,334,378,2585,2656,50,13.369,42,11.230,279,111,168,4.179,10.505,413,143,270,5.384,15.550,-134,-5.045,21.009,23,23,93
2007,1132,149,206,2143,2085,31,15.578,17,8.543,447,127,320,6.093,21.444,324,135,189,6.476,15.543,123,5.901,31.087,9,9,48
2007,1133,8666,8742,59181,60429,872,9.825,1138,12.823,9195,3544,5651,5.865,15.216,11584,3874,7710,6.411,19.170,-2389,-3.953,30.432,879,880,3117
2007,1141,1202,1211,5267,5383,250,20.921,218,18.243,1057,521,536,9.680,19.638,1304,582,722,10.813,24.227,-247,-4.589,39.275,138,138,270
2007,1142,261,261,1817,1840,29,10.943,37,13.962,180,60,120,3.262,9.785,229,99,130,5.382,12.449,-49,-2.664,19.571,26,26,57
2007,1151,3432,3763,63544,63380,434,11.512,448,11.883,11889,4535,7354,7.155,18.758,11433,3906,7527,6.163,18.039,456,0.719,36.078,283,284,2637
2007,1152,3636,3701,19853,19561,524,14.305,448,12.230,3661,1471,2190,7.520,18.716,3048,1346,1702,6.881,15.582,613,3.134,31.164,357,358,1027
2007,1153,1308,1386,13855,13747,191,13.911,165,12.017,2829,800,2029,5.820,20.580,2606,801,1805,5.827,18.958,223,1.622,37.915,107,107,545
2007,2111,5818,6964,142194,115357,876,12.785,652,9.515,66849,12233,54616,10.605,57.950,13236,7797,5439,6.759,11.474,53613,46.476,22.948,355,357,2006
2007,2121,625,1013,78791,77698,123,12.041,140,13.705,12559,2544,10015,3.274,16.164,10176,3533,6643,4.547,13.097,2383,3.067,26.194,69,72,1818
2007,2122,209,274,35386,31668,54,20.729,27,10.365,8723,1930,6793,6.095,27.546,1210,265,945,0.837,3.821,7513,23.725,7.642,11,11,46
2007,2123,3223,5312,102275,99009,426,8.025,419,7.893,21582,6967,14615,7.037,21.798,15406,3041,12365,3.071,15.560,6176,6.238,31.120,206,206,1410
2007,2131,8823,10620,348844,302000,1903,18.867,836,8.288,126107,36135,89972,11.965,41.757,32025,14792,17233,4.898,10.604,94082,31.153,21.209,519,531,5694
2007,2211,1559,9453,519674,511532,640,6.790,585,6.207,55014,12951,42063,2.532,10.755,39214,9676,29538,1.892,7.666,15800,3.089,15.332,69,76,865
2007,2212,418,2350,84049,83857,102,4.215,242,10.000,8157,1754,6403,2.092,9.727,7666,3048,4618,3.635,9.142,491,0.586,18.284,25,25,220
2007,2213,3546,4398,41543,40370,289,6.611,236,5.399,6699,2185,4514,5.412,16.594,4229,1129,3100,2.797,10.476,2470,6.118,20.951,146,151,526
2007,2361,161742,163110,906878,937414,29224,17.932,28938,17.757,199329,87741,111588,9.360,21.264,261232,98215,163017,10.477,27.867,-61903,-6.604,42.527,21835,21838,67285
2007,2362,40464,41663,734848,725561,4775,11.612,3693,8.981,136065,30718,105347,4.234,18.753,117714,25107,92607,3.460,16.224,18351,2.529,32.448,2733,2738,16962
2007,2371,18416,19442,545627,525379,1672,8.582,1752,8.993,119817,18620,101197,3.544,22.806,79716,19749,59967,3.759,15.173,40101,7.633,30.346,1160,1168,11558
2007,2372,10268,10348,73542,73061,1524,14.720,1534,14.817,17173,7452,9721,10.200,23.505,16051,5952,10099,8.147,21.969,1122,1.536,43.939,1246,1247,4728
2007,2373,9859,10621,324166,322492,760,7.126,848,7.951,50313,8356,41957,2.591,15.601,46914,9336,37578,2.895,14.547,3399,1.054,29.095,548,549,5077
2007,2379,4031,4145,69854,71091,587,14.175,579,13.982,14422,3773,10649,5.307,20.287,17137,5124,12013,7.208,24.106,-2715,-3.819,40.574,368,370,1989
2007,2381,98082,98853,1113173,1147790,13104,13.180,14251,14.333,221755,63203,158552,5.506,19.320,291970,70663,221307,6.156,25.438,-70215,-6.117,38.640,10591,10594,54826
2007,2382,165716,169397,1992051,1989234,18814,11.220,15380,9.172,347101,78841,268260,3.963,17.449,341586,78293,263293,3.936,17.172,5515,0.277,34.343,11684,11704,53701
2007,2383,114152,115292,941185,957422,17761,15.476,16707,14.558,197846,61923,135923,6.468,20.664,230776,61470,169306,6.420,24.104,-32930,-3.439,41.329,12643,12650,46896
2007,2389,63896,64594,615683,614527,10129,15.912,8255,12.968,121172,39113,82059,6.365,19.718,119114,32747,86367,5.329,19.383,2058,0.335,38.766,6023,6025,24533
2007,3111,1136,1708,46089,46861,88,5.133,101,5.891,4935,1502,3433,3.205,10.531,6384,1905,4479,4.065,13.623,-1449,-3.092,21.062,55,57,710
2007,3112,430,757,55501,54735,24,3.160,29,3.818,4536,1030,3506,1.882,8.287,3032,572,2460,1.045,5.539,1504,2.748,11.079,17,17,195
2007,3113,1512,1721,72209,72400,137,7.924,153,8.849,8300,868,7432,1.199,11.464,8639,3358,5281,4.638,11.932,-339,-0.468,22.928,112,112,1169
2007,3114,1201,1565,160639,160587,90,5.702,117,7.412,16303,2911,13392,1.813,10.152,16159,4875,11284,3.036,10.062,144,0.090,20.125,66,67,1520
2007,3115,992,1509,131860,132300,91,6.023,95,6.287,11440,2368,9072,1.790,8.647,12098,2839,9259,2.146,9.144,-658,-0.497,17.294,59,61,1178
2007,3116,2936,3555,490032,496341,204,5.703,248,6.933,33427,8101,25326,1.632,6.735,46418,11290,35128,2.275,9.352,-12991,-2.617,13.469,180,181,2371
2007,3117,516,610,32590,33685,46,7.535,47,7.699,3045,634,2411,1.882,9.040,5199,1107,4092,3.286,15.434,-2154,-6.395,18.080,29,29,354
2007,3118,9011,9781,290228,294030,792,8.003,1022,10.327,36280,10100,26180,3.435,12.339,43547,16419,27128,5.584,14.810,-7267,-2.472,24.678,765,776,6030
2007,3119,2647,3087,162932,161645,299,9.782,238,7.787,18398,4886,13512,3.023,11.382,15696,5453,10243,3.373,9.710,2702,1.672,19.420,174,179,2370
2007,3121,2788,3355,135249,134275,392,11.977,228,6.966,14278,3406,10872,2.537,10.633,12617,3252,9365,2.422,9.396,1661,1.237,18.793,149,149,1784
2007,3122,71,102,20107,20603,6,5.607,16,14.953,1226,791,435,3.839,5.951,2377,1195,1182,5.800,11.537,-1151,-5.587,11.901,8,8,47
2007,3131,281,406,42639,45177,23,5.496,48,11.470,2282,371,1911,0.821,5.051,7251,2739,4512,6.063,16.050,-4969,-10.999,10.103,24,25,819
2007,3132,1051,1204,76643,83581,60,4.792,156,12.460,6011,1736,4275,2.077,7.192,19950,10887,9063,13.026,23.869,-13939,-16.677,14.384,102,103,2707
2007,3133,1128,1190,44714,48113,75,6.090,158,12.830,3372,1354,2018,2.814,7.009,10135,4323,5812,8.985,21.065,-6763,-14.056,14.017,116,116,1784
2007,3141,2257,2393,75695,77735,148,6.045,259,10.578,6681,2115,4566,2.721,8.595,10812,2309,8503,2.970,13.909,-4131,-5.314,17.189,212,212,1197
2007,3149,3781,3894,70713,72625,283,7.091,477,11.952,7665,2161,5504,2.976,10.554,11655,4541,7114,6.253,16.048,-3990,-5.494,21.109,379,385,3283
2007,3151,364,394,22331,24031,30,7.194,76,18.225,2066,553,1513,2.301,8.597,5457,2285,3172,9.509,22.709,-3391,-14.111,17.195,54,55,814
2007,3152,6501,6619,138517,143592,991,14.557,1368,20.095,24024,10660,13364,7.424,16.731,33972,18308,15664,12.750,23.659,-9948,-6.928,33.462,1215,1218,14213
2007,3159,681,698,13286,13792,52,7.298,81,11.368,1168,254,914,1.842,8.469,2210,871,1339,6.315,16.024,-1042,-7.555,16.937,64,64,608
2007,3161,219,224,4863,5310,25,11.086,28,12.417,425,238,187,4.483,8.005,1323,643,680,12.110,24.918,-898,-16.913,16.009,21,21,195
2007,3162,214,237,13003,13585,13,5.372,23,9.504,662,42,620,0.309,4.873,1759,487,1272,3.585,12.948,-1097,-8.075,9.746,17,17,98
2007,3169,756,766,15974,16266,68,8.831,76,9.870,1773,392,1381,2.410,10.900,2384,848,1536,5.213,14.657,-611,-3.756,21.801,61,61,539
2007,3211,3462,3888,109677,112977,256,6.507,348,8.846,8693,3050,5643,2.700,7.694,15207,5076,10131,4.493,13.460,-6514,-5.766,15.389,252,254,2378
2007,3212,1489,1890,109109,116298,107,5.645,118,6.225,7031,2183,4848,1.877,6.046,21438,4210,17228,3.620,18.434,-14407,-12.388,12.091,74,74,1107
2007,3219,9393,10436,318183,334287,910,8.719,913,8.747,28657,9987,18670,2.988,8.573,61116,16327,44789,4.884,18.283,-32459,-9.710,17.145,671,701,10734
2007,3221,231,476,125784,130155,8,1.594,60,11.952,3053,380,2673,0.292,2.346,11794,4764,7030,3.660,9.062,-8741,-6.716,4.691,22,22,571
2007,3222,2967,4395,294195,297736,160,3.604,248,5.587,21610,5328,16282,1.790,7.258,28356,9964,18392,3.347,9.524,-6746,-2.266,14.516,116,119,2572
2007,3231,30490,32115,646571,655298,1919,5.895,2795,8.586,60905,19197,41708,2.930,9.294,78354,29447,48907,4.494,11.957,-17449,-2.663,18.588,2213,2225,14925
2007,3241,1054,2229,101386,100495,160,7.162,170,7.610,9419,2562,6857,2.549,9.373,7854,1822,6032,1.813,7.815,1565,1.557,15.631,51,59,684
2007,3251,1362,2475,158483,158858,196,8.031,127,5.204,10686,2744,7942,1.727,6.727,11200,2741,8459,1.725,7.050,-514,-0.324,13.454,50,52,574
2007,3252,957,1291,99855,100697,56,4.318,68,5.243,6898,1722,5176,1.710,6.850,8615,2663,5952,2.645,8.555,-1717,-1.705,13.701,32,32,808
2007,3253,624,861,29209,29337,52,5.906,91,10.335,3375,880,2495,3.000,11.504,3671,1427,2244,4.864,12.513,-296,-1.009,23.008,51,51,387
2007,3254,1441,1912,243980,245507,147,7.729,127,6.677,28043,7030,21013,2.863,11.423,32019,6151,25868,2.505,13.042,-3976,-1.620,22.845,69,70,2284
2007,3255,1487,1892,65482,65943,113,5.968,116,6.126,6715,1966,4749,2.981,10.183,7634,2259,5375,3.426,11.577,-919,-1.394,20.366,66,66,704
2007,3256,1923,2139,106938,107171,135,6.249,178,8.239,10475,3419,7056,3.190,9.774,10922,3542,7380,3.305,10.191,-447,-0.417,19.548,113,114,1667
2007,3259,2072,2650,100960,105260,205,7.773,180,6.825,9526,2241,7285,2.129,9.050,17812,2512,15300,2.386,16.922,-8286,-7.872,18.100,115,116,1142
2007,3261,9263,11728,700880,716467,585,4.942,802,6.776,57815,10946,46869,1.528,8.069,89267,26107,63160,3.644,12.459,-31452,-4.390,16.139,498,506,10032
2007,3262,1654,2142,149325,153851,83,3.826,138,6.361,8403,1324,7079,0.861,5.462,17609,4796,12813,3.117,11.445,-9206,-5.984,10.924,85,86,1512
2007,3271,1184,1384,50714,51419,97,6.894,143,10.163,5023,911,4112,1.772,9.769,6368,1943,4425,3.779,12.385,-1345,-2.616,19.538,111,111,767
2007,3272,1653,1964,98623,100451,118,5.958,151,7.624,6480,581,5899,0.578,6.451,10089,2449,7640,2.438,10.044,-3609,-3.593,12.902,104,104,549
2007,3273,4879,9784,226606,229482,534,5.443,588,5.993,28048,8093,19955,3.527,12.222,33992,8345,25647,3.636,14.812,-5944,-2.590,24.445,290,307,4386
2007,3274,198,331,17282,17723,19,5.706,23,6.907,920,377,543,2.127,5.191,1853,77,1776,0.434,10.455,-933,-5.264,10.382,18,18,55
2007,3279,2889,3328,83318,83191,308,9.347,242,7.344,9570,2402,7168,2.887,11.504,9337,2404,6933,2.890,11.224,233,0.280,22.447,169,169,1319
2007,3311,319,439,104102,105608,39,8.884,39,8.884,4942,407,4535,0.385,4.680,8212,3338,4874,3.161,7.776,-3270,-3.096,9.359,34,34,2754
2007,3312,453,598,46318,47496,21,3.454,41,6.743,3313,396,2917,0.834,6.975,5696,1797,3899,3.784,11.993,-2383,-5.017,13.951,22,23,381
2007,3313,412,557,62496,62866,37,6.661,34,6.121,4152,1134,3018,1.804,6.605,4896,1208,3688,1.922,7.788,-744,-1.183,13.209,23,23,493
2007,3314,752,964,64621,64723,40,4.113,57,5.861,4855,645,4210,0.997,7.501,5011,1491,3520,2.304,7.742,-156,-0.241,15.003,36,36,232
2007,3315,1832,2072,158935,162794,96,4.573,151,7.192,11496,2616,8880,1.607,7.062,19406,5630,13776,3.458,11.921,-7910,-4.859,14.123,108,109,2260
2007,3321,2451,2698,127103,128316,94,3.454,141,5.181,9795,1610,8185,1.255,7.634,12237,3409,8828,2.657,9.537,-2442,-1.903,15.267,88,88,1422
2007,3322,1323,1436,50698,52273,83,5.756,95,6.588,3507,1098,2409,2.101,6.709,6568,1938,4630,3.707,12.565,-3061,-5.856,13.418,63,63,520
2007,3323,12613,13615,413572,413044,919,6.761,875,6.437,50268,11124,39144,2.693,12.170,49341,12710,36631,3.077,11.946,927,0.224,23.891,658,658,7935
2007,3324,1218,1497,93980,90835,70,4.671,73,4.872,12968,1774,11194,1.953,14.277,6520,2267,4253,2.496,7.178,6448,7.099,14.356,41,41,533
2007,3325,669,745,40792,41988,45,6.032,47,6.300,2227,418,1809,0.996,5.304,4695,804,3891,1.915,11.182,-2468,-5.878,10.608,28,28,374
2007,3326,1360,1531,50052,50929,68,4.413,88,5.711,4163,1019,3144,2.001,8.174,5904,1284,4620,2.521,11.593,-1741,-3.418,16.348,58,58,449
2007,3327,23646,24102,398029,395346,1537,6.378,1530,6.349,45682,10531,35151,2.664,11.555,40215,11639,28576,2.944,10.172,5467,1.383,20.344,1155,1158,7450
2007,3328,5437,5982,138700,139031,308,5.124,367,6.105,15761,3036,12725,2.184,11.336,16383,5593,10790,4.023,11.784,-622,-0.447,22.673,267,267,2346
2007,3329,5901,6437,280388,280979,566,8.887,430,6.751,28556,6921,21635,2.463,10.163,30063,8390,21673,2.986,10.699,-1507,-0.536,20.326,310,310,3842
2007,3331,2545,2875,203357,198691,196,6.848,170,5.940,21851,4182,17669,2.105,10.998,12503,4261,8242,2.145,6.293,9348,4.705,12.585,121,121,2183
2007,3332,3577,3768,135070,135753,213,5.630,243,6.423,11906,2785,9121,2.052,8.770,13210,4920,8290,3.624,9.731,-1304,-0.961,17.541,175,177,2772
2007,3333,1957,2099,89108,89814,133,6.278,172,8.119,8378,1565,6813,1.742,9.328,9818,4418,5400,4.919,10.932,-1440,-1.603,18.656,115,116,2174
2007,3334,1472,1776,150423,150713,98,5.512,102,5.737,15746,1979,13767,1.313,10.448,16377,2386,13991,1.583,10.866,-631,-0.419,20.895,70,70,1345
2007,3335,7340,7588,166670,169624,300,3.900,508,6.604,13923,3190,10733,1.881,8.208,19894,6251,13643,3.685,11.728,-5971,-3.520,16.416,379,381,3751
2007,3336,792,965,103696,102484,44,4.588,32,3.337,8983,1069,7914,1.043,8.765,6470,409,6061,0.399,6.313,2513,2.452,12.626,22,22,163
2007,3339,5576,6218,296814,293979,335,5.385,342,5.497,28123,4255,23868,1.447,9.566,22412,6084,16328,2.070,7.624,5711,1.943,15.247,223,223,1904
2007,3341,1108,1167,98333,96468,103,8.755,122,10.370,11384,726,10658,0.753,11.801,8041,1977,6064,2.049,8.335,3343,3.465,16.671,87,87,662
2007,3342,1494,1696,149003,149548,130,7.565,175,10.183,15282,2684,12598,1.795,10.219,16294,5038,11256,3.369,10.895,-1012,-0.677,20.438,111,113,1804
2007,3343,445,460,16406,17024,64,14.254,42,9.354,1628,796,832,4.676,9.563,2827,721,2106,4.235,16.606,-1199,-7.043,19.126,29,29,198
2007,3344,4076,4601,367886,367036,283,6.110,344,7.427,37502,7255,30247,1.977,10.218,36092,12317,23775,3.356,9.833,1410,0.384,19.667,221,225,4324
2007,3345,4382,5104,398469,397349,294,5.727,354,6.895,36634,7116,29518,1.791,9.220,34474,14299,20175,3.599,8.676,2160,0.544,17.352,199,199,2064
2007,3346,703,741,27262,29718,71,9.404,99,13.113,1812,613,1199,2.063,6.097,6532,3787,2745,12.743,21.980,-4720,-15.883,12.195,71,71,1171
2007,3351,1059,1148,56991,57039,76,6.620,76,6.620,4271,731,3540,1.282,7.488,4545,859,3686,1.506,7.968,-274,-0.480,14.976,54,54,568
2007,3352,265,317,66152,69989,29,9.048,36,11.232,4578,364,4214,0.520,6.541,12323,7139,5184,10.200,17.607,-7745,-11.066,13.082,25,25,2379
2007,3353,1992,2311,138666,138799,93,3.982,142,6.080,12198,1553,10645,1.119,8.788,12647,4556,8091,3.282,9.112,-449,-0.323,17.576,78,78,689
2007,3359,1846,2209,154525,155424,116,5.216,146,6.565,12355,1403,10952,0.903,7.949,14206,5438,8768,3.499,9.140,-1851,-1.191,15.898,82,82,1278
2007,3361,269,333,193820,198885,34,10.241,32,9.639,12365,232,12133,0.117,6.217,23556,6715,16841,3.376,11.844,-11191,-5.627,12.434,18,18,110
2007,3362,1839,2122,152485,156214,158,7.446,158,7.446,13779,2953,10826,1.890,8.821,21102,4882,16220,3.125,13.508,-7323,-4.688,17.641,116,117,2641
2007,3363,4438,5526,603823,623523,326,5.848,423,7.588,52935,13161,39774,2.111,8.490,92543,26175,66368,4.198,14.842,-39608,-6.352,16.979,232,236,6266
2007,3364,1240,1626,411888,405205,122,7.559,98,6.072,36762,11903,24859,2.938,9.072,23697,4381,19316,1.081,5.848,13065,3.224,11.696,65,65,1585
2007,3365,168,230,29481,29903,14,6.074,15,6.508,2473,419,2054,1.401,8.270,3335,188,3147,0.629,11.153,-862,-2.883,16.540,10,10,112
2007,3366,1522,1655,153393,151458,160,9.601,183,10.981,16210,2563,13647,1.692,10.703,12303,3528,8775,2.329,8.123,3907,2.580,16.246,137,137,1133
2007,3369,864,896,46538,45349,125,14.172,97,10.998,6607,2092,4515,4.613,14.569,4397,1571,2826,3.464,9.696,2210,4.873,19.392,79,79,454
2007,3371,14492,14945,330581,340665,1310,8.724,1451,9.663,31658,8255,23403,2.423,9.293,51920,14664,37256,4.305,15.241,-20262,-5.948,18.586,1133,1135,7911
2007,3372,3998,4175,140275,141918,262,6.240,310,7.383,14474,3308,11166,2.331,10.199,17643,4769,12874,3.360,12.432,-3169,-2.233,20.398,235,236,2413
2007,3379,864,997,43593,45203,70,6.986,80,7.984,3975,1399,2576,3.095,8.794,7208,2038,5170,4.509,15.946,-3233,-7.152,17.587,62,63,1316
2007,3391,10707,11516,311014,308433,761,6.577,871,7.527,33875,6140,27735,1.991,10.983,28573,9768,18805,3.167,9.264,5302,1.719,18.528,642,644,3449
2007,3399,17334,17808,348217,350364,2024,11.495,1623,9.218,41712,13775,27937,3.932,11.905,46110,16043,30067,4.579,13.161,-4398,-1.255,23.811,1269,1277,9594
2007,4231,18019,25222,386860,391514,2071,8.207,2095,8.302,47362,14316,33046,3.657,12.097,56652,17443,39209,4.455,14.470,-9290,-2.373,24.194,1267,1328,7593
2007,4232,11466,13285,171964,173823,1272,9.588,1236,9.316,23853,6715,17138,3.863,13.723,27508,8501,19007,4.891,15.825,-3655,-2.103,27.445,861,884,5117
2007,4233,11539,18434,275075,279812,1815,9.962,1385,7.602,39344,14881,24463,5.318,14.061,48743,13117,35626,4.688,17.420,-9399,-3.359,28.122,799,818,6267
2007,4234,24035,33243,740623,737634,2999,8.956,3485,10.407,121726,35245,86481,4.778,16.502,114932,41185,73747,5.583,15.581,6794,0.921,31.162,1996,2062,11937
2007,4235,7783,10678,164950,163048,709,6.655,660,6.195,22858,5679,17179,3.483,14.019,19034,5913,13121,3.627,11.674,3824,2.345,23.348,329,337,1968
2007,4236,19799,29127,491755,494210,2499,8.557,2654,9.088,72789,21219,51570,4.294,14.728,78014,32419,45595,6.560,15.786,-5225,-1.057,29.457,1177,1250,8627
2007,4237,10952,19865,245208,245169,1491,7.599,1002,5.107,31702,8694,23008,3.546,12.931,31848,8063,23785,3.289,12.990,-146,-0.060,25.861,567,592,3605
2007,4238,41983,57490,724190,718988,3865,6.718,3953,6.871,100054,27947,72107,3.887,13.916,89670,30890,58780,4.296,12.472,10384,1.444,24.943,2162,2239,13681
2007,4239,27753,30601,337841,335566,3315,10.877,3068,10.066,55278,18069,37209,5.385,16.473,50464,17364,33100,5.175,15.038,4814,1.435,30.077,2314,2327,10652
2007,4241,8779,11412,176517,180755,669,5.755,1095,9.419,17894,4469,13425,2.472,9.900,26294,10335,15959,5.718,14.547,-8400,-4.647,19.799,541,604,3923
2007,4242,5576,7820,260451,264235,845,10.859,768,9.870,42755,13121,29634,4.966,16.181,50190,19756,30434,7.477,18.994,-7435,-2.814,32.361,480,481,2940
2007,4243,14013,15299,218840,217664,1860,12.238,1659,10.916,36885,13193,23692,6.061,16.946,34776,11310,23466,5.196,15.977,2109,0.969,31.954,1263,1279,6476
2007,4244,24967,31140,779134,781296,3050,9.780,3139,10.066,99745,34439,65306,4.408,12.767,104010,35905,68105,4.596,13.312,-4265,-0.546,25.533,2065,2097,14589
2007,4245,3719,6287,60333,60931,304,4.781,447,7.030,8698,1900,6798,3.118,14.275,9990,2729,7261,4.479,16.396,-1292,-2.120,28.551,208,215,1340
2007,4246,8551,12751,153574,152463,976,7.646,1003,7.858,22675,6194,16481,4.063,14.872,20696,6268,14428,4.111,13.574,1979,1.298,27.149,480,496,2643
2007,4247,5124,7410,105574,108468,515,6.914,592,7.948,16287,3949,12338,3.641,15.015,22218,6055,16163,5.582,20.483,-5931,-5.468,30.031,275,299,2394
2007,4248,3070,3887,177270,176810,319,8.221,306,7.886,19083,4515,14568,2.554,10.793,18056,5767,12289,3.262,10.212,1027,0.581,20.424,182,187,2600
2007,4249,21854,28051,364186,366078,2788,9.885,3092,10.963,53465,16952,36513,4.631,14.605,57454,21596,35858,5.899,15.694,-3989,-1.090,29.210,2079,2110,10701
2007,4251,37256,39329,277897,282841,4985,12.546,5795,14.584,50500,22065,28435,7.801,17.855,61587,29140,32447,10.303,21.774,-11087,-3.920,35.709,4297,4327,14696
2007,4411,42837,47503,1263944,1271230,4436,9.277,5060,10.582,146243,50087,96156,3.940,11.504,160683,69022,91661,5.430,12.640,-14440,-1.136,23.008,3878,3917,50839
2007,4412,13940,15704,170818,170229,1500,9.554,1493,9.509,25089,8722,16367,5.124,14.738,23832,8389,15443,4.928,14.000,1257,0.738,28.000,1106,1132,6143
2007,4413,30006,56076,483577,481947,3825,6.828,3714,6.630,63968,21460,42508,4.453,13.273,61741,17542,44199,3.640,12.811,2227,0.462,25.621,2430,2524,10552
2007,4421,18103,26988,267481,271535,3444,12.834,3136,11.687,46815,24047,22768,8.856,17.241,54737,19000,35737,6.997,20.158,-7922,-2.917,34.482,2084,2347,13547
2007,4422,24567,34036,317792,305009,3538,10.381,3631,10.654,71409,25140,46269,8.242,23.412,47182,16508,30674,5.412,15.469,24227,7.943,30.938,2277,2513,8963
2007,4431,27715,50646,500686,500943,8656,17.469,6464,13.045,97763,51466,46297,10.274,19.516,96179,39566,56613,7.898,19.200,1584,0.316,38.399,3848,4118,20927
2007,4441,44477,67677,1196124,1200535,5485,8.181,4224,6.300,126862,62495,64367,5.206,10.567,136868,28639,108229,2.386,11.401,-10006,-0.833,21.134,2755,2887,15463
2007,4442,15190,18441,163824,164977,1380,7.464,1477,7.988,24513,6976,17537,4.228,14.858,26693,6839,19854,4.145,16.180,-2180,-1.321,29.717,1007,1018,4579
2007,4451,55967,82144,2544839,2559812,9264,11.280,9229,11.238,287040,114321,172719,4.466,11.213,318954,104027,214927,4.064,12.460,-31914,-1.247,22.427,6610,6692,40181
2007,4452,16889,20380,136854,136383,3541,17.561,3110,15.423,33340,16561,16779,12.143,24.446,32497,14806,17691,10.856,23.828,843,0.618,47.656,2330,2339,10643
2007,4453,24693,28180,141004,140417,3005,10.734,2633,9.406,24890,9504,15386,6.768,17.726,23830,8472,15358,6.033,16.971,1060,0.755,33.942,1910,1936,6268
2007,4461,40055,84070,1021198,1046184,8100,9.718,6662,7.993,150046,60251,89795,5.759,14.342,198512,47446,151066,4.535,18.975,-48466,-4.633,28.684,3269,3378,15538
2007,4471,62225,110666,898950,910431,10065,9.048,11201,10.070,151975,65033,86942,7.143,16.693,175837,64317,111520,7.064,19.314,-23862,-2.621,33.385,6603,7054,35552
2007,4481,35475,91764,1270001,1257326,11371,12.574,8704,9.625,262697,102784,159913,8.175,20.893,232644,55279,177365,4.397,18.503,30053,2.390,37.006,4350,4567,18422
2007,4482,6251,26968,209428,207396,2546,9.626,1510,5.709,39888,15678,24210,7.559,19.233,36071,7943,28128,3.830,17.392,3817,1.840,34.785,605,701,2385
2007,4483,17580,27052,160897,163542,2225,8.150,2722,9.971,26012,8733,17279,5.340,15.905,31083,11623,19460,7.107,19.006,-5071,-3.101,31.811,1482,1528,4346
2007,4511,27479,37900,438576,433328,4443,11.751,4264,11.277,81475,37382,44093,8.627,18.802,70775,22505,48270,5.194,16.333,10700,2.469,32.666,2930,3032,11568
2007,4512,5338,10751,148184,147285,791,7.165,1370,12.409,23113,5420,17693,3.680,15.693,21172,7492,13680,5.087,14.375,1941,1.318,28.750,679,789,3272
2007,4522,40,5243,714180,722269,279,5.277,367,6.942,61692,21709,39983,3.006,8.541,78523,28445,50078,3.938,10.872,-16831,-2.330,17.083,41,41,268
2007,4523,7840,39176,2169454,2159302,3387,8.749,2460,6.355,194878,66308,128570,3.071,9.025,174672,14652,160020,0.679,8.089,20206,0.936,16.179,1486,1516,5389
2007,4531,17329,18089,92993,95378,1667,9.054,2314,12.568,15274,5348,9926,5.607,16.014,20132,7286,12846,7.639,21.108,-4858,-5.093,32.028,1860,1889,5531
2007,4532,25562,36748,306451,309505,4255,11.492,4808,12.986,53333,21521,31812,6.953,17.232,58741,23004,35737,7.433,18.979,-5408,-1.747,34.463,3380,3507,12502
2007,4533,11941,16508,133364,133107,1674,10.090,1838,11.079,21918,8464,13454,6.359,16.466,21238,6443,14795,4.840,15.956,680,0.511,31.911,1423,1451,4491
2007,4539,30605,38732,255167,254028,4851,12.374,5791,14.772,52036,21528,30508,8.475,20.484,48236,20225,28011,7.962,18.988,3800,1.496,37.977,3597,3681,12092
2007,4541,17881,19052,342631,335290,3000,16.214,1901,10.274,63047,22802,40245,6.801,18.804,48698,16270,32428,4.853,14.524,14349,4.280,29.048,1464,1474,8488
2007,4542,4134,4649,48688,50187,477,10.147,581,12.359,6449,1625,4824,3.238,12.850,9235,4398,4837,8.763,18.401,-2786,-5.551,25.700,427,437,2156
2007,4543,23345,29339,214552,215978,3059,10.525,2511,8.639,32075,12654,19421,5.859,14.851,34976,10114,24862,4.683,16.194,-2901,-1.343,29.702,1710,1726,5968
2007,4811,517,3004,439255,434407,328,11.012,277,9.300,62084,11023,51061,2.537,14.292,52430,18745,33685,4.315,12.069,9654,2.222,24.139,35,35,268
2007,4812,2022,2236,40294,40315,327,14.790,277,12.528,5074,1192,3882,2.957,12.586,5117,1932,3185,4.792,12.693,-43,-0.107,25.172,199,202,1185
2007,4831,707,1026,55014,54437,98,9.432,124,11.935,8459,1958,6501,3.597,15.539,6893,2209,4684,4.058,12.662,1566,2.877,25.325,66,67,900
2007,4832,464,512,19537,19425,75,14.677,73,14.286,2679,1032,1647,5.313,13.792,2438,1038,1400,5.344,12.551,241,1.241,25.102,36,36,478
2007,4841,48545,57447,978990,983987,9773,17.154,8822,15.485,149508,41304,108204,4.198,15.194,160662,59236,101426,6.020,16.328,-11154,-1.134,30.388,6667,6754,28350
2007,4842,41850,46358,495252,491637,6660,14.432,6241,13.524,93038,33523,59515,6.819,18.924,86327,27977,58350,5.691,17.559,6711,1.365,35.118,4729,4744,19849
2007,4851,569,880,49979,50118,72,8.136,82,9.266,5104,1830,3274,3.651,10.184,5306,2240,3066,4.469,10.587,-202,-0.403,20.368,51,51,963
2007,4852,178,518,17997,16946,79,15.310,75,14.535,4989,2307,2682,13.614,29.441,2795,1207,1588,7.123,16.494,2194,12.947,32.987,19,19,307
2007,4853,6015,6110,71814,70062,1035,17.183,862,14.311,13909,5225,8684,7.458,19.853,10497,3807,6690,5.434,14.983,3412,4.870,29.965,701,701,3286
2007,4854,2887,4402,209529,202359,587,13.783,301,7.067,35814,17487,18327,8.642,17.698,20680,8815,11865,4.356,10.219,15134,7.479,20.439,171,172,2369
2007,4855,1114,1226,30999,30797,107,8.671,123,9.968,4672,1235,3437,4.010,15.171,4315,1164,3151,3.780,14.011,357,1.159,28.023,86,87,618
2007,4859,2637,2890,60034,59833,396,13.688,402,13.896,9753,3047,6706,5.093,16.301,9476,4122,5354,6.889,15.838,277,0.463,31.675,315,321,3048
2007,4861,43,396,6418,6356,81,22.222,18,4.938,1351,306,1045,4.814,21.256,1236,480,756,7.552,19.446,115,1.809,38.892,D,D,D
2007,4862,118,1488,22973,22113,159,10.932,92,6.325,3952,1144,2808,5.174,17.872,2216,764,1452,3.455,10.021,1736,7.851,20.043,7,7,67
2007,4869,52,602,6271,6348,33,5.323,69,11.129,1009,397,612,6.254,15.896,1217,741,476,11.674,19.173,-208,-3.277,31.792,5,21,219
2007,4871,468,516,9057,8730,80,15.671,69,13.516,1963,660,1303,7.560,22.486,1333,628,705,7.194,15.269,630,7.216,30.538,50,50,290
2007,4872,1198,1236,10945,11028,225,18.526,182,14.986,2074,851,1223,7.717,18.808,2229,632,1597,5.731,20.213,-155,-1.406,37.615,139,139,522
2007,4879,125,133,2135,2179,20,15.038,20,15.038,233,79,154,3.626,10.695,318,67,251,3.076,14.597,-85,-3.902,21.391,14,14,30
2007,4881,3704,5183,171195,169058,684,13.271,626,12.146,27904,10251,17653,6.064,16.506,23419,8224,15195,4.865,13.853,4485,2.653,27.705,293,293,2023
2007,4882,456,987,28524,28479,127,13.026,103,10.564,4619,1269,3350,4.456,16.219,4461,2266,2195,7.957,15.664,158,0.555,31.329,39,40,501
2007,4883,1698,2232,85760,84707,194,8.764,157,7.093,11023,2149,8874,2.537,13.013,8987,1896,7091,2.238,10.610,2036,2.404,21.219,98,98,662
2007,4884,8187,8801,74499,72701,1316,15.198,1032,11.918,15067,6709,8358,9.228,20.725,11558,4582,6976,6.303,15.898,3509,4.827,31.796,783,787,3205
2007,4885,13772,20188,242501,234161,2802,14.260,1725,8.779,53860,27079,26781,11.564,23.001,37174,13791,23383,5.890,15.875,16686,7.126,31.751,855,868,4340
2007,4889,1180,1274,16457,16238,229,18.335,179,14.331,3134,1079,2055,6.645,19.300,2719,1023,1696,6.300,16.745,415,2.556,33.489,133,136,698
2007,4921,2988,8148,525158,524966,989,12.261,826,10.240,46937,20323,26614,3.871,8.941,46998,12591,34407,2.398,8.953,-61,-0.012,17.882,330,337,2001
2007,4922,3528,3797,36241,37767,548,13.951,810,20.621,7178,3047,4131,8.068,19.006,10270,5740,4530,15.198,27.193,-3092,-8.187,38.012,487,501,2097
2007,4931,6721,13612,731729,723652,1183,8.656,1293,9.461,116569,35619,80950,4.922,16.108,99722,31002,68720,4.284,13.780,16847,2.328,27.561,345,363,3638
2007,5111,14796,21065,683018,685869,1906,8.989,2182,10.291,79436,21248,58188,3.098,11.582,85943,25820,60123,3.765,12.531,-6507,-0.949,23.164,1229,1251,9577
2007,5112,5441,7776,380087,381197,760,9.479,1243,15.504,54505,13715,40790,3.598,14.298,57212,21402,35810,5.614,15.009,-2707,-0.710,28.597,433,466,7708
2007,5121,12586,15974,319264,317916,2387,15.059,2140,13.501,54720,15229,39491,4.790,17.212,52601,20114,32487,6.327,16.546,2119,0.667,33.091,1354,1372,13131
2007,5122,2882,3051,24379,24430,497,16.400,456,15.047,4087,1521,2566,6.226,16.729,4128,1694,2434,6.934,16.897,-41,-0.168,33.459,301,302,840
2007,5151,4218,9152,250809,254603,934,9.996,1317,14.095,34062,13603,20459,5.343,13.378,42969,12172,30797,4.781,16.877,-8907,-3.498,26.757,301,311,3308
2007,5152,416,683,42812,43231,88,12.951,81,11.921,7330,2124,5206,4.913,16.956,8233,1576,6657,3.646,19.044,-903,-2.089,33.911,28,28,200
2007,5173,4723,44268,1173150,1163000,6808,15.539,5897,13.460,221106,110195,110911,9.475,19.012,197922,103651,94271,8.912,17.018,23184,1.993,34.036,724,832,5530
2007,5174,556,653,9189,9182,160,26.381,67,11.047,3197,869,2328,9.465,34.820,3077,791,2286,8.615,33.513,120,1.307,67.026,39,39,322
2007,5179,4286,4744,64011,66288,925,18.972,1188,24.367,14845,4800,10045,7.241,22.395,19181,7928,11253,11.960,28.936,-4336,-6.541,44.790,858,888,4913
2007,5182,8098,14576,409865,413221,1876,12.288,3259,21.346,91895,31022,60873,7.507,22.239,98603,40675,57928,9.843,23.862,-6708,-1.623,44.477,644,665,6271
2007,5191,5201,6505,122036,119083,1005,15.862,667,10.527,20983,5704,15279,4.790,17.621,15137,4218,10919,3.542,12.711,5846,4.909,25.423,459,461,2256
2007,5211,13,48,19519,19743,D,D,6,12.000,820,D,801,D,4.153,1218,75,1143,0.380,6.169,-398,-2.016,8.307,5,5,43
2007,5221,15261,124398,2135496,2141692,12138,9.944,7475,6.124,289991,114566,175425,5.349,13.540,301308,104899,196409,4.898,14.069,-11317,-0.528,27.081,515,625,15095
2007,5222,17397,50917,781350,790135,8596,16.785,9185,17.935,183883,80136,103747,10.142,23.272,201217,85679,115538,10.844,25.466,-17334,-2.194,46.545,2627,3084,21658
2007,5223,26986,46168,349163,352124,8610,19.138,6253,13.899,89762,38818,50944,11.024,25.492,95046,37823,57223,10.741,26.992,-5284,-1.501,50.983,3919,4144,20158
2007,5231,12036,37852,498799,504244,6037,15.883,6349,16.704,106987,38468,68519,7.629,21.217,119630,52187,67443,10.350,23.725,-12643,-2.507,42.435,1055,1109,4437
2007,5232,21,48,8043,7738,8,9.877,74,91.358,1831,415,1416,5.363,23.662,1134,733,401,9.473,14.655,697,9.007,29.310,10,10,544
2007,5239,37031,41575,416242,409996,7015,17.211,5382,13.205,79903,34222,45681,8.347,19.489,67549,27418,40131,6.687,16.476,12354,3.013,32.951,3319,3333,11683
2007,5241,5854,32354,1451789,1453945,4253,13.065,4650,14.285,199825,77300,122525,5.317,13.744,203566,73834,129732,5.078,14.001,-3741,-0.257,27.487,575,582,3351
2007,5242,121888,137385,930718,938520,14015,10.278,11970,8.778,156088,61351,94737,6.537,16.631,172260,69811,102449,7.438,18.354,-16172,-1.723,33.263,7777,7912,28192
2007,5259,443,457,6886,6155,149,32.009,166,35.661,2849,2007,842,32.608,46.288,1459,735,724,11.942,23.704,1390,22.583,47.409,140,141,616
2007,5311,85016,106448,539570,546342,13909,13.142,12688,11.988,105405,51832,53573,9.487,19.293,120039,50301,69738,9.207,21.971,-14634,-2.679,38.586,8209,8297,29334
2007,5312,77476,87433,355462,361071,16120,18.474,15771,18.074,84053,43089,40964,11.934,23.279,95873,39078,56795,10.823,26.552,-11820,-3.274,46.558,11306,11406,25281
2007,5313,63573,73901,642070,637516,10994,15.098,8825,12.120,117116,48444,68672,7.599,18.371,107856,42525,65331,6.670,16.918,9260,1.453,33.836,5991,6044,24472
2007,5321,4095,12175,184904,178218,1390,11.324,1590,12.953,42646,8178,34468,4.589,23.929,29462,12921,16541,7.250,16.531,13184,7.398,33.063,483,512,2372
2007,5322,10738,31370,244234,249215,2161,6.775,3213,10.073,31984,10557,21427,4.236,12.834,41917,16089,25828,6.456,16.820,-9933,-3.986,25.668,1441,1581,6496
2007,5323,2920,4502,29391,29924,321,7.044,431,9.458,4267,1330,2937,4.445,14.259,5347,1936,3411,6.470,17.869,-1080,-3.609,28.519,212,219,986
2007,5324,7359,13015,162225,159124,1519,11.831,1168,9.097,28876,8612,20264,5.412,18.147,22991,8408,14583,5.284,14.448,5885,3.698,28.897,627,636,4155
2007,5331,1928,2023,29736,29144,294,14.656,260,12.961,7428,3797,3631,13.029,25.488,6388,2493,3895,8.554,21.919,1040,3.569,43.838,178,178,799
2007,5411,164528,173909,1195402,1204670,15342,8.834,14861,8.557,142206,48599,93607,4.034,11.805,161413,50298,111115,4.175,13.399,-19207,-1.594,23.609,10676,10746,30831
2007,5412,95007,109747,1263857,1277699,10905,9.980,9957,9.112,212134,66538,145596,5.208,16.603,237312,78183,159129,6.119,18.573,-25178,-1.971,33.206,6271,6313,45410
2007,5413,89530,103360,1412294,1392571,11147,10.875,9426,9.196,221991,66680,155311,4.788,15.941,182880,61151,121729,4.391,13.133,39111,2.809,26.265,6008,6099,25216
2007,5414,27315,27558,122576,122043,4336,15.923,3681,13.518,23884,9866,14018,8.084,19.570,22800,9658,13142,7.914,18.682,1084,0.888,37.364,2692,2698,6952
2007,5415,84105,98031,1259916,1217130,18750,19.559,14418,15.040,308070,103964,204106,8.542,25.311,225980,88639,137341,7.283,18.567,82090,6.745,37.133,9561,9627,38834
2007,5416,100539,105951,789006,784127,21411,20.619,17192,16.556,178049,74197,103852,9.462,22.707,168423,79939,88484,10.195,21.479,9626,1.228,42.958,12009,12072,45285
2007,5417,10970,14300,664172,667207,2012,14.201,1749,12.344,100346,18838,81508,2.823,15.040,107808,35481,72327,5.318,16.158,-7462,-1.118,30.079,950,966,9284
2007,5418,32135,35474,453472,459194,4546,12.905,4049,11.495,84613,29840,54773,6.498,18.426,97650,31063,66587,6.765,21.266,-13037,-2.839,36.853,2756,2786,12526
2007,5419,53765,63170,577965,570845,7580,12.183,5674,9.120,100154,35206,64948,6.167,17.545,86593,28150,58443,4.931,15.169,13561,2.376,30.339,4001,4023,16687
2007,5511,26438,50097,2855677,2834537,5872,11.765,5501,11.022,572430,179093,393337,6.318,20.195,525464,203021,322443,7.162,18.538,46966,1.657,37.076,870,904,11324
2007,5611,23039,24910,390861,393287,4301,17.672,3158,12.975,82360,36783,45577,9.353,20.941,87075,43247,43828,10.996,22.140,-4715,-1.199,41.883,2284,2304,22395
2007,5612,1693,5688,270646,248316,713,12.940,357,6.479,72580,16415,56165,6.611,29.229,28177,9130,19047,3.677,11.347,44403,17.882,22.695,107,108,1112
2007,5613,27769,47841,4894099,4871484,7224,15.335,5758,12.223,1058153,307645,750508,6.315,21.721,1019895,255601,764294,5.247,20.936,38258,0.785,41.872,2765,2921,154044
2007,5614,26647,33263,799500,812650,4090,12.256,4306,12.903,137097,47153,89944,5.802,16.870,160977,53066,107911,6.530,19.809,-23880,-2.939,33.741,2808,2835,19758
2007,5615,15442,20762,259944,260268,1721,8.126,2556,12.068,38153,9552,28601,3.670,14.659,38951,14560,24391,5.594,14.966,-798,-0.307,29.318,1370,1406,6637
2007,5616,17459,22844,777997,781024,2878,12.712,2471,10.914,131290,36920,94370,4.727,16.810,138335,54715,83620,7.006,17.712,-7045,-0.902,33.620,1538,1563,20783
2007,5617,137079,143341,1679133,1672892,23248,16.394,20182,14.232,331909,115623,216286,6.912,19.840,318400,111381,207019,6.658,19.033,13509,0.808,38.066,14114,14137,68320
2007,5619,16496,18519,313587,324160,2006,10.795,2133,11.479,49477,14386,35091,4.438,15.263,69640,24453,45187,7.544,21.483,-20163,-6.220,30.526,1413,1421,9135
2007,5621,7342,9386,194390,188815,1230,13.394,824,8.973,43635,22750,20885,12.049,23.110,32867,12192,20675,6.457,17.407,10768,5.703,34.814,501,501,2880
2007,5622,1393,2485,58937,60399,258,10.412,244,9.847,9087,4356,4731,7.212,15.045,11912,4918,6994,8.143,19.722,-2825,-4.677,30.090,110,110,901
2007,5629,7316,8232,121626,121448,1030,12.779,686,8.511,26407,9723,16684,8.006,21.744,26460,7641,18819,6.292,21.787,-53,-0.044,43.487,452,458,4155
2007,6111,17653,19982,823444,813855,989,4.967,850,4.269,70150,15902,54248,1.954,8.619,50862,11895,38967,1.462,6.250,19288,2.370,12.499,614,624,8344
2007,6112,436,826,80185,81300,32,3.860,38,4.584,5475,659,4816,0.811,6.734,7904,488,7416,0.600,9.722,-2429,-2.988,13.469,24,26,311
2007,6113,2263,3775,1561201,1544752,234,6.292,122,3.280,89602,10182,79420,0.659,5.800,57563,3990,53573,0.258,3.726,32039,2.074,7.453,72,74,795
2007,6114,6586,7189,68057,67790,1012,14.258,830,11.693,14723,6637,8086,9.791,21.719,14132,5613,8519,8.280,20.847,591,0.872,41.694,544,553,3007
2007,6115,6099,7578,127985,127139,870,11.626,681,9.100,23122,6640,16482,5.223,18.186,21897,4569,17328,3.594,17.223,1225,0.964,34.446,473,475,2369
2007,6116,30550,32860,307567,302314,5018,15.624,3531,10.994,69674,27527,42147,9.105,23.047,59120,19497,39623,6.449,19.556,10554,3.491,39.112,2539,2553,11612
2007,6117,4943,5644,72007,72357,842,15.102,705,12.645,12729,3959,8770,5.471,17.592,13375,3567,9808,4.930,18.485,-646,-0.893,35.184,478,486,1689
2007,6211,176846,203446,2101991,2086100,16302,8.038,15047,7.419,304726,107631,197095,5.159,14.607,275505,90889,184616,4.357,13.207,29221,1.401,26.413,10064,10293,47361
2007,6212,114616,120435,825526,821881,7036,5.880,5502,4.598,109218,35462,73756,4.315,13.289,101974,26245,75729,3.193,12.407,7244,0.881,24.815,4235,4359,20315
2007,6213,100956,112925,612116,604112,13163,11.864,9204,8.296,117078,46786,70292,7.745,19.380,100529,35858,64671,5.936,16.641,16549,2.739,33.282,6117,6200,18964
2007,6214,13478,28481,644081,638165,3472,12.528,1938,6.993,99379,38152,61227,5.978,15.573,87177,27272,59905,4.274,13.661,12202,1.912,27.321,768,840,9089
2007,6215,6996,12070,235239,233075,1899,16.278,1091,9.352,37711,15433,22278,6.621,16.180,33531,15144,18387,6.497,14.386,4180,1.793,28.773,646,692,6085
2007,6216,14199,20869,980376,957514,3609,18.019,1928,9.626,170553,55580,114973,5.805,17.812,123929,33640,90289,3.513,12.943,46624,4.869,25.886,1122,1174,15544
2007,6219,5563,8744,270312,262731,1002,11.659,703,8.180,50526,15423,35103,5.870,19.231,35257,11974,23283,4.558,13.419,15269,5.812,26.839,379,387,4695
2007,6221,3050,5065,5049129,4996082,59,1.160,99,1.947,307247,33193,274054,0.664,6.150,199071,45074,153997,0.902,3.985,108176,2.165,7.969,46,46,15832
2007,6222,421,563,210577,211021,21,3.710,27,4.770,18614,4080,14534,1.933,8.821,19755,2608,17147,1.236,9.362,-1141,-0.541,17.642,9,9,822
2007,6223,360,818,234326,230926,58,7.117,52,6.380,23883,4969,18914,2.152,10.342,17182,3893,13289,1.686,7.440,6701,2.902,14.881,32,34,2044
2007,6231,7957,15511,1582410,1574422,1358,8.793,1225,7.932,162671,72846,89825,4.627,10.332,147078,73433,73645,4.664,9.342,15593,0.990,18.683,573,627,41322
2007,6232,8624,32465,598609,595416,2672,8.288,2218,6.880,85459,26646,58813,4.475,14.353,80020,22005,58015,3.696,13.439,5439,0.913,26.879,360,418,5454
2007,6233,13816,19463,733031,718410,2200,11.438,1741,9.052,100656,47200,53456,6.570,14.011,71428,28749,42679,4.002,9.943,29228,4.068,19.885,1261,1289,19777
2007,6239,3386,5895,151424,151927,453,7.670,476,8.059,19896,5470,14426,3.600,13.096,20951,6089,14862,4.008,13.790,-1055,-0.694,26.192,217,227,2800
2007,6241,38342,53912,1178009,1153217,5552,10.465,3839,7.236,182923,47224,135699,4.095,15.862,132592,30325,102267,2.630,11.498,50331,4.364,22.995,2204,2273,16111
2007,6242,9346,13583,165643,165138,723,5.337,652,4.813,22346,4978,17368,3.014,13.532,21192,5285,15907,3.200,12.833,1154,0.699,25.666,286,293,2031
2007,6243,4370,7380,321057,322577,436,5.819,662,8.835,44490,6269,38221,1.943,13.792,47906,10185,37721,3.157,14.851,-3416,-1.059,27.584,224,250,1688
2007,6244,53877,68766,858930,858543,7648,11.088,8063,11.690,133981,51646,82335,6.016,15.606,135109,59620,75489,6.944,15.737,-1128,-0.131,31.211,5018,5109,28250
2007,7111,7133,7268,124174,124348,930,12.828,894,12.331,21020,5969,15051,4.800,16.904,21540,5638,15902,4.534,17.322,-520,-0.418,33.808,623,626,3815
2007,7112,3310,3483,122065,120436,554,16.021,504,14.575,20847,5518,15329,4.582,17.310,17431,6324,11107,5.251,14.473,3416,2.836,28.946,359,359,3555
2007,7113,5187,5554,123578,120649,792,14.559,564,10.368,23492,7655,15837,6.345,19.471,17962,3347,14615,2.774,14.888,5530,4.584,29.776,398,399,1893
2007,7114,2727,2804,17853,17294,451,16.332,366,13.254,3852,1345,2507,7.777,22.274,2765,1220,1545,7.055,15.989,1087,6.286,31.977,270,270,967
2007,7115,13554,13574,43888,45077,2654,19.754,2376,17.685,13332,6780,6552,15.041,29.576,15633,6375,9258,14.142,34.681,-2301,-5.105,59.152,1504,1505,4221
2007,7121,6128,6613,128450,126025,432,6.578,341,5.192,13268,1851,11417,1.469,10.528,8479,1576,6903,1.251,6.728,4789,3.800,13.456,194,196,915
2007,7131,2046,2536,133074,138506,397,15.602,414,16.270,14820,4684,10136,3.382,10.700,25786,4248,21538,3.067,18.617,-10966,-7.917,21.400,282,300,2816
2007,7132,1654,2216,167514,165960,292,13.198,285,12.881,20941,6603,14338,3.979,12.618,17516,7540,9976,4.543,10.554,3425,2.064,21.109,179,179,3021
2007,7139,50863,57162,1169509,1159410,7422,13.074,6636,11.689,177729,62360,115369,5.379,15.329,158422,52538,105884,4.531,13.664,19307,1.665,27.328,5191,5217,37932
2007,7211,37835,47648,1884696,1876606,5560,11.705,5263,11.080,272177,122298,149879,6.517,14.504,255550,125743,129807,6.701,13.618,16627,0.886,27.235,3444,3487,56432
2007,7212,5306,5843,39950,39504,658,11.375,541,9.353,7887,2460,5427,6.227,19.965,6979,2076,4903,5.255,17.667,908,2.299,35.333,348,348,1271
2007,7213,2003,2064,10980,11106,120,5.760,159,7.631,1411,372,1039,3.350,12.705,1662,649,1013,5.844,14.966,-251,-2.260,25.411,111,111,373
2007,7223,11991,32211,607902,598679,7087,22.767,4922,15.812,170610,80290,90320,13.411,28.498,145085,55552,89533,9.279,24.234,25525,4.264,48.468,1445,1465,8730
2007,7224,41502,42176,355257,355472,5119,12.073,5566,13.128,79530,41243,38287,11.602,22.373,79465,33355,46110,9.383,22.355,65,0.018,44.710,4672,4677,28292
2007,7225,317127,438515,8712724,8664536,59800,13.830,47530,10.993,1557217,811622,745595,9.367,17.972,1459574,492149,967425,5.680,16.845,97643,1.127,33.691,36750,37647,346991
2007,8111,139577,152659,875757,879177,14577,9.520,15497,10.121,148190,59716,88474,6.792,16.856,154532,56359,98173,6.410,17.577,-6342,-0.721,33.711,11556,11839,42123
2007,8112,10513,11837,124541,125266,1299,10.833,1608,13.409,23697,8813,14884,7.035,18.917,25234,9057,16177,7.230,20.144,-1537,-1.227,37.835,1042,1046,3705
2007,8113,19512,20951,189442,184457,2182,10.452,2033,9.738,36609,13903,22706,7.537,19.847,26052,9861,16191,5.346,14.124,10557,5.723,28.247,1448,1450,5498
2007,8114,17701,18716,78795,81797,2126,11.239,2526,13.354,14030,5095,8935,6.229,17.152,19822,7596,12226,9.286,24.233,-5792,-7.081,34.305,1853,1864,4393
2007,8121,84097,99929,613584,615258,14430,14.590,12375,12.512,117868,59629,58239,9.692,19.157,121613,47953,73660,7.794,19.766,-3745,-0.609,38.315,9701,9843,34682
2007,8122,14719,20285,136810,136354,954,4.720,805,3.983,18577,3871,14706,2.839,13.624,17697,2754,14943,2.020,12.979,880,0.645,25.958,460,468,1609
2007,8123,30880,36713,345928,349392,3802,10.228,4724,12.708,52023,17221,34802,4.929,14.890,58809,24585,34224,7.037,16.832,-6786,-1.942,29.779,3334,3418,14108
2007,8129,20639,31042,239447,233264,5976,19.454,5329,17.348,65192,29970,35222,12.848,27.948,52907,25348,27559,10.867,22.681,12285,5.267,45.362,2506,2556,9405
2007,8131,169029,169344,1678453,1677937,9180,5.451,7339,4.357,163727,28595,135132,1.704,9.758,162350,23244,139106,1.385,9.676,1377,0.082,19.351,4445,4445,13510
2007,8132,13879,15872,188369,181545,1281,8.170,897,5.721,29539,4734,24805,2.608,16.271,15346,3705,11641,2.041,8.453,14193,7.818,16.906,553,556,2522
2007,8133,12420,14695,129566,127234,1432,9.922,906,6.278,19331,4811,14520,3.781,15.193,14601,3117,11484,2.450,11.476,4730,3.718,22.952,515,519,1764
2007,8134,26327,28087,257253,256986,1631,5.810,1602,5.707,33353,6544,26809,2.546,12.979,32847,7233,25614,2.815,12.782,506,0.197,25.563,1068,1072,4113
2007,8139,56101,58266,511255,512774,2934,5.009,3549,6.059,59993,12674,47319,2.472,11.700,63127,14135,48992,2.757,12.311,-3134,-0.611,23.399,2455,2459,9658
2008,1131,322,355,2596,2627,26,7.104,48,13.115,438,99,339,3.769,16.673,511,222,289,8.451,19.452,-73,-2.779,33.346,26,26,151
2008,1132,134,189,2121,2173,20,10.127,37,18.734,493,253,240,11.646,22.693,579,285,294,13.119,26.651,-86,-3.959,45.386,19,19,199
2008,1133,8113,8185,56191,57603,676,7.999,1209,14.305,8242,2100,6142,3.646,14.308,11158,3862,7296,6.705,19.371,-2916,-5.062,28.617,896,897,2958
2008,1141,1131,1137,5384,5340,177,15.038,257,21.835,1077,431,646,8.071,20.169,985,455,530,8.521,18.446,92,1.723,36.891,140,140,226
2008,1142,263,263,1847,1842,32,12.237,29,11.090,217,74,143,4.018,11.784,209,48,161,2.607,11.349,8,0.434,22.699,22,22,37
2008,1151,3395,3732,63688,63582,394,10.525,417,11.139,10769,2822,7947,4.438,16.937,10678,3646,7032,5.734,16.794,91,0.143,33.588,292,294,3197
2008,1152,3638,3735,19885,19873,513,13.755,502,13.460,3426,1305,2121,6.567,17.239,3397,1507,1890,7.583,17.094,29,0.146,34.187,390,390,1010
2008,1153,1263,1362,11550,11812,151,10.895,199,14.358,2147,568,1579,4.809,18.177,2673,693,1980,5.867,22.630,-526,-4.453,36.354,97,97,336
2008,2111,5742,6993,101602,121488,781,11.319,595,8.623,17930,6847,11083,5.636,14.759,57341,9610,47731,7.910,47.199,-39411,-32.440,29.517,373,373,3342
2008,2121,572,968,79045,79355,99,10.087,126,12.837,11196,1991,9205,2.509,14.109,11857,3357,8500,4.230,14.942,-661,-0.833,28.218,75,75,1326
2008,2122,206,266,33310,34136,39,14.801,34,12.903,3870,653,3217,1.913,11.337,5560,180,5380,0.527,16.288,-1690,-4.951,22.674,21,21,101
2008,2123,3122,5180,89736,96007,260,4.952,401,7.637,10921,2749,8172,2.863,11.375,23212,2492,20720,2.596,24.178,-12291,-12.802,22.751,232,236,1446
2008,2131,9013,11042,317959,331644,1562,14.486,1044,9.682,59798,17758,42040,5.355,18.031,88011,16089,71922,4.851,26.538,-28213,-8.507,36.062,707,710,7590
2008,2211,1575,9543,508959,512229,701,7.380,612,6.443,45699,13886,31813,2.711,8.922,51870,13922,37948,2.718,10.126,-6171,-1.205,17.843,53,56,641
2008,2212,426,2323,84629,83972,155,6.645,174,7.460,10564,3890,6674,4.632,12.580,9420,1696,7724,2.020,11.218,1144,1.362,22.436,23,23,272
2008,2213,3482,4513,42648,42140,463,10.404,337,7.573,9154,5828,3326,13.830,21.723,8158,3267,4891,7.753,19.360,996,2.364,38.719,145,145,522
2008,2361,154211,155627,804297,854864,24727,15.485,32849,20.571,167261,73142,94119,8.556,19.566,268130,100668,167462,11.776,31.365,-100869,-11.799,39.132,24672,24672,73602
2008,2362,39998,41220,734645,733379,3898,9.395,4435,10.690,132934,27124,105810,3.698,18.126,131461,29935,101526,4.082,17.925,1473,0.201,35.851,3257,3271,18052
2008,2371,18128,19227,548060,544655,1518,7.831,1835,9.466,98954,16055,82899,2.948,18.168,92245,19905,72340,3.655,16.936,6709,1.232,33.873,1268,1268,8170
2008,2372,9358,9438,67030,70760,934,9.425,1878,18.951,11036,3608,7428,5.099,15.596,18513,6067,12446,8.574,26.163,-7477,-10.567,31.193,1571,1572,5015
2008,2373,9580,10367,313652,319094,632,6.010,931,8.853,42796,8500,34296,2.664,13.412,54005,7369,46636,2.309,16.925,-11209,-3.513,26.823,609,609,4417
2008,2379,3933,4074,67461,68404,457,11.102,542,13.167,13577,3428,10149,5.011,19.848,15527,4418,11109,6.459,22.699,-1950,-2.851,39.697,362,362,1911
2008,2381,91482,92303,1017117,1068954,10259,10.737,16754,17.534,187456,45488,141968,4.255,17.536,291093,69553,221540,6.507,27.232,-103637,-9.695,35.073,12195,12196,51688
2008,2382,164607,168388,1992775,1992901,16469,9.751,17468,10.343,339825,71195,268630,3.572,17.052,339344,76564,262780,3.842,17.028,481,0.024,34.055,13228,13244,57800
2008,2383,108524,109661,880223,910133,14089,12.518,19858,17.644,176699,51829,124870,5.695,19.415,236357,65386,170971,7.184,25.970,-59658,-6.555,38.829,15034,15036,49256
2008,2389,61511,62256,579965,596954,8067,12.711,10480,16.514,104524,32816,71708,5.497,17.510,138473,38136,100337,6.388,23.197,-33949,-5.687,35.019,7590,7593,29078
2008,3111,1118,1701,50409,48141,99,5.817,101,5.934,8440,1228,7212,2.551,17.532,4218,1163,3055,2.416,8.762,4222,8.770,17.524,70,70,693
2008,3112,434,760,55841,55287,46,6.089,37,4.897,4194,811,3383,1.467,7.586,3070,1094,1976,1.979,5.553,1124,2.033,11.106,25,25,447
2008,3113,1445,1595,67947,69634,123,7.680,136,8.492,6349,1379,4970,1.980,9.118,9624,2834,6790,4.070,13.821,-3275,-4.703,18.235,95,95,1312
2008,3114,1182,1544,160840,160407,85,5.456,113,7.253,13850,3090,10760,1.926,8.634,13113,2916,10197,1.818,8.175,737,0.459,16.350,78,78,1481
2008,3115,995,1507,133083,132075,83,5.524,74,4.925,11921,1625,10296,1.230,9.026,9910,2432,7478,1.841,7.503,2011,1.523,15.007,49,49,1252
2008,3116,2841,3458,498556,493631,177,5.085,222,6.378,36101,5661,30440,1.147,7.313,26609,8312,18297,1.684,5.390,9492,1.923,10.781,168,168,4219
2008,3117,504,598,33267,32790,38,6.271,54,8.911,5041,318,4723,0.970,15.374,4044,1199,2845,3.657,12.333,997,3.041,24.666,37,37,537
2008,3118,8583,9304,280091,282804,794,8.494,881,9.425,27545,7298,20247,2.581,9.740,32552,8678,23874,3.069,11.510,-5007,-1.770,19.480,696,701,5080
2008,3119,2565,3010,163032,162412,231,7.677,229,7.611,17714,5035,12679,3.100,10.907,16561,4280,12281,2.635,10.197,1153,0.710,20.394,165,166,2424
2008,3121,2960,3528,135441,134575,468,13.640,274,7.986,16422,5511,10911,4.095,12.203,14575,3743,10832,2.781,10.830,1847,1.372,21.661,192,197,1648
2008,3122,70,98,18813,19438,6,6.091,7,7.107,439,66,373,0.340,2.259,1673,215,1458,1.106,8.607,-1234,-6.349,4.517,D,D,D
2008,3131,258,372,39330,41484,15,3.891,42,10.895,1800,199,1601,0.480,4.339,6156,2178,3978,5.250,14.840,-4356,-10.501,8.678,24,26,462
2008,3132,1001,1128,65448,70053,59,5.077,127,10.929,4641,1259,3382,1.797,6.625,13979,7085,6894,10.114,19.955,-9338,-13.330,13.250,83,86,3042
2008,3133,1083,1139,41430,42602,88,7.599,126,10.881,4715,880,3835,2.066,11.068,6959,3609,3350,8.472,16.335,-2244,-5.267,22.135,98,99,1487
2008,3141,2092,2227,69140,72702,137,6.051,211,9.320,5682,2181,3501,3.000,7.815,12925,4682,8243,6.440,17.778,-7243,-9.963,15.631,165,165,1285
2008,3149,3930,4051,72109,72168,371,9.189,344,8.520,9548,2571,6977,3.563,13.230,9805,3177,6628,4.402,13.586,-257,-0.356,26.461,267,267,2052
2008,3151,336,355,19706,21612,30,7.968,73,19.389,1543,468,1075,2.165,7.140,5282,3454,1828,15.982,24.440,-3739,-17.301,14.279,54,55,1178
2008,3152,6225,6323,130136,132933,926,14.267,1261,19.428,25137,9820,15317,7.387,18.910,30466,15928,14538,11.982,22.918,-5329,-4.009,37.819,1094,1095,12592
2008,3159,666,682,12685,13095,59,8.381,103,14.631,1047,213,834,1.627,7.996,1883,501,1382,3.826,14.380,-836,-6.384,15.991,89,89,376
2008,3161,205,212,4811,4747,13,6.005,22,10.162,850,269,581,5.667,17.906,689,109,580,2.296,14.514,161,3.392,29.029,18,18,104
2008,3162,215,237,12774,13017,16,6.653,23,9.563,667,56,611,0.430,5.124,1163,426,737,3.273,8.935,-496,-3.811,10.249,17,17,91
2008,3169,747,760,15348,15632,76,9.928,87,11.365,1813,538,1275,3.442,11.598,2316,1410,906,9.020,14.816,-503,-3.218,23.197,61,61,226
2008,3211,3249,3660,101277,104878,223,5.955,393,10.494,8170,2972,5198,2.834,7.790,15318,4888,10430,4.661,14.606,-7148,-6.816,15.580,298,304,2896
2008,3212,1410,1812,93149,100804,123,6.688,177,9.625,7206,2795,4411,2.773,7.149,22775,6156,16619,6.107,22.593,-15569,-15.445,14.297,100,102,1834
2008,3219,9002,10039,291788,304207,703,6.907,981,9.638,28159,9313,18846,3.061,9.257,53191,13364,39827,4.393,17.485,-25032,-8.229,18.513,763,770,8532
2008,3221,235,477,121631,124183,16,3.320,26,5.394,3486,432,3054,0.348,2.807,8417,2383,6034,1.919,6.778,-4931,-3.971,5.614,12,12,274
2008,3222,2875,4268,287737,291680,143,3.309,249,5.763,16677,3971,12706,1.361,5.718,24563,7753,16810,2.658,8.421,-7886,-2.704,11.435,142,143,2276
2008,3231,29199,30749,617552,628762,1644,5.257,2692,8.608,48605,12410,36195,1.974,7.730,71342,25041,46301,3.983,11.346,-22737,-3.616,15.461,2195,2207,14472
2008,3241,1039,2213,103384,102007,163,7.382,153,6.929,9283,1331,7952,1.305,9.100,6468,1833,4635,1.797,6.341,2815,2.760,12.681,62,62,667
2008,3251,1395,2461,160355,159334,156,6.330,163,6.614,12844,3284,9560,2.061,8.061,10838,2759,8079,1.732,6.802,2006,1.259,13.604,65,65,391
2008,3252,959,1292,98300,98893,65,5.052,54,4.197,7123,2045,5078,2.068,7.203,8489,1284,7205,1.298,8.584,-1366,-1.381,14.405,31,31,295
2008,3253,609,847,29714,29683,68,8.086,56,6.659,2668,884,1784,2.978,8.988,2622,820,1802,2.763,8.833,46,0.155,17.667,29,29,215
2008,3254,1413,1835,254946,247792,119,6.505,108,5.903,31991,2981,29010,1.203,12.910,16772,4980,11792,2.010,6.769,15219,6.142,13.537,56,56,995
2008,3255,1441,1822,62616,63817,85,4.612,127,6.891,5619,1209,4410,1.894,8.805,8036,2362,5674,3.701,12.592,-2417,-3.787,17.610,77,79,1034
2008,3256,1888,2094,104599,105074,137,6.527,147,7.003,9895,2091,7804,1.990,9.417,10785,3502,7283,3.333,10.264,-890,-0.847,18.834,95,95,1123
2008,3259,1941,2477,94697,96871,135,5.376,203,8.084,8228,2099,6129,2.167,8.494,12476,2963,9513,3.059,12.879,-4248,-4.385,16.988,128,131,1245
2008,3261,8900,11305,664836,680391,470,4.105,757,6.612,52158,9527,42631,1.400,7.666,83446,24138,59308,3.548,12.264,-31288,-4.599,15.332,498,509,11810
2008,3262,1579,2055,144732,145889,99,4.794,119,5.763,11248,2540,8708,1.741,7.710,13566,3343,10223,2.291,9.299,-2318,-1.589,15.420,77,77,722
2008,3271,1127,1322,44815,46999,101,7.540,136,10.153,3480,1302,2178,2.770,7.404,7780,1969,5811,4.189,16.554,-4300,-9.149,14.809,83,83,474
2008,3272,1566,1869,99559,98715,105,5.516,174,9.141,8989,2439,6550,2.471,9.106,7301,2046,5255,2.073,7.396,1688,1.710,14.792,121,121,589
2008,3273,4671,9585,209060,216865,533,5.534,625,6.489,21718,6103,15615,2.814,10.015,37566,7931,29635,3.657,17.322,-15848,-7.308,20.029,288,333,4293
2008,3274,201,338,16510,16786,21,6.195,23,6.785,1215,566,649,3.372,7.238,1787,164,1623,0.977,10.646,-572,-3.408,14.476,17,17,64
2008,3279,2812,3291,79364,81374,281,8.562,263,8.013,7268,2135,5133,2.624,8.932,11224,2891,8333,3.553,13.793,-3956,-4.862,17.863,197,197,1714
2008,3311,374,503,106528,105064,73,15.005,40,8.222,7588,2013,5575,1.916,7.222,4635,1413,3222,1.345,4.412,2953,2.811,8.823,25,25,534
2008,3312,474,617,45376,45230,49,8.046,33,5.419,3522,884,2638,1.954,7.787,3250,828,2422,1.831,7.186,272,0.601,14.371,21,21,360
2008,3313,430,568,61685,62124,31,5.434,36,6.310,4557,2716,1841,4.372,7.335,5459,1533,3926,2.468,8.787,-902,-1.452,14.671,18,18,334
2008,3314,732,945,65970,65694,54,5.690,62,6.533,5138,982,4156,1.495,7.821,4667,1548,3119,2.356,7.104,471,0.717,14.208,39,39,287
2008,3315,1768,1993,151431,154967,81,4.015,130,6.444,8921,1457,7464,0.940,5.757,16099,3397,12702,2.192,10.389,-7178,-4.632,11.513,95,97,1916
2008,3321,2401,2648,126105,126684,85,3.181,134,5.014,10040,1725,8315,1.362,7.925,11207,2974,8233,2.348,8.846,-1167,-0.921,15.850,101,101,1809
2008,3322,1300,1414,49470,49954,77,5.419,91,6.404,3665,504,3161,1.009,7.337,4737,1366,3371,2.735,9.483,-1072,-2.146,14.674,73,73,893
2008,3323,12352,13397,401531,405507,784,5.832,877,6.524,40600,9515,31085,2.346,10.012,48849,12596,36253,3.106,12.046,-8249,-2.034,20.024,664,666,7191
2008,3324,1188,1479,95926,94601,76,5.146,72,4.875,13544,6720,6824,7.104,14.317,11560,6563,4997,6.938,12.220,1984,2.097,24.440,54,54,5477
2008,3325,624,700,38603,39506,30,4.211,55,7.719,2316,721,1595,1.825,5.862,4064,1314,2750,3.326,10.287,-1748,-4.425,11.725,43,43,406
2008,3326,1297,1465,48535,49406,43,2.881,98,6.566,4036,895,3141,1.812,8.169,5834,1417,4417,2.868,11.808,-1798,-3.639,16.338,74,74,728
2008,3327,23176,23606,395924,395566,1275,5.374,1514,6.381,41520,8517,33003,2.153,10.496,40802,14593,26209,3.689,10.315,718,0.182,20.630,1171,1173,8542
2008,3328,5316,5844,135415,136461,279,4.732,382,6.480,12971,3171,9800,2.324,9.505,15110,4427,10683,3.244,11.073,-2139,-1.567,19.011,292,298,2801
2008,3329,5852,6393,278723,279140,456,7.147,430,6.740,26904,6233,20671,2.233,9.638,27578,9349,18229,3.349,9.880,-674,-0.241,19.276,314,316,3793
2008,3331,2534,2864,209029,206622,198,6.950,168,5.897,21699,3132,18567,1.516,10.502,16766,4180,12586,2.023,8.114,4933,2.387,16.229,122,122,2469
2008,3332,3430,3610,127004,130183,168,4.600,252,6.900,11599,2768,8831,2.126,8.910,17661,3731,13930,2.866,13.566,-6062,-4.657,17.820,181,182,1929
2008,3333,1887,2027,86535,87122,134,6.573,157,7.702,7755,1949,5806,2.237,8.901,9014,2994,6020,3.437,10.346,-1259,-1.445,17.803,113,113,986
2008,3334,1463,1760,147160,148610,108,6.161,94,5.362,10820,1544,9276,1.039,7.281,13905,2758,11147,1.856,9.357,-3085,-2.076,14.562,55,55,797
2008,3335,7153,7390,163430,164911,281,3.758,455,6.085,13750,3782,9968,2.293,8.338,16667,5523,11144,3.349,10.107,-2917,-1.769,16.676,349,354,3192
2008,3336,796,972,108479,107045,61,6.308,51,5.274,9782,1404,8378,1.312,9.138,7032,1822,5210,1.702,6.569,2750,2.569,13.138,35,35,178
2008,3339,5384,6005,295600,295018,280,4.630,365,6.036,27399,4722,22677,1.601,9.287,26102,8148,17954,2.762,8.848,1297,0.440,17.695,254,255,3192
2008,3341,1069,1109,88518,91466,102,9.099,126,11.240,7011,2417,4594,2.643,7.665,12788,3601,9187,3.937,13.981,-5777,-6.316,15.330,87,87,1001
2008,3342,1374,1539,128962,128244,94,5.991,154,9.815,16594,1942,14652,1.514,12.939,14502,5672,8830,4.423,11.308,2092,1.631,22.616,106,107,1931
2008,3343,437,452,13944,14879,52,11.556,48,10.667,1329,155,1174,1.042,8.932,3093,572,2521,3.844,20.788,-1764,-11.856,17.865,41,41,408
2008,3344,3917,4413,348524,357124,252,5.668,318,7.152,26414,6413,20001,1.796,7.396,43636,12350,31286,3.458,12.219,-17222,-4.822,14.793,224,224,3695
2008,3345,4248,4930,404738,399976,324,6.543,368,7.431,44779,12469,32310,3.117,11.195,35293,13440,21853,3.360,8.824,9486,2.372,17.648,207,207,2335
2008,3346,657,681,25341,26234,71,10.282,90,13.034,2201,427,1774,1.628,8.390,4084,1271,2813,4.845,15.568,-1883,-7.178,16.780,62,63,604
2008,3351,1007,1102,54793,55765,75,6.742,96,8.629,3587,1070,2517,1.919,6.432,5539,1356,4183,2.432,9.933,-1952,-3.500,12.865,79,79,803
2008,3352,263,312,58779,62612,26,8.228,34,10.759,1955,428,1527,0.684,3.122,9820,2648,7172,4.229,15.684,-7865,-12.561,6.245,22,22,207
2008,3353,1916,2226,135869,136457,109,4.870,133,5.943,15378,5420,9958,3.972,11.270,16512,7572,8940,5.549,12.101,-1134,-0.831,22.539,88,88,1174
2008,3359,1808,2115,154119,153479,120,5.659,131,6.178,13565,1848,11717,1.204,8.838,12600,4951,7649,3.226,8.210,965,0.629,16.419,81,82,784
2008,3361,274,341,177774,185454,46,13.814,30,9.009,9621,996,8625,0.537,5.188,24680,274,24406,0.148,13.308,-15059,-8.120,10.376,22,22,180
2008,3362,1765,2031,133747,142790,112,5.424,180,8.717,10051,2919,7132,2.044,7.039,27819,5311,22508,3.719,19.482,-17768,-12.443,14.078,134,134,2003
2008,3363,4247,5227,551892,577088,294,5.529,474,8.915,38787,12504,26283,2.167,6.721,88518,27621,60897,4.786,15.339,-49731,-8.618,13.442,283,290,6848
2008,3364,1223,1609,417262,414468,100,6.231,92,5.732,28921,2728,26193,0.658,6.978,23563,4010,19553,0.968,5.685,5358,1.293,11.370,68,68,1907
2008,3365,156,218,29507,29158,12,5.517,11,5.057,2742,118,2624,0.405,9.404,2070,158,1912,0.542,7.099,672,2.305,14.199,9,9,110
2008,3366,1473,1601,157884,155820,133,8.212,170,10.497,18453,1567,16886,1.006,11.843,14155,4427,9728,2.841,9.084,4298,2.758,18.168,120,120,1490
2008,3369,856,884,48327,47261,114,12.874,117,13.213,7867,981,6886,2.076,16.646,6004,2387,3617,5.051,12.704,1863,3.942,25.408,100,100,770
2008,3371,13523,13835,298096,312262,997,7.033,1681,11.857,24270,7248,17022,2.321,7.772,52303,17203,35100,5.509,16.750,-28033,-8.977,15.545,1338,1346,8789
2008,3372,3875,4074,138931,139559,235,5.720,304,7.399,15353,3418,11935,2.449,11.001,16752,5461,11291,3.913,12.004,-1399,-1.002,22.002,231,232,3056
2008,3379,832,961,40988,42230,49,5.028,76,7.799,3434,298,3136,0.706,8.132,5924,1575,4349,3.730,14.028,-2490,-5.896,16.264,65,65,988
2008,3391,10427,11254,306680,305803,678,5.987,819,7.232,27412,5220,22192,1.707,8.964,25554,6880,18674,2.250,8.356,1858,0.608,16.713,631,633,3863
2008,3399,16040,16496,330921,336732,1323,7.878,1919,11.427,34544,9406,25138,2.793,10.259,46384,15028,31356,4.463,13.775,-11840,-3.516,20.517,1569,1572,8891
2008,4231,17589,24893,390446,390263,1812,7.239,2087,8.338,46422,14871,31551,3.811,11.895,46188,13441,32747,3.444,11.835,234,0.060,23.670,1344,1379,6578
2008,4232,11018,12816,167452,169227,1159,8.979,1343,10.404,23254,8135,15119,4.807,13.741,27017,8357,18660,4.938,15.965,-3763,-2.224,27.483,934,954,4697
2008,4233,11285,18316,255371,266145,1569,8.563,1585,8.650,30210,11459,18751,4.306,11.351,51799,15872,35927,5.964,19.463,-21589,-8.112,22.702,898,943,6504
2008,4234,23282,32761,716172,733407,3519,10.707,3731,11.352,106420,31689,74731,4.321,14.510,142768,42872,99896,5.846,19.466,-36348,-4.956,29.021,1907,1971,11699
2008,4235,7800,10659,168709,168706,663,6.193,755,7.053,20084,4258,15826,2.524,11.905,20246,6166,14080,3.655,12.001,-162,-0.096,23.809,410,440,3286
2008,4236,19148,28666,518712,512383,2430,8.452,2597,9.033,83064,26028,57036,5.080,16.211,71799,23825,47974,4.650,14.013,11265,2.199,28.026,1461,1505,9758
2008,4237,10728,19294,241746,242992,1067,5.464,1532,7.846,30034,6828,23206,2.810,12.360,32857,12824,20033,5.278,13.522,-2823,-1.162,24.720,639,698,4000
2008,4238,40675,57038,740148,730749,4053,7.112,3954,6.938,103258,34693,68565,4.748,14.130,83725,28982,54743,3.966,11.457,19533,2.673,22.915,2386,2497,14426
2008,4239,27491,30413,343502,341413,3187,10.482,3170,10.426,55075,17436,37639,5.107,16.132,50893,17857,33036,5.230,14.907,4182,1.225,29.813,2396,2470,13247
2008,4241,8368,11008,170963,173183,667,5.989,924,8.297,17233,4229,13004,2.442,9.951,21568,8768,12800,5.063,12.454,-4335,-2.503,19.902,621,643,4111
2008,4242,5596,8130,270980,264802,1051,13.167,755,9.459,52780,26399,26381,9.969,19.932,40807,16319,24488,6.163,15.410,11973,4.522,30.821,473,476,3236
2008,4243,13756,15028,209391,212695,1650,10.947,1739,11.538,30699,8272,22427,3.889,14.433,37236,11261,25975,5.294,17.507,-6537,-3.073,28.867,1346,1366,6087
2008,4244,24556,30762,788417,782839,2650,8.587,2850,9.235,93502,22120,71382,2.826,11.944,82497,27915,54582,3.566,10.538,11005,1.406,21.076,1997,2015,14813
2008,4245,3488,6039,60368,60180,335,5.510,417,6.859,8028,1891,6137,3.142,13.340,7650,2610,5040,4.337,12.712,378,0.628,25.424,215,237,1502
2008,4246,8195,12236,149572,150647,827,6.667,1163,9.376,19522,4753,14769,3.155,12.959,21576,8799,12777,5.841,14.322,-2054,-1.363,25.918,551,566,2805
2008,4247,4914,7105,105031,104932,346,4.778,618,8.535,14156,3714,10442,3.539,13.491,14015,4581,9434,4.366,13.356,141,0.134,26.713,293,303,1790
2008,4248,3070,3919,178458,178070,366,9.408,309,7.942,16988,2689,14299,1.510,9.540,16289,6503,9786,3.652,9.148,699,0.393,18.295,201,208,2976
2008,4249,21158,27132,357402,361507,2386,8.674,3135,11.397,48521,13593,34928,3.760,13.422,56506,18971,37535,5.248,15.631,-7985,-2.209,26.844,2069,2239,9083
2008,4251,41262,43331,295586,294909,5090,11.764,4963,11.471,46556,17785,28771,6.031,15.787,44864,21446,23418,7.272,15.213,1692,0.574,30.426,3681,3693,13298
2008,4411,41547,46432,1244876,1253954,3956,8.440,4838,10.322,135858,52992,82866,4.226,10.834,153709,55493,98216,4.425,12.258,-17851,-1.424,21.669,3909,3945,43976
2008,4412,13661,15473,163717,166942,1338,8.603,1497,9.625,20158,7504,12654,4.495,12.075,26571,7605,18966,4.555,15.916,-6413,-3.841,24.150,1148,1180,5497
2008,4413,29059,55249,475332,479103,2863,5.154,3460,6.229,51909,14357,37552,2.997,10.835,58715,15208,43507,3.174,12.255,-6806,-1.421,21.669,2325,2413,8804
2008,4421,17198,26075,251594,260364,2352,8.828,3484,13.078,35160,14302,20858,5.493,13.504,52062,21697,30365,8.333,19.996,-16902,-6.492,27.008,2295,2681,15409
2008,4422,23588,32467,280347,299339,2246,6.756,3797,11.422,34753,9639,25114,3.220,11.610,71006,19801,51205,6.615,23.721,-36253,-12.111,23.220,2417,2657,10707
2008,4431,26874,49322,488723,493479,4442,8.928,5302,10.657,68284,23388,44896,4.739,13.837,78497,27156,51341,5.503,15.907,-10213,-2.070,27.675,3526,3675,14442
2008,4441,43374,66671,1166999,1180843,3743,5.579,4579,6.825,109526,34093,75433,2.887,9.275,137644,27060,110584,2.292,11.656,-28118,-2.381,18.550,2989,3146,14445
2008,4442,14759,18109,161438,162666,1142,6.253,1452,7.950,22416,6027,16389,3.705,13.780,24627,6680,17947,4.107,15.140,-2211,-1.359,27.561,1005,1042,4700
2008,4451,55701,81554,2565121,2553594,8351,10.232,8479,10.389,251190,81338,169852,3.185,9.837,227719,76316,151403,2.989,8.918,23471,0.919,17.835,6272,6382,35887
2008,4452,17311,21247,147636,143407,3363,16.069,2726,13.025,36172,15217,20955,10.611,25.223,27998,12121,15877,8.452,19.523,8174,5.700,39.047,2077,2091,8930
2008,4453,24867,28415,144708,142720,2809,9.944,2475,8.762,25889,8694,17195,6.092,18.140,21790,8305,13485,5.819,15.268,4099,2.872,30.535,1913,1936,6603
2008,4461,39559,84697,1018895,1021236,6740,8.003,5778,6.861,138908,57686,81222,5.649,13.602,145488,41267,104221,4.041,14.246,-6580,-0.644,27.204,3208,3363,16318
2008,4471,61370,108377,893128,896657,8286,7.562,10678,9.745,145704,49321,96383,5.501,16.250,152622,57240,95382,6.384,17.021,-6918,-0.772,32.499,6496,6963,33919
2008,4481,35101,93269,1285055,1277494,9668,10.449,8174,8.835,231265,75835,155430,5.936,18.103,217150,49458,167692,3.871,16.998,14115,1.105,33.996,4459,4686,17380
2008,4482,6159,27193,208169,206424,1904,7.032,1669,6.164,36563,11209,25354,5.430,17.713,33403,8602,24801,4.167,16.182,3160,1.531,32.363,604,610,1806
2008,4483,16965,26129,152038,156222,1731,6.534,2456,9.271,21783,7126,14657,4.561,13.944,30540,10217,20323,6.540,19.549,-8757,-5.606,27.887,1482,1559,4874
2008,4511,26815,37303,429013,433819,3821,10.160,4430,11.780,73167,35104,38063,8.092,16.866,83002,25748,57254,5.935,19.133,-9835,-2.267,33.732,2954,3164,12978
2008,4512,5086,10435,145028,145703,767,7.240,1084,10.233,18647,6542,12105,4.490,12.798,19525,4836,14689,3.319,13.401,-878,-0.603,25.596,668,774,2832
2008,4522,72,5352,703932,709697,175,3.298,84,1.583,44450,15771,28679,2.222,6.263,55998,9643,46355,1.359,7.890,-11548,-1.627,12.526,3,4,16
2008,4523,7388,38665,2269374,2218387,1870,4.809,2315,5.953,200019,77858,122161,3.510,9.016,101090,15398,85692,0.694,4.557,98929,4.460,9.114,1361,1416,5517
2008,4531,16475,17179,88903,90878,1402,7.960,2271,12.894,15139,5957,9182,6.555,16.659,19098,7209,11889,7.933,21.015,-3959,-4.356,33.317,1847,1857,5669
2008,4532,24264,35460,302998,304611,3352,9.309,4450,12.358,43753,14805,28948,4.860,14.364,46851,17393,29458,5.710,15.381,-3098,-1.017,28.727,3265,3363,11706
2008,4533,11635,16261,135859,134471,1518,9.266,1761,10.749,23852,8759,15093,6.514,17.738,21006,7345,13661,5.462,15.621,2846,2.116,31.242,1301,1316,4331
2008,4539,29838,37993,248029,252158,3984,10.389,4694,12.241,39001,16915,22086,6.708,15.467,47287,16077,31210,6.376,18.753,-8286,-3.286,30.934,3464,3562,11353
2008,4541,18529,19533,332955,336602,3032,15.731,2513,13.039,56041,16178,39863,4.806,16.649,64264,25243,39021,7.499,19.092,-8223,-2.443,33.298,1878,1888,8100
2008,4542,3973,4459,47218,47916,414,9.110,585,12.873,5630,1947,3683,4.063,11.750,7085,3375,3710,7.044,14.786,-1455,-3.037,23.499,423,429,1415
2008,4543,22626,28577,210374,212741,2546,8.840,2994,10.395,29642,9121,20521,4.287,13.933,34384,12078,22306,5.677,16.162,-4742,-2.229,27.867,1992,2012,7540
2008,4811,473,2897,443381,440284,186,6.318,280,9.511,28822,2165,26657,0.492,6.546,22650,4810,17840,1.092,5.144,6172,1.402,10.289,73,97,3194
2008,4812,2013,2211,41525,41396,265,11.883,303,13.587,5672,1718,3954,4.150,13.702,5308,1604,3704,3.875,12.823,364,0.879,25.645,204,207,684
2008,4831,709,1015,48262,50588,88,8.623,99,9.701,4716,882,3834,1.743,9.322,9255,2968,6287,5.867,18.295,-4539,-8.972,18.645,57,57,730
2008,4832,458,511,20201,19940,58,11.229,69,13.359,2317,520,1797,2.608,11.620,1811,824,987,4.133,9.082,506,2.538,18.165,45,45,632
2008,4841,47521,56519,946845,958438,8686,15.263,9468,16.637,121650,35327,86323,3.686,12.693,143894,46503,97391,4.852,15.013,-22244,-2.321,25.385,7291,7308,31243
2008,4842,40017,44274,476964,484183,5189,11.465,7159,15.818,71377,22771,48606,4.703,14.742,86023,29799,56224,6.154,17.767,-14646,-3.025,29.484,5136,5151,20276
2008,4851,575,828,48347,49673,76,8.822,143,16.599,5651,2352,3299,4.735,11.377,8717,6312,2405,12.707,17.549,-3066,-6.172,22.753,56,56,396
2008,4852,198,467,15680,16824,36,7.317,86,17.480,1942,141,1801,0.838,11.543,4317,1547,2770,9.195,25.660,-2375,-14.117,23.086,16,16,60
2008,4853,6196,6290,70286,70825,1054,17.005,870,14.037,11274,4394,6880,6.204,15.918,12334,4005,8329,5.655,17.415,-1060,-1.497,31.836,709,709,3142
2008,4854,2821,4312,219340,213412,356,8.190,425,9.778,35236,8806,26430,4.126,16.511,23403,13177,10226,6.174,10.966,11833,5.545,21.932,193,196,2756
2008,4855,1128,1244,30460,30712,122,9.819,119,9.577,3698,884,2814,2.878,12.041,4163,1220,2943,3.972,13.555,-465,-1.514,24.082,92,93,814
2008,4859,2740,3023,65024,62602,496,16.661,404,13.571,12805,4181,8624,6.679,20.455,7971,4107,3864,6.561,12.733,4834,7.722,25.466,297,297,2074
2008,4861,50,377,6199,6261,31,8.042,48,12.451,942,594,348,9.488,15.047,1086,286,800,4.568,17.347,-144,-2.300,30.093,D,D,D
2008,4862,124,1691,25768,24792,341,21.259,167,10.411,5988,3023,2965,12.193,24.153,3775,1812,1963,7.309,15.227,2213,8.926,30.453,9,9,188
2008,4869,58,707,8053,7282,151,22.622,72,10.787,2338,1524,814,20.930,32.109,735,366,369,5.026,10.094,1603,22.015,20.188,3,3,19
2008,4871,483,530,9287,9047,76,14.573,59,11.314,1644,464,1180,5.129,18.172,1207,353,854,3.902,13.341,437,4.830,26.683,41,41,169
2008,4872,1194,1236,11399,11209,192,15.490,199,16.055,2158,534,1624,4.764,19.253,1773,459,1314,4.095,15.818,385,3.435,31.637,124,124,279
2008,4879,140,152,2037,1993,29,20.139,13,9.028,554,368,186,18.469,27.804,478,22,456,1.104,23.990,76,3.814,47.980,9,9,16
2008,4881,3715,5300,179064,177474,614,11.719,493,9.409,25316,7168,18148,4.039,14.265,21806,5367,16439,3.024,12.287,3510,1.978,24.574,317,317,2262
2008,4882,452,987,27817,27889,113,11.608,86,8.834,3302,1313,1989,4.708,11.840,3345,1876,1469,6.727,11.994,-43,-0.154,23.680,34,36,359
2008,4883,1669,2246,93061,93369,211,9.413,202,9.012,11785,2448,9337,2.622,12.622,12126,2738,9388,2.932,12.987,-341,-0.365,25.244,127,128,1317
2008,4884,8452,9085,77871,76661,1315,14.685,1054,11.771,15762,7400,8362,9.653,20.561,13192,4772,8420,6.225,17.208,2570,3.352,34.416,756,757,2798
2008,4885,13818,20057,238326,239431,1930,9.607,1997,9.940,37036,10589,26447,4.423,15.468,39205,15100,24105,6.307,16.374,-2169,-0.906,30.937,1048,1062,5470
2008,4889,1206,1323,28047,27648,215,16.444,184,14.073,4213,1113,3100,4.026,15.238,3294,1409,1885,5.096,11.914,919,3.324,23.828,140,142,845
2008,4921,3168,8768,558972,545265,1417,16.697,854,10.063,60234,15859,44375,2.908,11.047,30945,11767,19178,2.158,5.675,29289,5.372,11.350,352,363,2906
2008,4922,3697,3967,36420,36288,754,19.453,572,14.757,7507,3329,4178,9.174,20.687,7238,2405,4833,6.628,19.946,269,0.741,39.892,480,489,2152
2008,4931,6846,13916,704663,717652,1264,9.074,1292,9.275,95296,29047,66249,4.048,13.279,121908,35486,86422,4.945,16.987,-26612,-3.708,26.558,375,403,4486
2008,5111,14554,20733,671205,677376,1877,8.982,2207,10.561,71068,24574,46494,3.628,10.492,84216,22095,62121,3.262,12.433,-13148,-1.941,20.983,1269,1287,8368
2008,5112,5287,7633,381595,376570,853,11.111,941,12.257,57386,16873,40513,4.481,15.239,47584,24905,22679,6.614,12.636,9802,2.603,25.272,420,450,7175
2008,5121,12888,16253,324192,321150,2445,15.147,2223,13.772,57365,21413,35952,6.668,17.862,52347,24723,27624,7.698,16.300,5018,1.563,32.600,1363,1372,16732
2008,5122,2901,3114,24190,24569,472,15.182,462,14.860,3330,1276,2054,5.194,13.554,4058,1591,2467,6.476,16.517,-728,-2.963,27.108,345,345,1066
2008,5151,4225,8898,246689,248231,979,10.845,1238,13.714,28773,13633,15140,5.492,11.591,31645,12760,18885,5.140,12.748,-2872,-1.157,23.182,275,286,1966
2008,5152,396,616,41385,42097,57,8.858,112,17.405,5228,1921,3307,4.563,12.419,6555,2830,3725,6.723,15.571,-1327,-3.152,24.838,36,36,432
2008,5173,4451,44544,1124934,1130398,6041,13.565,6020,13.518,189368,81489,107879,7.209,16.752,204457,51934,152523,4.594,18.087,-15089,-1.335,33.505,524,536,4704
2008,5174,468,587,9603,9624,144,24.490,146,24.830,2591,1627,964,16.906,26.922,2756,751,2005,7.803,28.637,-165,-1.714,53.845,102,102,308
2008,5179,4483,4974,59010,61363,982,19.875,916,18.539,12326,5605,6721,9.134,20.087,16976,7524,9452,12.262,27.665,-4650,-7.578,40.174,684,687,4137
2008,5182,8219,14655,396772,400670,1347,9.211,1284,8.780,73022,18946,54076,4.729,18.225,80004,28044,51960,6.999,19.968,-6982,-1.743,36.450,691,702,7725
2008,5191,5341,6723,139458,131249,965,14.565,770,11.622,29341,11984,17357,9.131,22.355,12348,4568,7780,3.480,9.408,16993,12.947,18.816,509,514,2192
2008,5211,12,47,19003,19258,0,0.000,0,0.000,319,0,319,0.000,1.656,839,0,839,0.000,4.357,-520,-2.700,3.313,0,0,0
2008,5221,14799,127691,2127632,2131054,9348,7.426,5740,4.560,257776,79837,177939,3.746,12.096,263899,67463,196436,3.166,12.383,-6123,-0.287,24.192,497,610,6506
2008,5222,16201,47038,639708,707371,5125,10.426,9359,19.040,111533,42999,68534,6.079,15.767,247270,113933,133337,16.107,34.956,-135737,-19.189,31.535,2978,3867,37102
2008,5223,21666,40437,294719,320258,4353,10.070,9931,22.975,51129,18338,32791,5.726,15.965,101317,45861,55456,14.320,31.636,-50188,-15.671,31.930,7102,7387,35807
2008,5231,11983,40036,524010,512765,5952,15.270,3837,9.844,86751,44741,42010,8.725,16.918,63500,24848,38652,4.846,12.384,23251,4.534,24.768,1049,1069,4806
2008,5232,32,59,5334,6596,15,27.027,8,14.414,734,149,585,2.259,11.128,3291,1325,1966,20.088,49.894,-2557,-38.766,22.256,5,5,93
2008,5239,37573,42591,424809,420475,6418,15.255,5381,12.790,76884,28648,48236,6.813,18.285,68766,31424,37342,7.473,16.354,8118,1.931,32.709,3775,3793,15113
2008,5241,5802,32889,1496342,1474999,5631,17.211,5286,16.157,237637,114187,123450,7.741,16.111,192592,69510,123082,4.713,13.057,45045,3.054,26.114,609,646,4527
2008,5242,121118,135994,890939,900600,11816,8.654,12894,9.444,137430,51923,85507,5.765,15.260,157205,69964,87241,7.769,17.456,-19775,-2.196,30.520,8315,8422,26759
2008,5259,640,661,8196,7698,192,30.000,150,23.438,3126,1801,1325,23.396,40.608,2172,1826,346,23.720,28.215,954,12.393,56.430,124,124,1643
2008,5311,83818,105215,533871,538431,11720,11.084,12773,12.079,98598,45416,53182,8.435,18.312,107116,50111,57005,9.307,19.894,-8518,-1.582,36.624,8228,8348,30084
2008,5312,69648,79797,328703,341414,11409,13.614,19419,23.172,68821,28233,40588,8.269,20.158,94666,44637,50029,13.074,27.728,-25845,-7.570,40.315,13564,13646,29634
2008,5313,61390,72823,637785,636012,9708,13.274,10332,14.127,110235,41204,69031,6.478,17.332,106917,41837,65080,6.578,16.811,3318,0.522,33.621,7068,7110,25798
2008,5321,3981,12955,188269,185914,2134,16.987,1349,10.738,31538,18306,13232,9.847,16.964,26646,9232,17414,4.966,14.332,4892,2.631,28.665,522,550,1922
2008,5322,10046,29985,236147,241018,2343,7.615,3908,12.702,36789,9244,27545,3.835,15.264,46492,21308,25184,8.841,19.290,-9703,-4.026,30.528,1449,1513,6822
2008,5323,2790,4227,27742,28179,190,4.409,354,8.215,3850,686,3164,2.434,13.663,4612,1484,3128,5.266,16.367,-762,-2.704,27.326,227,257,1090
2008,5324,7369,13142,165020,163009,1196,9.141,1081,8.262,28008,8447,19561,5.182,17.182,24344,8772,15572,5.381,14.934,3664,2.248,29.868,657,662,3285
2008,5331,1992,2095,31571,31069,279,13.430,244,11.745,6272,1725,4547,5.552,20.188,5339,1425,3914,4.587,17.185,933,3.003,34.369,180,183,1235
2008,5411,162472,171818,1186968,1191100,13461,7.791,15382,8.903,135735,41899,93836,3.518,11.396,144329,45155,99174,3.791,12.117,-8594,-0.722,22.792,11202,11300,31990
2008,5412,95501,110327,1271637,1260689,10064,9.142,9581,8.703,191397,55990,135407,4.441,15.182,170159,62807,107352,4.982,13.497,21238,1.685,26.995,6413,6453,44358
2008,5413,88280,103258,1444853,1425878,10433,10.112,10258,9.943,225039,64748,160291,4.541,15.782,186295,57499,128796,4.033,13.065,38744,2.717,26.131,6853,6920,26770
2008,5414,27775,28029,130984,128521,4172,14.943,3953,14.159,26783,10102,16681,7.860,20.839,21988,9582,12406,7.456,17.109,4795,3.731,34.217,3046,3048,7456
2008,5415,86572,98911,1306466,1296900,17751,17.962,17578,17.787,306553,127124,179429,9.802,23.637,284070,140214,143856,10.811,21.904,22483,1.734,43.808,10059,10140,37931
2008,5416,102875,109364,855429,839737,20344,18.806,17977,16.618,190229,74264,115965,8.844,22.653,158116,63190,94926,7.525,18.829,32113,3.824,37.658,13069,13121,41306
2008,5417,11470,14169,604874,609989,2015,14.414,1636,11.703,79793,22829,56964,3.743,13.081,88516,23212,65304,3.805,14.511,-8723,-1.430,26.162,982,1005,8562
2008,5418,32238,35858,465881,458591,4224,11.816,4003,11.198,79397,22644,56753,4.938,17.313,64252,22208,42044,4.843,14.011,15145,3.303,28.022,2958,2968,13237
2008,5419,53529,62795,613138,606814,6231,9.897,6553,10.409,98812,28239,70573,4.654,16.284,85527,30127,55400,4.965,14.094,13285,2.189,28.189,4210,4285,16710
2008,5511,26639,50298,2860402,2911161,4512,8.938,4873,9.654,473393,141356,332037,4.856,16.261,576023,149680,426343,5.142,19.787,-102630,-3.525,32.523,1025,1069,16203
2008,5611,23112,25018,397204,391150,3843,15.550,3234,13.086,78044,31048,46996,7.938,19.952,65619,28250,37369,7.222,16.776,12425,3.177,33.552,2506,2514,20283
2008,5612,1721,5724,259115,266370,791,13.863,755,13.232,35181,13448,21733,5.049,13.208,48975,17575,31400,6.598,18.386,-13794,-5.179,26.415,114,136,1648
2008,5613,27231,48798,4753689,4811132,7819,16.207,6713,13.914,1002294,301511,700783,6.267,20.833,1131308,331370,799938,6.888,23.514,-129014,-2.682,41.666,3204,3318,153459
2008,5614,26391,33113,831313,812231,3863,11.624,4103,12.346,180686,74390,106296,9.159,22.246,141678,45553,96125,5.608,17.443,39008,4.803,34.886,2759,2851,23021
2008,5615,15079,20239,255617,256648,1878,9.183,2303,11.261,34675,8811,25864,3.433,13.511,36973,11318,25655,4.410,14.406,-2298,-0.895,27.021,1300,1354,5596
2008,5616,17622,23268,822161,799718,2779,12.040,2407,10.428,171866,56534,115332,7.069,21.491,126403,46122,80281,5.767,15.806,45463,5.685,31.612,1639,1697,20554
2008,5617,136888,143419,1692557,1685200,21410,14.947,21052,14.697,298498,115601,182897,6.860,17.713,286834,89540,197294,5.313,17.021,11664,0.692,34.042,14848,14863,59608
2008,5619,16572,18519,303451,294687,2129,11.585,1844,10.035,62040,15445,46595,5.241,21.053,44282,18112,26170,6.146,15.027,17758,6.026,30.054,1347,1357,12557
2008,5621,7368,9459,195622,194706,888,9.413,838,8.883,24155,7005,17150,3.598,12.406,22389,8477,13912,4.354,11.499,1766,0.907,22.998,581,590,4186
2008,5622,1362,2450,49157,50322,181,7.358,201,8.171,5681,1692,3989,3.362,11.289,7994,3481,4513,6.918,15.886,-2313,-4.596,22.579,108,110,751
2008,5629,7476,8460,122298,121916,905,10.799,746,8.902,21597,6853,14744,5.621,17.715,20950,5193,15757,4.259,17.184,647,0.531,34.368,509,510,3212
2008,6111,17785,20098,839679,831966,956,4.755,969,4.820,68523,13929,54594,1.674,8.236,53190,15424,37766,1.854,6.393,15333,1.843,12.787,695,703,11137
2008,6112,439,832,82427,80855,39,4.690,38,4.570,8277,627,7650,0.775,10.237,5113,1721,3392,2.129,6.324,3164,3.913,12.647,17,18,733
2008,6113,2331,4024,1612984,1592407,300,7.633,113,2.875,93255,5503,87752,0.346,5.856,51859,5127,46732,0.322,3.257,41396,2.600,6.513,56,56,3575
2008,6114,6377,6909,67159,67422,810,11.580,982,14.039,10836,3297,7539,4.890,16.072,11425,5049,6376,7.489,16.946,-589,-0.874,32.144,675,728,3761
2008,6115,6109,7587,122588,120176,761,10.042,744,9.817,20738,5172,15566,4.304,17.256,16063,5348,10715,4.450,13.366,4675,3.890,26.732,528,535,3355
2008,6116,31685,34069,316151,311101,4886,14.593,3713,11.089,65640,23161,42479,7.445,21.099,55830,18830,37000,6.053,17.946,9810,3.153,35.892,2745,2763,12571
2008,6117,5054,5819,78778,75101,895,15.742,628,11.046,17922,6639,11283,8.840,23.864,10313,3584,6729,4.772,13.732,7609,10.132,27.464,456,456,2175
2008,6211,175800,203781,2147133,2122794,15461,7.598,14889,7.317,305328,95645,209683,4.506,14.383,256584,85504,171080,4.028,12.087,48744,2.296,24.174,10410,10630,51245
2008,6212,115457,121702,832651,828900,6789,5.611,5388,4.453,101995,33518,68477,4.044,12.305,94616,25668,68948,3.097,11.415,7379,0.890,22.829,4205,4259,20244
2008,6213,103042,114502,630151,621583,11505,10.119,9893,8.701,118203,41984,76219,6.754,19.016,101476,34304,67172,5.519,16.325,16727,2.691,32.651,6151,6231,19177
2008,6214,13943,29680,677163,662951,2858,9.817,1724,5.922,105996,33938,72058,5.119,15.989,77542,24248,53294,3.658,11.696,28454,4.292,23.393,746,779,8069
2008,6215,7103,12499,242076,239731,1341,10.872,1012,8.205,32925,9642,23283,4.022,13.734,28702,8789,19913,3.666,11.973,4223,1.762,23.945,600,633,4667
2008,6216,15184,22201,1040501,1010859,3429,15.961,1994,9.282,182568,47646,134922,4.713,18.061,123317,39559,83758,3.913,12.199,59251,5.861,24.398,1126,1153,16503
2008,6219,5708,8993,276942,275850,912,10.229,758,8.502,39459,10519,28940,3.813,14.305,37537,10593,26944,3.840,13.608,1922,0.697,27.216,390,408,4197
2008,6221,3050,5210,5135028,5091390,200,3.885,75,1.457,264801,28868,235933,0.567,5.201,182392,45436,136956,0.892,3.582,82409,1.619,7.165,23,23,11321
2008,6222,446,601,210225,210210,41,6.979,14,2.383,12713,2626,10087,1.249,6.048,12508,8378,4130,3.986,5.950,205,0.098,11.900,7,7,4742
2008,6223,402,870,238279,236438,80,9.384,45,5.279,19676,4373,15303,1.850,8.322,16162,7677,8485,3.247,6.836,3514,1.486,13.671,9,9,1176
2008,6231,7832,15583,1574596,1576500,1159,7.475,1002,6.463,139326,54978,84348,3.487,8.838,143182,65126,78056,4.131,9.082,-3856,-0.245,17.675,513,577,38331
2008,6232,8673,32923,619833,608518,2519,7.711,2012,6.159,95369,23604,71765,3.879,15.672,72463,19204,53259,3.156,11.908,22906,3.764,23.816,374,400,4193
2008,6233,13996,19786,774182,757798,1991,10.094,1867,9.466,111009,34455,76554,4.547,14.649,78940,41785,37155,5.514,10.417,32069,4.232,20.834,1231,1262,21738
2008,6239,3384,5801,150945,150502,374,6.399,462,7.904,19177,4190,14987,2.784,12.742,18250,5645,12605,3.751,12.126,927,0.616,24.252,212,222,2478
2008,6241,39514,55342,1228469,1201610,5333,9.757,3961,7.247,184281,42585,141696,3.544,15.336,130556,34494,96062,2.871,10.865,53725,4.471,21.730,2274,2315,15967
2008,6242,10045,13590,169100,167476,659,4.847,673,4.950,22686,4351,18335,2.598,13.546,19280,3945,15335,2.356,11.512,3406,2.034,23.024,301,321,1730
2008,6243,4252,7293,326776,323725,498,6.789,582,7.935,49817,8593,41224,2.654,15.389,43954,12043,31911,3.720,13.578,5863,1.811,27.155,202,233,2392
2008,6244,54666,69306,882298,872391,7783,11.286,7097,10.291,145036,59542,85494,6.825,16.625,125054,47984,77070,5.500,14.335,19982,2.290,28.669,4741,4822,29124
2008,7111,7167,7304,129375,127198,857,11.732,859,11.759,22880,5883,16997,4.625,17.988,18517,4754,13763,3.737,14.558,4363,3.430,29.115,594,594,3546
2008,7112,3355,3540,126644,124729,511,14.398,529,14.906,20158,4498,15660,3.606,16.161,16313,4961,11352,3.977,13.079,3845,3.083,26.158,413,414,3565
2008,7113,5290,5613,130129,127001,686,12.270,642,11.483,23646,5195,18451,4.091,18.619,17524,4158,13366,3.274,13.798,6122,4.820,27.597,445,445,2621
2008,7114,2736,2810,19123,19045,419,14.895,425,15.108,3370,1445,1925,7.587,17.695,3206,1179,2027,6.191,16.834,164,0.861,33.668,293,294,892
2008,7115,13424,13456,43721,43614,2519,18.654,2615,19.365,12369,5530,6839,12.679,28.360,12158,5759,6399,13.204,27.876,211,0.484,55.753,1602,1602,3520
2008,7121,6246,6729,133039,130825,391,5.838,327,4.883,12845,1677,11168,1.282,9.818,8506,1045,7461,0.799,6.502,4339,3.317,13.004,181,181,555
2008,7131,2084,2550,141068,137224,405,15.892,402,15.774,20045,6546,13499,4.770,14.608,12420,6202,6218,4.520,9.051,7625,5.557,18.102,294,296,3714
2008,7132,1716,2340,175276,171692,287,12.500,199,8.667,20228,7866,12362,4.581,11.782,12935,3313,9622,1.930,7.534,7293,4.248,15.068,136,137,2360
2008,7139,50237,56545,1165027,1163908,6623,11.663,7104,12.510,164191,54569,109622,4.688,14.107,160536,61437,99099,5.279,13.793,3655,0.314,27.586,5449,5504,39561
2008,7211,38047,48101,1919512,1907658,5379,11.235,4928,10.293,248990,124525,124465,6.528,13.052,226034,97077,128957,5.089,11.849,22956,1.203,23.698,3414,3479,60370
2008,7212,5252,5770,38788,38880,521,8.977,589,10.148,6799,1943,4856,4.997,17.487,6968,1956,5012,5.031,17.922,-169,-0.435,34.974,351,354,1131
2008,7213,1966,2039,10856,11009,116,5.654,141,6.873,1390,419,971,3.806,12.627,1710,429,1281,3.897,15.533,-320,-2.907,25.253,102,102,266
2008,7223,12134,34762,658818,632903,6470,19.332,3881,11.596,170013,61826,108187,9.769,26.862,121068,33099,87969,5.230,19.129,48945,7.733,38.258,1588,1599,10007
2008,7224,40547,41223,354014,356073,4501,10.781,5556,13.308,72899,36858,36041,10.351,20.473,77029,31721,45308,8.909,21.633,-4130,-1.160,40.946,4524,4536,26779
2008,7225,321160,444102,8900863,8809928,55040,12.467,49823,11.285,1574197,748531,825666,8.496,17.868,1397838,525332,872506,5.963,15.867,176359,2.002,31.733,38311,39173,361510
2008,8111,137497,150204,864976,872693,12861,8.485,15598,10.291,135420,50118,85302,5.743,15.517,150936,55497,95439,6.359,17.295,-15516,-1.778,31.035,11653,11935,42195
2008,8112,10365,11676,124908,123787,1065,9.004,1369,11.574,20992,5265,15727,4.253,16.958,18752,7161,11591,5.785,15.149,2240,1.810,30.297,996,1003,3399
2008,8113,19574,21108,201417,199066,1837,8.660,2044,9.636,32613,8327,24286,4.183,16.383,28161,9992,18169,5.019,14.147,4452,2.236,28.293,1471,1480,5642
2008,8114,17688,18596,80114,81129,2040,10.849,2454,13.051,12222,4520,7702,5.571,15.065,14157,6811,7346,8.395,17.450,-1935,-2.385,30.130,1774,1779,3922
2008,8121,85144,101309,635106,624221,13936,13.846,12622,12.540,141585,65120,76465,10.432,22.682,118708,50961,67747,8.164,19.017,22877,3.665,38.034,9387,9588,35274
2008,8122,14650,19857,135024,135930,839,4.179,1275,6.351,15028,3797,11231,2.793,11.056,17126,5252,11874,3.864,12.599,-2098,-1.543,22.111,531,619,2214
2008,8123,30305,36146,329586,338129,3774,10.357,4360,11.965,47390,19581,27809,5.791,14.015,63275,23276,39999,6.884,18.713,-15885,-4.698,28.031,3182,3318,14352
2008,8129,21260,32459,264306,251770,5682,17.936,4122,13.012,77470,27508,49962,10.926,30.770,52686,22033,30653,8.751,20.926,24784,9.844,41.852,2412,2443,10976
2008,8131,171043,171348,1693707,1687381,8536,4.997,7469,4.373,165662,24709,140953,1.464,9.818,152890,23973,128917,1.421,9.061,12772,0.757,18.122,4719,4719,16108
2008,8132,14139,16111,191817,188395,1283,8.042,968,6.068,19106,3715,15391,1.972,10.141,12275,3536,8739,1.877,6.516,6831,3.626,13.031,640,653,2135
2008,8133,12486,14802,138484,133224,1266,8.632,995,6.784,23645,4344,19301,3.261,17.748,13003,3633,9370,2.727,9.760,10642,7.988,19.521,574,577,1799
2008,8134,24819,26645,259879,258677,1138,4.227,1691,6.281,34113,5544,28569,2.143,13.187,31563,7715,23848,2.982,12.202,2550,0.986,24.403,1125,1142,5314
2008,8139,56120,58268,520029,515525,2847,4.884,2884,4.948,62755,10773,51982,2.090,12.173,53497,11650,41847,2.260,10.377,9258,1.796,20.754,1914,1924,8704
2009,1131,307,321,2131,2281,37,11.437,42,12.983,361,238,123,10.434,15.826,681,441,240,19.334,29.855,-320,-14.029,31.653,29,29,318
2009,1132,116,136,1515,1686,15,10.490,29,20.280,238,56,182,3.322,14.120,599,254,345,15.070,35.538,-361,-21.418,28.241,16,16,122
2009,1133,7482,7604,49247,52986,589,7.420,1256,15.824,5751,1751,4000,3.305,10.854,13147,3820,9327,7.210,24.812,-7396,-13.959,21.708,851,851,2752
2009,1141,1134,1144,5420,5445,203,17.714,207,18.063,1129,482,647,8.852,20.735,1176,531,645,9.752,21.598,-47,-0.863,41.469,122,122,383
2009,1142,255,255,1774,1807,29,11.240,35,13.566,173,69,104,3.820,9.577,239,105,134,5.812,13.230,-66,-3.653,19.153,25,25,44
2009,1151,3354,3676,59145,61123,339,9.151,396,10.690,7432,1891,5541,3.094,12.159,11252,3626,7626,5.932,18.409,-3820,-6.250,24.318,254,254,2600
2009,1152,3615,3712,19518,19725,441,11.825,476,12.763,2959,1342,1617,6.804,15.001,3371,1353,2018,6.859,17.090,-412,-2.089,30.003,380,380,1082
2009,1153,1225,1321,10620,11039,142,10.569,187,13.919,1924,577,1347,5.227,17.430,2736,599,2137,5.426,24.786,-812,-7.356,34.860,117,117,365
2009,2111,5791,7115,107032,105524,747,10.580,638,9.036,17665,6262,11403,5.934,16.740,14730,6069,8661,5.751,13.959,2935,2.781,27.918,369,375,2408
2009,2121,618,1034,83008,81084,150,14.903,95,9.439,14525,4933,9592,6.084,17.914,10540,3451,7089,4.256,12.999,3985,4.915,25.998,50,50,835
2009,2122,203,264,34530,34059,27,10.019,38,14.100,4070,353,3717,1.036,11.950,3028,553,2475,1.624,8.890,1042,3.059,17.781,25,25,372
2009,2123,2975,4982,81278,85763,309,6.075,518,10.184,8689,3163,5526,3.688,10.131,17593,3811,13782,4.444,20.514,-8904,-10.382,20.263,256,261,1964
2009,2131,9241,11345,295652,307455,1366,12.149,1164,10.352,43544,13574,29970,4.415,14.163,67491,15731,51760,5.117,21.952,-23947,-7.789,28.325,745,763,8296
2009,2211,1561,9918,517053,512133,793,8.148,422,4.336,51832,17228,34604,3.364,10.121,42357,11234,31123,2.194,8.271,9475,1.850,16.541,66,107,3217
2009,2212,421,2299,83567,84112,118,5.091,156,6.730,7441,3007,4434,3.575,8.847,8604,2949,5655,3.506,10.229,-1163,-1.383,17.693,27,69,1430
2009,2213,3435,4622,43950,43306,379,8.294,274,5.996,6855,2817,4038,6.505,15.829,5605,1330,4275,3.071,12.943,1250,2.886,25.886,141,144,587
2009,2361,135707,137088,638848,723856,19857,13.483,40240,27.322,120939,53587,67352,7.403,16.708,291508,112870,178638,15.593,40.272,-170569,-23.564,33.415,27792,27805,78476
2009,2362,37553,38844,637222,686046,3030,7.574,5349,13.371,82043,18176,63867,2.649,11.959,179562,30591,148971,4.459,26.173,-97519,-14.215,23.918,3864,3870,21691
2009,2371,17289,18453,503810,526734,1320,6.980,2235,11.819,74570,22386,52184,4.250,14.157,119666,20325,99341,3.859,22.719,-45096,-8.561,28.314,1521,1530,11831
2009,2372,7689,7757,49528,56999,570,6.654,2188,25.543,5285,1809,3476,3.174,9.272,20179,7416,12763,13.011,35.402,-14894,-26.130,18.544,1819,1822,6253
2009,2373,9131,9926,280543,296837,547,5.384,1013,9.971,30222,5818,24404,1.960,10.181,62690,9715,52975,3.273,21.119,-32468,-10.938,20.363,641,643,6721
2009,2379,3703,3864,63389,65991,389,9.797,602,15.162,12305,2845,9460,4.311,18.647,17309,3092,14217,4.686,26.230,-5004,-7.583,37.293,393,394,2326
2009,2381,79994,80810,805767,912069,8085,9.336,19667,22.710,123650,35982,87668,3.945,13.557,336417,81072,255345,8.889,36.885,-212767,-23.328,27.114,12992,12995,56988
2009,2382,156805,160621,1773428,1886245,12948,7.863,21030,12.772,221745,60675,161070,3.217,11.756,447058,89744,357314,4.758,23.701,-225313,-11.945,23.512,14981,15004,63108
2009,2383,96511,97582,715554,798519,10853,10.453,23345,22.484,112765,34465,78300,4.316,14.122,279152,78902,200250,9.881,34.959,-166387,-20.837,28.244,16000,16001,55664
2009,2389,54951,55717,476694,528146,6200,10.543,12375,21.044,73066,26741,46325,5.063,13.834,176007,46761,129246,8.854,33.325,-102941,-19.491,27.669,8286,8289,34092
2009,3111,1078,1657,50376,50487,76,4.535,114,6.802,4560,760,3800,1.505,9.032,4836,815,4021,1.614,9.579,-276,-0.547,18.064,77,77,489
2009,3112,436,762,55745,55134,38,5.020,28,3.699,4362,1223,3139,2.218,7.912,3128,952,2176,1.727,5.674,1234,2.238,11.347,15,17,491
2009,3113,1424,1568,64802,66105,111,7.005,144,9.088,4706,687,4019,1.039,7.119,7501,1200,6301,1.815,11.347,-2795,-4.228,14.238,112,112,775
2009,3114,1175,1541,159329,160278,109,7.078,107,6.948,13607,3643,9964,2.273,8.490,15514,2502,13012,1.561,9.679,-1907,-1.190,16.979,66,66,762
2009,3115,971,1476,138256,136486,94,6.317,118,7.930,12967,2785,10182,2.041,9.501,9418,2911,6507,2.133,6.900,3549,2.600,13.801,73,73,741
2009,3116,2797,3424,498676,501034,173,5.020,217,6.297,28874,5331,23543,1.064,5.763,33985,7629,26356,1.523,6.783,-5111,-1.020,11.526,155,157,4052
2009,3117,485,576,30920,32025,37,6.346,51,8.748,2504,671,1833,2.095,7.819,4665,1283,3382,4.006,14.567,-2161,-6.748,15.638,39,39,849
2009,3118,8529,9249,271284,275351,835,8.980,933,10.034,23759,7122,16637,2.587,8.629,31616,9762,21854,3.545,11.482,-7857,-2.853,17.257,740,750,5240
2009,3119,2520,2953,162098,162763,223,7.479,280,9.391,16508,4275,12233,2.627,10.142,17822,4006,13816,2.461,10.950,-1314,-0.807,20.285,200,201,1665
2009,3121,3082,3648,126469,130921,405,11.300,277,7.729,11492,3790,7702,2.895,8.778,20394,4830,15564,3.689,15.577,-8902,-6.800,17.556,180,181,1198
2009,3122,67,95,17145,18088,4,4.145,7,7.254,388,66,322,0.365,2.145,2258,53,2205,0.293,12.483,-1870,-10.338,4.290,4,4,46
2009,3131,251,349,32119,35683,19,5.256,44,12.172,1120,419,701,1.174,3.139,8133,3150,4983,8.828,22.793,-7013,-19.654,6.278,27,27,462
2009,3132,933,1050,55199,60434,48,4.430,115,10.614,3942,1595,2347,2.639,6.523,13991,3071,10920,5.082,23.151,-10049,-16.628,13.046,81,82,1146
2009,3133,1054,1103,33959,37494,80,7.124,120,10.686,2857,1378,1479,3.675,7.620,9895,2182,7713,5.820,26.391,-7038,-18.771,15.240,90,90,1291
2009,3141,1928,2048,57438,63084,108,5.056,284,13.296,2845,1234,1611,1.956,4.510,14203,2824,11379,4.477,22.515,-11358,-18.005,9.020,213,213,1174
2009,3149,3968,4079,61189,66882,369,8.914,490,11.837,4762,1820,2942,2.721,7.120,16222,3576,12646,5.347,24.255,-11460,-17.135,14.240,354,358,2448
2009,3151,299,318,15896,18037,26,7.784,58,17.365,1235,518,717,2.872,6.847,5553,1693,3860,9.387,30.788,-4318,-23.940,13.694,47,47,763
2009,3152,5509,5590,105096,115562,764,12.965,1370,23.248,16372,8259,8113,7.147,14.167,37395,15058,22337,13.030,32.359,-21023,-18.192,28.335,1162,1163,12053
2009,3159,627,641,10814,11787,50,7.599,84,12.766,754,174,580,1.476,6.397,2690,581,2109,4.929,22.823,-1936,-16.426,12.794,63,63,341
2009,3161,194,198,3500,4108,11,5.392,23,11.275,292,133,159,3.238,7.109,1476,464,1012,11.296,35.934,-1184,-28.825,14.218,17,17,118
2009,3162,198,219,11832,12206,20,8.969,28,12.556,700,159,541,1.303,5.735,1431,243,1188,1.991,11.724,-731,-5.989,11.470,22,22,232
2009,3169,713,725,14070,14676,63,8.451,104,13.950,1709,740,969,5.042,11.645,2994,995,1999,6.780,20.401,-1285,-8.756,23.291,81,81,660
2009,3211,3043,3461,83627,92697,199,5.576,415,11.628,5571,2862,2709,3.087,6.010,23803,6231,17572,6.722,25.678,-18232,-19.668,12.020,282,286,2967
2009,3212,1331,1682,71612,82853,81,4.619,224,12.774,4723,1981,2742,2.391,5.700,27561,4911,22650,5.927,33.265,-22838,-27.565,11.401,129,133,2315
2009,3219,8438,9432,231816,263284,520,5.325,1187,12.155,14771,4685,10086,1.779,5.610,77418,15250,62168,5.792,29.405,-62647,-23.795,11.221,847,853,7495
2009,3221,237,460,116310,119226,14,2.976,35,7.439,4615,1977,2638,1.658,3.871,10579,4622,5957,3.877,8.873,-5964,-5.002,7.742,9,10,1619
2009,3222,2760,4121,264449,276494,120,2.860,270,6.435,14475,4117,10358,1.489,5.235,38487,8500,29987,3.074,13.920,-24012,-8.684,10.470,166,174,3147
2009,3231,27665,29089,547367,581895,1394,4.654,3122,10.423,35336,11701,23635,2.011,6.073,104592,28894,75698,4.966,17.974,-69256,-11.902,12.145,2509,2521,17102
2009,3241,996,2142,99729,101475,145,6.679,203,9.351,5570,1016,4554,1.001,5.489,9027,2960,6067,2.917,8.896,-3457,-3.407,10.978,76,76,640
2009,3251,1371,2413,150427,152125,154,6.334,191,7.855,11010,3350,7660,2.202,7.237,14333,3228,11105,2.122,9.422,-3323,-2.184,14.475,86,88,457
2009,3252,972,1295,88994,94203,64,4.912,80,6.140,5620,1888,3732,2.004,5.966,15871,4731,11140,5.022,16.848,-10251,-10.882,11.932,36,38,883
2009,3253,611,839,29545,29599,60,7.168,56,6.691,2443,459,1984,1.551,8.254,2487,383,2104,1.294,8.402,-44,-0.149,16.507,38,39,218
2009,3254,1424,1846,241702,247484,140,7.611,127,6.904,17025,3212,13813,1.298,6.879,28911,6453,22458,2.607,11.682,-11886,-4.803,13.758,70,70,1145
2009,3255,1376,1743,55881,59288,63,3.539,137,7.697,2828,529,2299,0.892,4.770,9614,2318,7296,3.910,16.216,-6786,-11.446,9.540,85,87,1030
2009,3256,1850,2044,94282,99626,112,5.390,180,8.662,7821,2531,5290,2.541,7.850,18559,5795,12764,5.817,18.629,-10738,-10.778,15.701,119,119,1593
2009,3259,1894,2462,92737,94265,199,8.053,217,8.782,12593,7278,5315,7.721,13.359,15015,4094,10921,4.343,15.929,-2422,-2.569,26.718,155,156,1417
2009,3261,8594,10930,562224,613735,400,3.584,860,7.706,29183,8876,20307,1.446,4.755,132892,29878,103014,4.868,21.653,-103709,-16.898,9.510,544,563,12507
2009,3262,1536,2005,125583,135663,74,3.636,134,6.585,4259,1289,2970,0.950,3.139,24381,4342,20039,3.201,17.972,-20122,-14.832,6.279,77,80,1633
2009,3271,1074,1266,35597,40304,81,6.231,149,11.462,1974,714,1260,1.772,4.898,11389,2163,9226,5.367,28.258,-9415,-23.360,9.796,95,96,938
2009,3272,1475,1773,89131,94864,104,5.686,216,11.810,4918,1220,3698,1.286,5.184,16239,4281,11958,4.513,17.118,-11321,-11.934,10.369,155,155,961
2009,3273,4479,9118,172605,190315,428,4.589,846,9.070,17425,6649,10776,3.494,9.156,52935,9724,43211,5.109,27.814,-35510,-18.659,18.312,278,288,2815
2009,3274,179,315,14130,15408,16,4.848,46,13.939,781,385,396,2.499,5.069,3412,646,2766,4.193,22.144,-2631,-17.076,10.138,26,26,169
2009,3279,2654,3118,67113,72769,198,6.194,355,11.106,5156,2220,2936,3.051,7.085,16507,3275,13232,4.501,22.684,-11351,-15.599,14.171,266,266,2242
2009,3311,372,505,102494,104577,65,12.859,66,13.056,5905,3052,2853,2.918,5.647,10188,966,9222,0.924,9.742,-4283,-4.096,11.293,53,53,455
2009,3312,470,610,38915,41660,35,5.700,43,7.003,2233,467,1766,1.121,5.360,7699,674,7025,1.618,18.481,-5466,-13.121,10.720,32,32,320
2009,3313,424,556,51207,56657,32,5.689,45,8.000,1547,792,755,1.398,2.730,12357,1959,10398,3.458,21.810,-10810,-19.080,5.461,26,26,933
2009,3314,722,924,59328,62208,53,5.705,63,6.781,3817,882,2935,1.418,6.136,9594,2818,6776,4.530,15.423,-5777,-9.287,12.272,33,35,1187
2009,3315,1714,1936,125889,138550,68,3.467,119,6.067,4596,1517,3079,1.095,3.317,30048,2871,27177,2.072,21.688,-25452,-18.370,6.634,84,85,1290
2009,3321,2378,2629,110558,119430,99,3.737,140,5.284,5614,2174,3440,1.820,4.701,23394,3129,20265,2.620,19.588,-17780,-14.887,9.401,92,92,1221
2009,3322,1249,1351,42493,45906,55,3.964,128,9.225,2124,505,1619,1.100,4.627,8859,2488,6371,5.420,19.298,-6735,-14.671,9.254,85,85,393
2009,3323,11965,13020,352460,376906,607,4.591,1011,7.646,25740,8293,17447,2.200,6.829,74552,11919,62633,3.162,19.780,-48812,-12.951,13.659,711,718,6718
2009,3324,1155,1441,86440,90648,57,3.911,90,6.175,5593,1846,3747,2.036,6.170,14131,2583,11548,2.849,15.589,-8538,-9.419,12.340,52,52,1033
2009,3325,597,666,31524,34540,27,3.968,56,8.229,1097,251,846,0.727,3.176,7135,1582,5553,4.580,20.657,-6038,-17.481,6.352,38,38,594
2009,3326,1246,1410,41032,44888,42,2.917,102,7.083,2446,668,1778,1.488,5.449,10147,1887,8260,4.204,22.605,-7701,-17.156,10.898,68,69,1267
2009,3327,22474,22921,352680,374202,1004,4.310,1753,7.525,26768,7814,18954,2.088,7.153,69810,11906,57904,3.182,18.656,-43042,-11.502,14.307,1299,1303,8357
2009,3328,5202,5707,118844,127317,265,4.578,429,7.411,9261,3082,6179,2.421,7.274,26175,5991,20184,4.706,20.559,-16914,-13.285,14.548,300,302,3418
2009,3329,5788,6346,262574,273251,412,6.459,478,7.493,19303,6762,12541,2.475,7.064,40771,6347,34424,2.323,14.921,-21468,-7.857,14.128,324,324,2698
2009,3331,2471,2827,199222,204755,160,5.605,215,7.532,17779,5372,12407,2.624,8.683,28740,4786,23954,2.337,14.036,-10961,-5.353,17.366,152,152,2283
2009,3332,3297,3472,111906,119225,151,4.269,281,7.945,8313,2657,5656,2.229,6.973,23151,4563,18588,3.827,19.418,-14838,-12.445,13.945,195,197,2066
2009,3333,1826,1964,77593,81745,108,5.399,181,9.048,4924,1783,3141,2.181,6.024,13160,3296,9864,4.032,16.099,-8236,-10.075,12.047,125,125,1327
2009,3334,1444,1723,131924,139806,103,5.918,138,7.929,7949,2319,5630,1.659,5.686,24019,5556,18463,3.974,17.180,-16070,-11.494,11.371,76,79,2000
2009,3335,6863,7083,141499,152094,226,3.117,559,7.711,8295,1348,6947,0.886,5.454,29363,5971,23392,3.926,19.306,-21068,-13.852,10.908,409,411,3204
2009,3336,815,1003,104622,107763,56,5.622,42,4.217,7463,2139,5324,1.985,6.925,13936,1869,12067,1.734,12.932,-6473,-6.007,13.851,28,28,413
2009,3339,5281,5898,269728,282268,290,4.873,396,6.654,18050,5342,12708,1.893,6.395,43192,7158,36034,2.536,15.302,-25142,-8.907,12.789,266,270,3257
2009,3341,996,1075,84603,86987,116,10.681,138,12.707,7695,4154,3541,4.775,8.846,12361,2786,9575,3.203,14.210,-4666,-5.364,17.692,104,104,1395
2009,3342,1293,1437,140448,132424,99,6.781,145,9.932,27684,2619,25065,1.978,20.906,13363,3511,9852,2.651,10.091,14321,10.815,20.182,92,92,1944
2009,3343,412,425,12496,13213,28,6.393,54,12.329,827,139,688,1.052,6.259,2309,928,1381,7.023,17.475,-1482,-11.216,12.518,45,45,333
2009,3344,3773,4250,300628,324060,191,4.410,354,8.173,15431,5023,10408,1.550,4.762,62909,13721,49188,4.234,19.413,-47478,-14.651,9.524,230,233,4554
2009,3345,4279,4971,396344,401638,279,5.572,352,7.029,29394,6330,23064,1.576,7.319,39683,9127,30556,2.272,9.880,-10289,-2.562,14.637,211,212,2328
2009,3346,578,598,21473,23314,44,6.984,108,17.143,2145,387,1758,1.660,9.200,5772,3194,2578,13.700,24.758,-3627,-15.557,18.401,77,77,907
2009,3351,988,1085,49321,52319,50,4.570,68,6.216,2923,685,2238,1.309,5.587,8851,1532,7319,2.928,16.918,-5928,-11.331,11.174,47,47,312
2009,3352,236,280,48491,53114,22,7.496,49,16.695,1057,61,996,0.115,1.990,10137,1578,8559,2.971,19.086,-9080,-17.095,3.980,38,38,690
2009,3353,1894,2201,125292,130673,93,4.182,139,6.250,8475,1611,6864,1.233,6.486,19230,4544,14686,3.477,14.716,-10755,-8.230,12.971,79,80,1324
2009,3359,1784,2086,137635,145683,115,5.476,143,6.810,8286,3052,5234,2.095,5.688,24345,4791,19554,3.289,16.711,-16059,-11.023,11.375,84,84,1119
2009,3361,264,331,135695,156777,37,11.078,43,12.874,6396,1565,4831,0.998,4.080,49123,11733,37390,7.484,31.333,-42727,-27.253,8.159,32,32,805
2009,3362,1662,1920,94039,113230,114,5.765,229,11.580,5657,2916,2741,2.575,4.996,43900,6354,37546,5.612,38.771,-38243,-33.775,9.992,164,165,3287
2009,3363,4151,5089,427724,488080,282,5.454,445,8.607,22092,9680,12412,1.983,4.526,142475,24020,118455,4.921,29.191,-120383,-24.665,9.053,260,263,4719
2009,3364,1241,1638,400633,408822,97,5.935,90,5.506,31020,3955,27065,0.967,7.588,46245,3273,42972,0.801,11.312,-15225,-3.724,15.175,60,64,2497
2009,3365,153,230,27618,28507,23,10.245,12,5.345,1572,398,1174,1.396,5.514,3312,846,2466,2.968,11.618,-1740,-6.104,11.029,6,7,264
2009,3366,1367,1487,136696,147222,124,8.026,240,15.534,10456,1545,8911,1.049,7.102,32007,4742,27265,3.221,21.741,-21551,-14.638,14.204,168,168,2044
2009,3369,770,799,44097,46113,80,9.644,141,16.998,3238,851,2387,1.845,7.022,7312,1160,6152,2.516,15.857,-4074,-8.835,14.044,118,118,768
2009,3371,12278,12545,236454,266539,731,5.531,2076,15.706,14114,5708,8406,2.142,5.295,74288,19720,54568,7.399,27.871,-60174,-22.576,10.591,1588,1593,9642
2009,3372,3676,3881,115077,127365,181,4.547,380,9.547,7373,2295,5078,1.802,5.789,31765,6649,25116,5.220,24.940,-24392,-19.151,11.578,297,297,3278
2009,3379,786,901,34259,37682,39,4.189,99,10.634,2147,408,1739,1.083,5.698,9116,2183,6933,5.793,24.192,-6969,-18.494,11.396,61,61,779
2009,3391,10326,11159,302090,305419,684,6.087,839,7.467,25502,4748,20754,1.555,8.350,32613,7593,25020,2.486,10.678,-7111,-2.328,16.700,627,628,3625
2009,3399,15330,15779,291861,311414,1097,6.791,1847,11.434,22411,7906,14505,2.539,7.197,61816,13171,48645,4.229,19.850,-39405,-12.654,14.393,1417,1420,8192
2009,4231,16816,24108,361104,376284,1443,5.880,2306,9.397,32001,12106,19895,3.217,8.504,62337,15662,46675,4.162,16.566,-30336,-8.062,17.009,1494,1549,7980
2009,4232,10416,12101,146565,157764,810,6.490,1568,12.564,13309,4126,9183,2.615,8.436,35724,10200,25524,6.465,22.644,-22415,-14.208,16.872,1129,1189,7382
2009,4233,10902,17696,213011,234271,1105,6.103,1926,10.637,17977,6805,11172,2.905,7.674,60813,16863,43950,7.198,25.958,-42836,-18.285,15.347,1016,1040,6001
2009,4234,22739,32504,697048,706932,3106,9.496,3517,10.752,88475,25714,62761,3.637,12.515,108509,36182,72327,5.118,15.349,-20034,-2.834,25.031,1889,1928,11614
2009,4235,7613,10532,153563,161792,594,5.596,761,7.169,12718,3881,8837,2.399,7.861,29329,6515,22814,4.027,18.128,-16611,-10.267,15.721,496,508,4336
2009,4236,18627,28102,518300,525074,1876,6.595,2560,9.000,70712,19496,51216,3.713,13.467,84206,28198,56008,5.370,16.037,-13494,-2.570,26.934,1450,1508,9645
2009,4237,10591,19238,221758,232352,1146,5.933,1300,6.731,18372,6646,11726,2.860,7.907,39313,8804,30509,3.789,16.920,-20941,-9.013,15.814,584,624,4050
2009,4238,39834,56386,705183,724010,3015,5.306,3890,6.846,66319,22788,43531,3.147,9.160,103992,26773,77219,3.698,14.363,-37673,-5.203,18.320,2355,2496,14187
2009,4239,26596,29637,316330,331420,2751,9.139,3682,12.232,36175,12587,23588,3.798,10.915,66389,19836,46553,5.985,20.032,-30214,-9.117,21.830,2696,2732,12065
2009,4241,8019,10637,155545,162786,571,5.277,939,8.678,10958,4000,6958,2.457,6.732,25264,6590,18674,4.048,15.520,-14306,-8.788,13.463,589,603,3741
2009,4242,5589,8358,274654,274033,957,11.582,767,9.282,46369,8820,37549,3.219,16.921,43921,11280,32641,4.116,16.028,2448,0.893,32.055,491,505,4031
2009,4243,13173,14348,185398,197606,1429,9.720,2136,14.529,20676,6594,14082,3.337,10.463,44810,15653,29157,7.921,22.676,-24134,-12.213,20.926,1609,1645,8060
2009,4244,24142,30825,763629,779317,2723,8.827,2770,8.979,73566,22104,51462,2.836,9.440,105463,23822,81641,3.057,13.533,-31897,-4.093,18.880,1933,1961,13418
2009,4245,3397,5960,60288,60588,264,4.394,360,5.992,7110,1457,5653,2.405,11.735,7688,2210,5478,3.648,12.689,-578,-0.954,23.470,191,206,1437
2009,4246,7966,11946,144950,147163,792,6.535,1138,9.390,15926,5923,10003,4.025,10.822,20655,7065,13590,4.801,14.036,-4729,-3.213,21.644,512,542,2782
2009,4247,4832,7101,103265,104342,309,4.335,364,5.106,9924,2733,7191,2.619,9.511,11976,3027,8949,2.901,11.478,-2052,-1.967,19.022,251,255,2386
2009,4248,3049,3935,177264,178943,328,8.320,343,8.700,17168,6928,10240,3.872,9.594,20274,7360,12914,4.113,11.330,-3106,-1.736,19.188,257,271,4560
2009,4249,20528,26598,335627,346278,2213,8.219,2867,10.648,35615,10746,24869,3.103,10.285,56960,16432,40528,4.745,16.449,-21345,-6.164,20.570,2030,2065,9820
2009,4251,39927,42060,288798,292785,4580,10.683,6202,14.467,41627,17123,24504,5.848,14.218,49562,20353,29209,6.952,16.928,-7935,-2.710,28.435,4568,4588,14185
2009,4411,39290,44090,1047136,1147931,3196,7.052,5652,12.472,63102,29548,33554,2.574,5.497,264436,70994,193442,6.185,23.036,-201334,-17.539,10.994,4499,4551,55741
2009,4412,12889,14652,136069,150131,1020,6.773,1835,12.185,12036,5493,6543,3.659,8.017,40023,9844,30179,6.557,26.659,-27987,-18.642,16.034,1338,1363,6976
2009,4413,27996,54738,463848,470221,2908,5.282,3539,6.428,43631,16215,27416,3.448,9.279,56760,15233,41527,3.240,12.071,-13129,-2.792,18.558,2360,2419,9058
2009,4421,15952,24609,216663,234567,1705,6.713,3284,12.930,20735,11271,9464,4.805,8.840,56615,17405,39210,7.420,24.136,-35880,-15.296,17.679,2200,2558,13633
2009,4422,21727,29684,229248,254933,1795,5.772,4619,14.854,24588,9006,15582,3.533,9.645,77221,34240,42981,13.431,30.291,-52633,-20.646,19.290,2756,3391,25988
2009,4431,25842,47992,465774,478076,4358,8.948,5777,11.862,56855,25558,31297,5.346,11.892,82003,36305,45698,7.594,17.153,-25148,-5.260,23.785,3555,4208,18690
2009,4441,41279,64421,1068767,1118195,2987,4.557,5232,7.982,70961,31645,39316,2.830,6.346,171027,32686,138341,2.923,15.295,-100066,-8.949,12.692,3435,3594,18239
2009,4442,14142,17572,149341,155529,886,4.962,1456,8.154,15195,3998,11197,2.571,9.770,27109,7233,19876,4.651,17.430,-11914,-7.660,19.540,1056,1069,5554
2009,4451,56234,82234,2558001,2561512,8716,10.651,7910,9.666,252560,121406,131154,4.740,9.860,260825,85821,175004,3.350,10.182,-8265,-0.323,19.720,5774,5824,33147
2009,4452,16884,20866,142394,145228,2471,11.710,2941,13.938,27246,11397,15849,7.848,18.761,32846,12935,19911,8.907,22.617,-5600,-3.856,37.522,2286,2297,9567
2009,4453,25245,28964,147119,146189,2675,9.296,2296,7.979,24891,9310,15581,6.368,17.027,22929,7340,15589,5.021,15.685,1962,1.342,31.369,1739,1769,5938
2009,4461,39052,85486,984728,1003068,6088,7.147,5483,6.437,94118,37149,56969,3.704,9.383,131042,28107,102935,2.802,13.064,-36924,-3.681,18.766,3248,3377,14544
2009,4471,61041,107770,855084,875189,7915,7.306,9048,8.352,109664,42661,67003,4.874,12.530,149607,49281,100326,5.631,17.094,-39943,-4.564,25.061,6093,6339,30625
2009,4481,33894,91696,1201521,1246383,7980,8.618,9789,10.571,152880,76607,76273,6.146,12.266,238624,69987,168637,5.615,19.145,-85744,-6.879,24.532,4830,5093,18785
2009,4482,5895,26112,195508,202213,1652,6.180,2888,10.804,26753,13426,13327,6.640,13.230,39638,11790,27848,5.831,19.602,-12885,-6.372,26.460,691,763,2995
2009,4483,16307,24369,137117,144610,1722,6.822,3468,13.739,19080,8160,10920,5.643,13.194,33992,14591,19401,10.090,23.506,-14912,-10.312,26.388,1486,2164,7458
2009,4511,25942,36025,399513,414775,2976,8.103,4376,11.916,47204,20502,26702,4.943,11.381,78763,21957,56806,5.294,18.989,-31559,-7.609,22.761,2917,2999,11507
2009,4512,4795,10076,136153,140867,661,6.435,1054,10.260,10088,5009,5079,3.556,7.161,19350,6016,13334,4.271,13.736,-9262,-6.575,14.323,651,666,2732
2009,4522,80,5150,613172,657795,146,2.783,337,6.425,21091,12035,9056,1.830,3.206,108253,38189,70064,5.806,16.457,-87162,-13.251,6.413,12,188,27431
2009,4523,7044,38471,2297628,2283572,1916,4.964,2163,5.604,166539,38762,127777,1.697,7.293,140668,22295,118373,0.976,6.160,25871,1.133,12.320,1229,1274,6664
2009,4531,15294,16005,75349,82320,1076,6.472,2315,13.925,7888,2963,4925,3.599,9.582,21740,6578,15162,7.991,26.409,-13852,-16.827,19.164,1949,1955,5550
2009,4532,22634,33614,276696,289933,2440,7.063,4306,12.464,25450,9774,15676,3.371,8.778,52551,16598,35953,5.725,18.125,-27101,-9.347,17.556,3268,3321,10980
2009,4533,11353,16146,140886,138536,1446,8.897,1659,10.208,21402,8141,13261,5.876,15.449,16696,5331,11365,3.848,12.052,4706,3.397,24.103,1283,1301,3665
2009,4539,28767,37522,238180,243426,3926,10.376,4559,12.049,35247,16195,19052,6.653,14.480,45027,15112,29915,6.208,18.497,-9780,-4.018,28.959,3472,3546,11681
2009,4541,18646,19722,322716,327712,2788,14.167,2702,13.730,51914,21907,30007,6.685,15.841,62041,20327,41714,6.203,18.932,-10127,-3.090,31.683,2121,2133,10502
2009,4542,3770,4235,38344,42999,374,8.583,619,14.205,3821,1222,2599,2.842,8.886,12892,3580,9312,8.326,29.982,-9071,-21.096,17.773,466,475,1809
2009,4543,21510,27514,198515,205547,2023,7.208,3127,11.142,23597,8256,15341,4.017,11.480,37947,13609,24338,6.621,18.461,-14350,-6.981,22.960,2274,2314,8795
2009,4811,450,2804,402913,423056,174,6.103,268,9.400,12253,2480,9773,0.586,2.896,52123,4395,47728,1.039,12.321,-39870,-9.424,5.793,53,63,1576
2009,4812,1964,2150,35522,37779,290,13.349,335,15.420,4484,1605,2879,4.248,11.869,8939,4345,4594,11.501,23.661,-4455,-11.792,23.738,234,240,3465
2009,4831,699,1017,48088,48126,109,10.840,86,8.553,5115,1603,3512,3.331,10.628,5285,704,4581,1.463,10.982,-170,-0.353,21.257,63,63,571
2009,4832,473,522,19318,19882,65,12.440,66,12.632,1694,596,1098,2.998,8.520,2813,961,1852,4.834,14.149,-1119,-5.628,17.041,45,45,554
2009,4841,45259,54523,879740,916956,8229,14.809,10320,18.572,105866,47677,58189,5.199,11.545,180855,60247,120608,6.570,19.723,-74989,-8.178,23.091,7518,7618,35412
2009,4842,37583,41776,442722,460753,4215,9.765,6994,16.203,59830,21196,38634,4.600,12.985,96612,32155,64457,6.979,20.968,-36782,-7.983,25.971,4854,4895,21316
2009,4851,572,817,48074,48177,69,8.394,79,9.611,5127,1378,3749,2.860,10.642,5371,2766,2605,5.741,11.149,-244,-0.506,21.284,47,47,1489
2009,4852,205,406,13093,14389,65,14.840,129,29.452,2026,1034,992,7.186,14.080,4755,2202,2553,15.303,33.046,-2729,-18.966,28.160,19,19,104
2009,4853,6054,6158,64735,67598,942,15.142,1068,17.168,8931,3993,4938,5.907,13.212,14661,4072,10589,6.024,21.689,-5730,-8.477,26.424,830,830,3008
2009,4854,2801,4389,214264,217189,349,8.005,291,6.674,23531,9644,13887,4.440,10.834,30158,7014,23144,3.229,13.886,-6627,-3.051,21.669,168,170,3384
2009,4855,1130,1246,29116,29853,111,8.876,120,9.596,2954,756,2198,2.532,9.895,4457,1395,3062,4.673,14.930,-1503,-5.035,19.790,84,85,866
2009,4859,2895,3215,67774,66498,530,16.922,364,11.622,12431,4254,8177,6.397,18.694,9878,4072,5806,6.124,14.855,2553,3.839,29.709,300,300,2732
2009,4861,48,389,7642,6942,33,8.594,23,5.990,1670,838,832,12.072,24.058,355,86,269,1.239,5.114,1315,18.944,10.228,4,4,12
2009,4862,113,1673,25425,25568,96,5.701,118,7.007,2677,1164,1513,4.553,10.470,2933,969,1964,3.790,11.472,-256,-1.001,20.941,14,14,82
2009,4869,59,710,8241,8251,45,6.325,48,6.746,758,179,579,2.170,9.187,789,224,565,2.715,9.563,-31,-0.376,18.375,4,4,9
2009,4871,470,513,8653,9031,52,9.821,85,16.053,1108,245,863,2.713,12.269,1852,523,1329,5.791,20.507,-744,-8.238,24.538,66,68,478
2009,4872,1155,1195,10407,10933,152,12.434,207,16.933,1262,407,855,3.723,11.544,2319,678,1641,6.202,21.212,-1057,-9.668,23.087,139,139,431
2009,4879,136,151,2244,2261,25,16.502,26,17.162,606,387,219,17.116,26.802,597,87,510,3.848,26.404,9,0.398,52.808,15,15,66
2009,4881,3737,5375,164296,172400,577,10.790,522,9.762,24583,10392,14191,6.028,14.259,40953,13062,27891,7.577,23.755,-16370,-9.495,28.519,299,307,8937
2009,4882,461,1057,24949,26381,145,14.126,84,8.183,3319,2191,1128,8.305,12.581,6232,1957,4275,7.418,23.623,-2913,-11.042,25.162,28,28,818
2009,4883,1636,2217,85115,88791,175,7.844,203,9.099,9395,2048,7347,2.307,10.581,16577,2094,14483,2.358,18.670,-7182,-8.089,21.162,118,122,1304
2009,4884,8423,9128,75932,76955,1202,13.199,1160,12.737,13743,5893,7850,7.658,17.858,15568,6112,9456,7.942,20.230,-1825,-2.372,35.717,836,889,3999
2009,4885,13436,19432,225671,231536,1553,7.854,2236,11.308,29303,8148,21155,3.519,12.656,40703,14298,26405,6.175,17.580,-11400,-4.924,25.312,1210,1299,6588
2009,4889,1196,1314,24858,26215,203,15.556,185,14.176,2815,1100,1715,4.196,10.738,5670,978,4692,3.731,21.629,-2855,-10.891,21.476,148,148,729
2009,4921,3254,8698,517209,538756,808,9.211,957,10.909,24968,10118,14850,1.878,4.634,70225,6729,63496,1.249,13.035,-45257,-8.400,9.269,406,413,2479
2009,4922,3756,4010,30997,33202,656,16.435,619,15.508,5390,2592,2798,7.807,16.234,9948,3311,6637,9.972,29.962,-4558,-13.728,32.468,504,506,2451
2009,4931,6856,14098,682954,697525,1314,9.328,1290,9.158,85506,36940,48566,5.296,12.258,114864,37082,77782,5.316,16.467,-29358,-4.209,24.517,423,468,7989
2009,5111,13912,20112,589262,631407,1652,8.084,2299,11.250,44093,19475,24618,3.084,6.983,127897,29250,98647,4.633,20.256,-83804,-13.273,13.967,1350,1394,13320
2009,5112,5143,7510,375756,381558,765,10.082,920,12.125,47564,14106,33458,3.697,12.466,59663,23876,35787,6.258,15.637,-12099,-3.171,24.931,395,424,9692
2009,5121,12588,15976,314627,320874,2072,12.831,2416,14.962,39865,15838,24027,4.936,12.424,51715,14540,37175,4.531,16.117,-11850,-3.693,24.848,1537,1576,6780
2009,5122,2798,3039,23599,24108,439,14.256,520,16.886,3196,1586,1610,6.579,13.257,4252,1370,2882,5.683,17.638,-1056,-4.380,26.515,370,370,852
2009,5151,4159,8721,229787,238527,839,9.521,1022,11.597,18408,8590,9818,3.601,7.717,35866,10048,25818,4.213,15.036,-17458,-7.319,15.435,276,290,2254
2009,5152,397,670,41130,41456,118,18.366,63,9.805,5139,2510,2629,6.055,12.396,5819,2105,3714,5.078,14.037,-680,-1.640,24.793,28,28,420
2009,5173,4293,44692,1115883,1121314,6858,15.329,6953,15.541,164451,75895,88556,6.768,14.666,177101,66196,110905,5.903,15.794,-12650,-1.128,29.332,476,564,8806
2009,5174,400,511,8036,8339,65,12.276,102,19.263,1241,282,959,3.382,14.883,1803,890,913,10.673,21.623,-562,-6.740,29.766,69,69,433
2009,5179,4285,4752,57521,59444,784,16.089,1026,21.055,10728,4171,6557,7.017,18.047,14498,5929,8569,9.974,24.390,-3770,-6.342,36.095,770,778,3351
2009,5182,7958,11850,394884,396442,1845,13.958,4582,34.664,67977,34205,33772,8.628,17.147,70540,29708,40832,7.494,17.793,-2563,-0.647,34.294,813,826,8157
2009,5191,5978,7385,139053,139688,1185,16.413,855,11.842,25120,10872,14248,7.783,17.983,26164,7542,18622,5.399,18.730,-1044,-0.747,35.966,538,546,3426
2009,5211,13,48,18775,18894,D,D,D,D,994,D,972,D,5.261,1164,D,1034,D,6.161,-170,-0.900,10.522,0,0,0
2009,5221,14435,126912,2030665,2064529,6515,5.122,7061,5.552,203670,80205,123465,3.885,9.865,271709,75057,196652,3.636,13.161,-68039,-3.296,19.730,477,750,11432
2009,5222,14702,41223,556511,596434,4088,9.248,10049,22.733,95947,32414,63533,5.435,16.087,175654,68926,106728,11.556,29.451,-79707,-13.364,32.174,2712,3077,16154
2009,5223,16446,34183,268661,283477,3126,8.366,9495,25.410,50283,18997,31286,6.701,17.738,79559,36206,43353,12.772,28.065,-29276,-10.327,35.476,6500,7214,25368
2009,5231,11625,42144,485912,505884,7112,17.247,5298,12.848,81622,44350,37272,8.767,16.135,120237,22626,97611,4.473,23.768,-38615,-7.633,32.269,1157,1176,4889
2009,5232,29,83,5430,5924,58,95.082,14,22.951,417,238,179,4.018,7.040,1398,170,1228,2.870,23.601,-981,-16.561,14.080,8,8,38
2009,5239,37263,42622,429176,430625,5592,13.086,5815,13.608,71395,32539,38856,7.556,16.579,75113,23823,51290,5.532,17.443,-3718,-0.863,33.159,3838,3872,14141
2009,5241,5533,32653,1481749,1487046,3707,11.290,4067,12.387,154726,64570,90156,4.342,10.405,165509,49084,116425,3.301,11.130,-10783,-0.725,20.810,631,667,5016
2009,5242,119448,134143,874008,880753,10858,8.031,12980,9.600,118320,43154,75166,4.900,13.434,132321,53259,79062,6.047,15.024,-14001,-1.590,26.868,8691,8804,29114
2009,5259,660,676,7880,8679,179,26.637,171,25.446,2392,1953,439,22.504,27.562,3946,1660,2286,19.128,45.469,-1554,-17.906,55.125,138,139,1329
2009,5311,82674,104386,518802,529273,9158,8.715,10550,10.040,77721,33134,44587,6.260,14.684,98858,38781,60077,7.327,18.678,-21137,-3.994,29.369,7278,7356,25748
2009,5312,60717,70566,290303,314823,9849,13.047,19700,26.096,56097,27671,28426,8.789,17.819,104937,50915,54022,16.173,33.332,-48840,-15.514,35.637,12166,12314,25819
2009,5313,59574,71922,618595,627583,9221,12.750,10019,13.854,98697,44535,54162,7.096,15.727,116455,45297,71158,7.218,18.556,-17758,-2.830,31.453,6686,6712,27439
2009,5321,3831,12770,168509,178374,1205,9.365,1399,10.873,15796,7205,8591,4.039,8.856,35278,12296,22982,6.893,19.778,-19482,-10.922,17.711,551,570,2997
2009,5322,9345,28133,207399,221888,1321,4.542,3227,11.095,21574,7832,13742,3.530,9.723,51471,14495,36976,6.533,23.197,-29897,-13.474,19.446,1283,1344,5919
2009,5323,2669,4099,25724,26775,173,4.154,305,7.323,2676,658,2018,2.458,9.995,4675,1185,3490,4.426,17.461,-1999,-7.466,19.989,223,233,884
2009,5324,7271,13019,154205,159029,1097,8.378,1247,9.523,19628,6145,13483,3.864,12.342,29302,8849,20453,5.564,18.426,-9674,-6.083,24.685,645,714,4494
2009,5331,1979,2083,33159,32898,260,12.425,279,13.333,5230,2300,2930,6.991,15.898,4689,2054,2635,6.244,14.253,541,1.644,28.506,197,197,1001
2009,5411,160469,169980,1168978,1180118,12819,7.486,15351,8.964,125517,40990,84527,3.473,10.636,147872,46882,100990,3.973,12.530,-22355,-1.894,21.272,11073,11149,34432
2009,5412,96051,111335,1281969,1295310,10515,9.466,10009,9.010,198368,61559,136809,4.752,15.314,224343,72233,152110,5.577,17.320,-25975,-2.005,30.629,6199,6239,42711
2009,5413,83707,99810,1361970,1408238,9123,8.978,12740,12.537,179749,66396,113353,4.715,12.764,270833,72322,198511,5.136,19.232,-91084,-6.468,25.528,7921,8016,31039
2009,5414,25972,26239,113960,122945,3108,11.430,5013,18.436,16682,7456,9226,6.065,13.569,34642,11720,22922,9.533,28.177,-17960,-14.608,27.137,3571,3572,8495
2009,5415,86118,101123,1334842,1319112,18094,18.061,16209,16.180,278457,142709,135748,10.819,21.109,249464,104958,144506,7.957,18.912,28993,2.198,37.823,10456,10542,43269
2009,5416,102462,109743,855944,862442,19684,17.901,20114,18.292,179794,81464,98330,9.446,20.847,191432,73774,117658,8.554,22.197,-11638,-1.349,41.694,14135,14242,46926
2009,5417,11692,14433,639022,631224,1777,12.370,1641,11.424,90293,23256,67037,3.684,14.304,74430,20606,53824,3.264,11.791,15863,2.513,23.583,1013,1029,10014
2009,5418,31037,34529,430585,449687,3528,10.005,4993,14.160,56808,23238,33570,5.168,12.633,95280,29044,66236,6.459,21.188,-38472,-8.555,25.266,3563,3589,17054
2009,5419,52409,61900,603921,610302,5603,8.994,6399,10.272,80104,27987,52117,4.586,13.125,92868,29401,63467,4.817,15.217,-12764,-2.091,26.251,4501,4552,20624
2009,5511,26703,50351,2817786,2853174,4357,8.633,4596,9.106,408766,140104,268662,4.910,14.327,479402,123869,355533,4.341,16.802,-70636,-2.476,28.653,993,1124,18573
2009,5611,22949,25013,402120,399003,3324,13.299,3287,13.151,77795,30260,47535,7.584,19.497,71124,27316,43808,6.846,17.825,6671,1.672,35.651,2476,2504,20250
2009,5612,1684,4778,230643,243958,570,10.870,1502,28.642,43887,12542,31345,5.141,17.990,72434,25717,46717,10.542,29.691,-28547,-11.702,35.979,119,126,2966
2009,5613,26062,46892,3879344,4316760,5847,12.177,8099,16.867,611622,192445,419177,4.458,14.169,1495260,329722,1165538,7.638,34.638,-883638,-20.470,28.337,3540,3675,160446
2009,5614,25790,32527,814940,823926,3364,10.220,4141,12.581,159708,73728,85980,8.948,19.384,177836,49532,128304,6.012,21.584,-18128,-2.200,38.768,2844,2899,23798
2009,5615,14074,19886,232690,243689,2379,11.856,2737,13.641,27130,13618,13512,5.588,11.133,49605,15760,33845,6.467,20.356,-22475,-9.223,22.266,1585,1606,7413
2009,5616,17535,23555,794418,810605,2740,11.660,2630,11.191,102286,36052,66234,4.448,12.618,134509,35857,98652,4.423,16.594,-32223,-3.975,25.237,1683,1755,21389
2009,5617,134773,141670,1619779,1660504,19324,13.514,21963,15.360,246332,88248,158084,5.315,14.835,327181,106533,220648,6.416,19.704,-80849,-4.869,29.670,14572,14604,64912
2009,5619,16122,18184,279139,291421,1702,9.269,2059,11.213,45496,12690,32806,4.355,15.612,69180,18488,50692,6.344,23.739,-23684,-8.127,31.224,1466,1469,11738
2009,5621,7183,9331,187464,191148,739,7.860,882,9.380,17269,6385,10884,3.340,9.034,24630,6953,17677,3.637,12.885,-7361,-3.851,18.069,608,622,4627
2009,5622,1319,2436,46838,48201,143,5.825,181,7.373,5760,2375,3385,4.927,11.950,8517,2271,6246,4.712,17.670,-2757,-5.720,23.900,109,110,954
2009,5629,7416,8485,115125,119227,782,9.194,823,9.676,19854,7052,12802,5.915,16.652,27751,7599,20152,6.374,23.276,-7897,-6.624,33.305,544,547,3121
2009,6111,17988,20323,853321,847062,977,4.829,796,3.934,64742,13913,50829,1.643,7.643,52045,10833,41212,1.279,6.144,12697,1.499,12.288,587,597,8270
2009,6112,457,880,87756,85355,53,6.106,29,3.341,10383,1406,8977,1.647,12.165,5597,468,5129,0.548,6.557,4786,5.607,13.115,13,19,342
2009,6113,2351,4133,1664381,1638773,212,5.193,111,2.719,96421,4266,92155,0.260,5.884,46680,2882,43798,0.176,2.848,49741,3.035,5.697,63,63,1190
2009,6114,6253,6769,63255,64618,718,10.462,906,13.201,9519,3040,6479,4.705,14.731,12232,4809,7423,7.442,18.930,-2713,-4.199,29.462,599,610,3213
2009,6115,6010,7423,117978,119260,799,10.700,887,11.879,18917,6957,11960,5.833,15.862,21317,8961,12356,7.514,17.874,-2400,-2.012,31.724,603,621,6444
2009,6116,32442,34934,324132,319210,4665,13.503,3893,11.268,67160,21843,45317,6.843,21.039,56831,19931,36900,6.244,17.804,10329,3.236,35.607,2869,2884,15039
2009,6117,5134,5916,77114,76438,797,13.538,739,12.553,13300,4105,9195,5.370,17.400,12078,4948,7130,6.473,15.801,1222,1.599,31.602,532,533,2560
2009,6211,175249,205084,2198214,2179664,15395,7.522,14546,7.107,301199,100176,201023,4.596,13.819,263893,88772,175121,4.073,12.107,37306,1.712,24.214,10348,10572,58246
2009,6212,116576,123212,840329,837131,6396,5.219,5097,4.159,96151,32207,63944,3.847,11.486,89912,23205,66707,2.772,10.740,6239,0.745,21.481,4180,4222,19567
2009,6213,105717,117754,652629,642791,11643,10.008,8812,7.574,111970,37776,74194,5.877,17.419,92317,31046,61271,4.830,14.362,19653,3.057,28.724,5877,5954,19633
2009,6214,14297,31130,695708,687824,2965,9.710,1775,5.813,91580,35219,56361,5.120,13.314,75292,28186,47106,4.098,10.946,16288,2.368,21.893,824,902,12319
2009,6215,7161,12511,246550,244194,1411,11.267,1435,11.459,34139,12976,21163,5.314,13.980,29440,9836,19604,4.028,12.056,4699,1.924,24.112,631,667,5874
2009,6216,16201,23614,1107931,1073948,3416,14.888,2078,9.056,199652,57976,141676,5.398,18.590,131945,42759,89186,3.981,12.286,67707,6.304,24.572,1291,1361,20128
2009,6219,5725,9043,284190,280840,956,10.607,896,9.941,40372,13910,26462,4.953,14.375,33793,11915,21878,4.243,12.033,6579,2.343,24.066,417,488,5884
2009,6221,3107,5289,5163703,5141515,220,4.194,134,2.554,226985,34760,192225,0.676,4.415,181364,51565,129799,1.003,3.527,45621,0.887,7.055,61,64,28218
2009,6222,462,626,214837,213966,34,5.515,15,2.433,7508,2661,4847,1.244,3.509,5687,1368,4319,0.639,2.658,1821,0.851,5.316,6,6,285
2009,6223,461,934,250018,245129,88,9.644,45,4.932,21251,6723,14528,2.743,8.669,11350,4281,7069,1.746,4.630,9901,4.039,9.260,10,10,1007
2009,6231,7910,15631,1601104,1589483,824,5.280,777,4.978,134410,47638,86772,2.997,8.456,110132,41147,68985,2.589,6.929,24278,1.527,13.858,409,446,26651
2009,6232,8727,32961,632494,625441,1760,5.337,1787,5.419,81300,16915,64385,2.704,12.999,67354,22727,44627,3.634,10.769,13946,2.230,21.538,400,449,10481
2009,6233,14363,20285,792213,783366,1735,8.623,1406,6.988,80878,23671,57207,3.022,10.324,61578,25647,35931,3.274,7.861,19300,2.464,15.721,1004,1029,18032
2009,6239,3481,5868,147815,149362,409,6.983,387,6.607,15208,3803,11405,2.546,10.182,18427,6634,11793,4.442,12.337,-3219,-2.155,20.364,206,221,4346
2009,6241,40771,56863,1278479,1259586,4966,8.828,3745,6.657,170894,36316,134578,2.883,13.567,133245,38353,94892,3.045,10.578,37649,2.989,21.157,2422,2461,28680
2009,6242,10185,13693,172534,170820,659,4.825,591,4.327,20042,4624,15418,2.707,11.733,16506,3904,12602,2.285,9.663,3536,2.070,19.326,282,311,2041
2009,6243,4233,7436,327473,327980,400,5.368,430,5.771,43151,8929,34222,2.722,13.157,43720,7345,36375,2.239,13.330,-569,-0.173,26.313,181,194,2762
2009,6244,55471,70459,871145,877565,7492,10.710,6485,9.270,114375,47583,66792,5.422,13.033,126554,44172,82382,5.033,14.421,-12179,-1.388,26.066,4829,4890,31664
2009,7111,7085,7212,119285,123828,760,10.437,899,12.346,16704,4257,12447,3.438,13.490,25934,7479,18455,6.040,20.944,-9230,-7.454,26.979,630,633,5171
2009,7112,3292,3477,123444,124746,477,13.507,586,16.594,15306,4081,11225,3.271,12.270,18003,4318,13685,3.461,14.432,-2697,-2.162,24.540,451,453,3217
2009,7113,5274,5583,124279,127501,594,10.579,658,11.719,17036,4113,12923,3.226,13.362,23453,5463,17990,4.285,18.394,-6417,-5.033,26.723,462,467,2720
2009,7114,2733,2826,18449,18598,438,15.477,446,15.760,3367,1473,1894,7.920,18.104,3636,1310,2326,7.044,19.550,-269,-1.446,36.208,320,320,955
2009,7115,13246,13280,41656,42735,2441,18.209,2692,20.081,11482,5343,6139,12.503,26.868,13679,5698,7981,13.333,32.009,-2197,-5.141,53.736,1606,1608,3631
2009,7121,6293,6779,128750,131161,333,4.911,336,4.955,8663,1665,6998,1.269,6.605,13247,1292,11955,0.985,10.100,-4584,-3.495,13.210,214,215,928
2009,7131,2096,2526,138967,140626,385,15.125,424,16.657,14798,4542,10256,3.230,10.523,18248,4170,14078,2.965,12.976,-3450,-2.453,21.046,319,321,3262
2009,7132,1702,2404,171397,170804,282,11.891,217,9.150,19166,5584,13582,3.269,11.221,17813,3211,14602,1.880,10.429,1353,0.792,20.858,166,167,1986
2009,7139,49452,56029,1141403,1158917,5763,10.204,6662,11.796,139405,51375,88030,4.433,12.029,175523,51963,123560,4.484,15.145,-36118,-3.117,24.058,5186,5227,40566
2009,7211,38289,48819,1798624,1863815,4807,9.896,4320,8.893,175451,97763,77688,5.245,9.414,307011,69457,237554,3.727,16.472,-131560,-7.059,18.827,3034,3076,43302
2009,7212,5161,5712,37884,38655,444,7.701,551,9.557,5366,1535,3831,3.971,13.882,6987,1736,5251,4.491,18.075,-1621,-4.194,27.764,322,325,1206
2009,7213,1902,1974,10389,10588,119,5.943,176,8.789,1366,378,988,3.570,12.901,1772,705,1067,6.658,16.736,-406,-3.835,25.803,126,132,604
2009,7223,11940,35041,641696,649746,4881,13.979,4631,13.263,143692,59902,83790,9.219,22.115,159175,56660,102515,8.720,24.498,-15483,-2.383,44.230,1706,1726,11476
2009,7224,39866,40552,346957,352021,4182,10.182,5221,12.712,65321,31844,33477,9.046,18.556,75787,30761,45026,8.738,21.529,-10466,-2.973,37.112,4304,4311,26092
2009,7225,322853,447692,8606429,8766555,51586,11.548,49606,11.105,1226760,662704,564056,7.559,13.994,1545832,520122,1025710,5.933,17.633,-319072,-3.640,27.987,39193,40322,381323
2009,8111,134125,146768,804593,835277,11643,7.824,15729,10.570,102434,41224,61210,4.935,12.263,164014,52835,111179,6.325,19.636,-61580,-7.372,24.527,11372,11596,39106
2009,8112,10107,11429,117193,121266,1185,10.236,1480,12.785,16277,5641,10636,4.652,13.423,24574,9248,15326,7.626,20.265,-8297,-6.842,26.845,959,970,3895
2009,8113,18928,20485,192066,197292,1528,7.331,2245,10.771,24178,8265,15913,4.189,12.255,34649,9442,25207,4.786,17.562,-10471,-5.307,24.510,1580,1583,5885
2009,8114,17044,17845,73885,77559,1799,9.840,2673,14.621,11362,4495,6867,5.796,14.650,18623,6310,12313,8.136,24.012,-7261,-9.362,29.299,1871,1873,4304
2009,8121,85714,101917,618997,628030,12462,12.238,12286,12.065,94088,46615,47473,7.422,14.981,111465,45509,65956,7.246,17.748,-17377,-2.767,29.963,9766,9947,37835
2009,8122,14546,19898,134408,134841,774,3.889,784,3.939,14475,3275,11200,2.429,10.735,15251,2656,12595,1.970,11.310,-776,-0.575,21.470,480,492,1807
2009,8123,29779,35210,315796,323012,3114,8.706,4233,11.834,43508,15891,27617,4.920,13.469,58461,20741,37720,6.421,18.099,-14953,-4.629,26.939,2952,3346,16028
2009,8129,21388,31811,246012,253429,3948,12.299,4525,14.097,46309,18325,27984,7.231,18.273,60075,27929,32146,11.020,23.705,-13766,-5.432,36.546,2444,2543,10120
2009,8131,173091,173439,1691016,1697067,8354,4.831,7325,4.236,145092,24216,120876,1.427,8.550,156933,20773,136160,1.224,9.247,-11841,-0.698,17.099,4744,4745,13648
2009,8132,14501,16494,169974,181120,1229,7.518,934,5.714,18728,3706,15022,2.046,10.340,42541,2887,39654,1.594,23.488,-23813,-13.148,20.680,656,658,2053
2009,8133,12752,15118,139617,138691,1257,8.403,940,6.284,19079,4226,14853,3.047,13.756,17391,3284,14107,2.368,12.539,1688,1.217,25.079,559,562,2285
2009,8134,24423,26259,244821,248175,1234,4.686,1383,5.252,27407,6048,21359,2.437,11.043,34154,6994,27160,2.818,13.762,-6747,-2.719,22.087,942,950,5101
2009,8139,55738,57943,507011,512748,2696,4.638,3059,5.263,53389,10600,42789,2.067,10.412,64983,13693,51290,2.671,12.673,-11594,-2.261,20.825,2136,2137,10051
2010,1131,314,326,2062,2095,37,11.473,30,9.302,190,99,91,4.726,9.069,263,72,191,3.437,12.554,-73,-3.484,18.138,16,16,37
2010,1132,120,137,1482,1520,16,11.808,13,9.594,356,49,307,3.225,23.429,414,94,320,6.186,27.246,-58,-3.817,46.858,5,5,23
2010,1133,7230,7330,49970,49478,682,9.141,944,12.652,8647,2210,6437,4.467,17.477,7688,2736,4952,5.530,15.538,959,1.938,31.077,628,631,1927
2010,1141,1182,1193,6044,5764,206,17.539,169,14.389,1476,555,921,9.629,25.607,939,511,428,8.865,16.291,537,9.316,32.582,95,95,235
2010,1142,235,235,1499,1481,22,9.072,37,15.258,279,56,223,3.781,18.839,246,110,136,7.427,16.610,33,2.228,33.221,27,27,84
2010,1151,3327,3674,61042,59689,398,10.843,391,10.652,11532,3173,8359,5.316,19.320,8782,2975,5807,4.984,14.713,2750,4.607,29.426,257,257,2401
2010,1152,3649,3745,18845,19050,451,12.138,392,10.550,2432,1094,1338,5.743,12.767,2878,907,1971,4.761,15.108,-446,-2.341,25.533,289,289,690
2010,1153,1204,1299,10443,10511,153,11.675,176,13.430,1992,579,1413,5.509,18.952,2144,471,1673,4.481,20.398,-152,-1.446,37.903,90,90,251
2010,2111,5754,7042,108214,107845,593,8.401,627,8.882,13949,5039,8910,4.672,12.934,13334,4763,8571,4.417,12.364,615,0.570,24.728,400,404,2050
2010,2121,556,973,80879,81704,80,7.972,141,14.051,11365,2950,8415,3.611,13.910,13088,3396,9692,4.156,16.019,-1723,-2.109,27.820,90,95,1741
2010,2122,207,269,32068,33193,46,17.358,38,14.340,2244,785,1459,2.365,6.761,4612,193,4419,0.581,13.895,-2368,-7.134,13.521,27,27,116
2010,2123,2915,4963,79350,80697,324,6.495,375,7.517,10092,3059,7033,3.791,12.506,12713,2439,10274,3.022,15.754,-2621,-3.248,25.012,184,184,874
2010,2131,9119,11384,286037,292622,1291,11.293,1387,12.133,49894,20543,29351,7.020,17.051,62988,15147,47841,5.176,21.525,-13094,-4.475,34.101,876,878,7381
2010,2211,1623,10172,512904,513220,688,6.872,367,3.666,31541,10448,21093,2.036,6.146,31944,7617,24327,1.484,6.224,-403,-0.079,12.291,49,51,569
2010,2212,426,2422,84821,85333,165,6.942,75,3.155,5888,2594,3294,3.040,6.900,6979,2135,4844,2.502,8.179,-1091,-1.279,13.800,16,16,144
2010,2213,3436,4602,41926,42133,258,5.628,222,4.843,3850,1876,1974,4.453,9.138,4345,924,3421,2.193,10.313,-495,-1.175,18.276,114,114,574
2010,2361,125258,126566,575934,605295,21844,16.578,32239,24.467,135927,63865,72062,10.551,22.456,194786,85910,108876,14.193,32.180,-58859,-9.724,44.913,20728,20759,56960
2010,2362,35652,37173,570151,606734,3552,9.310,5509,14.440,87459,30301,57158,4.994,14.415,161387,27656,133731,4.558,26.599,-73928,-12.185,28.829,3636,3640,18560
2010,2371,16588,17820,470003,487745,1392,7.646,2163,11.881,71640,20302,51338,4.162,14.688,107739,17235,90504,3.534,22.089,-36099,-7.401,29.376,1350,1358,9492
2010,2372,6537,6616,39751,44753,579,8.099,1645,23.010,6036,2253,3783,5.034,13.488,16302,7140,9162,15.954,36.427,-10266,-22.940,26.975,1307,1314,5951
2010,2373,8866,9695,269387,274764,666,6.778,927,9.435,36886,6320,30566,2.300,13.425,47673,6558,41115,2.387,17.351,-10787,-3.926,26.849,597,597,4251
2010,2379,3634,3792,62165,63381,440,11.418,563,14.610,12616,3568,9048,5.629,19.905,15259,2293,12966,3.618,24.075,-2643,-4.170,39.810,334,335,1410
2010,2381,73645,74496,690250,749084,9609,12.385,15792,20.354,131843,41253,90590,5.507,17.601,249631,64888,184743,8.662,33.325,-117788,-15.724,35.201,9672,9688,41435
2010,2382,150241,154166,1610469,1690376,13351,8.487,19640,12.485,217725,57444,160281,3.398,12.880,377866,79904,297962,4.727,22.354,-160141,-9.474,25.761,13130,13145,54500
2010,2383,89283,90282,626149,670897,11897,12.651,19407,20.638,118276,39282,78994,5.855,17.630,207760,59676,148084,8.895,30.968,-89484,-13.338,35.259,12491,12503,41343
2010,2389,50589,51294,436278,451911,6568,12.399,9924,18.734,84246,24374,59872,5.394,18.642,115763,35855,79908,7.934,25.616,-31517,-6.974,37.284,6216,6231,23210
2010,3111,1083,1667,50031,50245,78,4.692,69,4.150,3612,563,3049,1.121,7.189,3975,1073,2902,2.136,7.911,-363,-0.722,14.378,38,38,386
2010,3112,429,767,54675,55060,41,5.359,37,4.837,2749,460,2289,0.835,4.993,3541,785,2756,1.426,6.431,-792,-1.438,9.986,18,18,227
2010,3113,1434,1572,66154,65499,129,8.211,127,8.084,6282,1293,4989,1.974,9.591,5008,1538,3470,2.348,7.646,1274,1.945,15.292,87,87,469
2010,3114,1224,1584,158435,159131,120,7.658,86,5.488,11797,3133,8664,1.969,7.413,13112,2537,10575,1.594,8.240,-1315,-0.826,14.827,54,54,1050
2010,3115,984,1484,136820,137531,87,5.880,78,5.272,8865,1335,7530,0.971,6.446,10355,4226,6129,3.073,7.529,-1490,-1.083,12.892,47,47,587
2010,3116,2813,3404,490756,494411,171,5.015,183,5.367,23739,3319,20420,0.671,4.801,30603,12271,18332,2.482,6.190,-6864,-1.388,9.603,107,108,1421
2010,3117,472,562,31456,31098,35,6.162,47,8.275,4063,923,3140,2.968,13.065,3372,1016,2356,3.267,10.843,691,2.222,21.687,32,32,552
2010,3118,8531,9247,274444,273033,842,9.135,782,8.484,27023,8419,18604,3.084,9.897,23941,6184,17757,2.265,8.769,3082,1.129,17.537,602,605,3354
2010,3119,2516,2960,163256,162549,231,7.840,204,6.923,14141,2727,11414,1.678,8.700,12705,3814,8891,2.346,7.816,1436,0.883,15.632,149,149,1859
2010,3121,3234,3798,125363,125887,420,11.313,249,6.707,10212,2767,7445,2.198,8.112,11340,2268,9072,1.802,9.008,-1128,-0.896,16.224,173,173,1033
2010,3122,76,101,14064,15597,14,14.359,7,7.179,458,73,385,0.468,2.937,3480,1844,1636,11.823,22.313,-3022,-19.376,5.873,D,D,D
2010,3131,239,315,27551,29057,12,3.647,40,12.158,1442,282,1160,0.971,4.963,4298,2453,1845,8.442,14.792,-2856,-9.829,9.925,17,17,244
2010,3132,891,994,51536,54075,54,5.281,111,10.856,3654,799,2855,1.478,6.757,8766,2481,6285,4.588,16.211,-5112,-9.454,13.515,81,84,918
2010,3133,1006,1051,30489,31765,84,7.865,118,11.049,3328,1008,2320,3.173,10.477,5710,2195,3515,6.910,17.976,-2382,-7.499,20.954,84,84,755
2010,3141,1792,1907,54388,56482,112,5.668,250,12.652,4443,865,3578,1.531,7.866,8482,1980,6502,3.506,15.017,-4039,-7.151,15.733,179,179,726
2010,3149,3798,3905,57762,58712,339,8.494,511,12.804,7061,2096,4965,3.570,12.027,8952,2544,6408,4.333,15.247,-1891,-3.221,24.053,387,387,1691
2010,3151,273,289,14210,14846,19,6.355,39,13.043,1235,294,941,1.980,8.319,2439,943,1496,6.352,16.429,-1204,-8.110,16.637,31,32,468
2010,3152,5106,5166,94760,97881,783,14.699,1105,20.743,18262,6311,11951,6.448,18.657,24504,10757,13747,10.990,25.034,-6242,-6.377,37.315,950,954,8489
2010,3159,587,601,9632,10163,47,7.624,78,12.652,865,178,687,1.751,8.511,1927,533,1394,5.245,18.961,-1062,-10.450,17.023,58,58,305
2010,3161,176,181,3498,3504,10,5.291,26,13.757,275,27,248,0.771,7.849,297,88,209,2.512,8.477,-22,-0.628,15.699,21,21,77
2010,3162,180,202,11068,11565,11,5.288,23,11.058,467,44,423,0.380,4.038,1435,88,1347,0.761,12.409,-968,-8.370,8.076,15,15,56
2010,3169,685,693,12262,12951,60,8.578,73,10.436,1017,173,844,1.336,7.853,2334,610,1724,4.710,18.022,-1317,-10.169,15.705,52,52,276
2010,3211,2902,3311,78332,80661,207,6.107,364,10.739,7384,2048,5336,2.539,9.154,12112,4323,7789,5.359,15.016,-4728,-5.862,18.309,236,236,1902
2010,3212,1223,1535,64347,68264,56,3.492,193,12.036,6526,1553,4973,2.275,9.560,14199,4122,10077,6.038,20.800,-7673,-11.240,19.120,123,125,1942
2010,3219,7930,8861,209566,219986,552,6.035,1122,12.268,21223,6222,15001,2.828,9.647,41912,12890,29022,5.859,19.052,-20689,-9.405,19.295,737,743,5878
2010,3221,233,446,111301,113721,26,5.771,35,7.769,3274,1165,2109,1.024,2.879,8198,2978,5220,2.619,7.209,-4924,-4.330,5.758,18,18,219
2010,3222,2704,4042,254583,259292,138,3.379,222,5.436,14790,2495,12295,0.962,5.704,24330,6514,17816,2.512,9.383,-9540,-3.679,11.408,136,136,1609
2010,3231,26319,27676,499575,524969,1382,4.862,2876,10.119,33382,10849,22533,2.067,6.359,84421,26756,57665,5.097,16.081,-51039,-9.722,12.718,2299,2305,15852
2010,3241,1000,2165,99728,100907,167,7.766,138,6.417,6189,2665,3524,2.641,6.133,8808,2159,6649,2.140,8.729,-2619,-2.595,12.267,53,54,338
2010,3251,1331,2373,147452,149157,116,4.861,143,5.992,9335,2466,6869,1.653,6.259,12655,2512,10143,1.684,8.484,-3320,-2.226,12.517,79,79,1115
2010,3252,973,1276,85736,87036,53,4.125,71,5.525,6494,1481,5013,1.702,7.461,9078,1509,7569,1.734,10.430,-2584,-2.969,14.923,37,40,667
2010,3253,603,833,28702,28968,53,6.363,53,6.363,2393,454,1939,1.567,8.261,3011,754,2257,2.603,10.394,-618,-2.133,16.522,35,35,220
2010,3254,1442,1853,232168,234262,134,7.228,136,7.335,16055,4738,11317,2.023,6.853,20117,3536,16581,1.509,8.587,-4062,-1.734,13.707,75,75,917
2010,3255,1332,1674,51478,53312,73,4.277,139,8.143,3387,763,2624,1.431,6.353,7096,1932,5164,3.624,13.310,-3709,-6.957,12.706,85,85,651
2010,3256,1873,2065,91726,92870,142,6.897,130,6.314,9111,3977,5134,4.282,9.810,11208,2429,8779,2.615,12.068,-2097,-2.258,19.621,88,88,1084
2010,3259,1850,2373,85484,87672,133,5.539,189,7.872,6373,1276,5097,1.455,7.269,10791,2735,8056,3.120,12.308,-4418,-5.039,14.538,123,126,1179
2010,3261,8344,10625,549095,556502,441,4.086,778,7.208,49316,11409,37907,2.050,8.862,64451,21077,43374,3.787,11.581,-15135,-2.720,17.724,492,498,7810
2010,3262,1497,1927,118374,122069,79,4.025,150,7.643,8053,1726,6327,1.414,6.597,15494,5703,9791,4.672,12.693,-7441,-6.096,13.194,80,82,896
2010,3271,1037,1224,33906,34668,88,7.048,137,10.973,2930,730,2200,2.106,8.452,4380,920,3460,2.654,12.634,-1450,-4.183,16.903,96,96,405
2010,3272,1418,1693,80132,85482,110,6.340,194,11.182,3718,575,3143,0.673,4.349,14830,4193,10637,4.905,17.349,-11112,-12.999,8.699,128,128,881
2010,3273,4370,8938,154305,163369,378,4.179,594,6.566,15063,3908,11155,2.392,9.220,33165,6067,27098,3.714,20.301,-18102,-11.080,18.441,229,234,2302
2010,3274,179,309,13009,13469,20,6.452,22,7.097,1058,527,531,3.913,7.855,1979,381,1598,2.829,14.693,-921,-6.838,15.710,12,12,45
2010,3279,2558,2995,62695,65280,171,5.552,341,11.071,5127,1346,3781,2.062,7.854,10404,2778,7626,4.256,15.938,-5277,-8.084,15.708,237,239,1310
2010,3311,367,497,97668,100470,46,9.136,59,11.718,4483,1214,3269,1.208,4.462,10103,1244,8859,1.238,10.056,-5620,-5.594,8.924,45,45,252
2010,3312,470,598,35776,36924,34,5.611,50,8.251,2577,406,2171,1.100,6.979,4817,961,3856,2.603,13.046,-2240,-6.067,13.959,29,29,467
2010,3313,402,525,49577,50912,17,3.145,48,8.881,3610,556,3054,1.092,7.091,6308,1216,5092,2.388,12.390,-2698,-5.299,14.181,29,29,360
2010,3314,724,919,55949,57353,60,6.504,67,7.263,3941,840,3101,1.465,6.872,6805,1604,5201,2.797,11.865,-2864,-4.994,13.743,42,42,612
2010,3315,1640,1845,110668,118079,58,3.073,143,7.576,6780,1073,5707,0.909,5.742,21462,5322,16140,4.507,18.176,-14682,-12.434,11.484,86,87,2368
2010,3321,2272,2513,103082,106620,68,2.654,166,6.479,7623,1592,6031,1.493,7.150,14698,3178,11520,2.981,13.785,-7075,-6.636,14.299,105,106,1502
2010,3322,1202,1300,39065,40544,64,4.845,106,8.024,3491,761,2730,1.877,8.611,6441,1178,5263,2.906,15.887,-2950,-7.276,17.221,62,62,417
2010,3323,11438,12434,309606,331442,543,4.248,1238,9.686,22928,5201,17727,1.569,6.918,66577,14447,52130,4.359,20.087,-43649,-13.169,13.835,824,829,6502
2010,3324,1127,1426,81323,84198,69,4.792,97,6.736,6288,2920,3368,3.468,7.468,11984,2666,9318,3.166,14.233,-5696,-6.765,14.936,68,68,691
2010,3325,568,631,27358,29282,29,4.489,59,9.133,1032,136,896,0.464,3.524,4869,1082,3787,3.695,16.628,-3837,-13.104,7.049,39,39,208
2010,3326,1192,1349,38921,39910,52,3.786,101,7.353,3184,768,2416,1.924,7.978,5263,955,4308,2.393,13.187,-2079,-5.209,15.956,70,71,456
2010,3327,21533,21946,325935,339533,915,4.070,1985,8.830,27896,6002,21894,1.768,8.216,55131,12413,42718,3.656,16.237,-27235,-8.021,16.432,1304,1306,7394
2010,3328,5004,5494,109649,114121,209,3.733,418,7.466,9234,1966,7268,1.723,8.091,18150,4322,13828,3.787,15.904,-8916,-7.813,16.183,304,305,2646
2010,3329,5574,6115,244777,253231,316,5.077,535,8.595,17995,3692,14303,1.458,7.106,35063,7159,27904,2.827,13.846,-17068,-6.740,14.212,369,369,3474
2010,3331,2396,2720,172344,185003,135,4.884,223,8.068,8033,2323,5710,1.256,4.342,33492,5863,27629,3.169,18.103,-25459,-13.761,8.684,157,158,1877
2010,3332,3142,3310,98506,104520,160,4.732,302,8.932,7228,1849,5379,1.769,6.915,19191,3829,15362,3.663,18.361,-11963,-11.446,13.831,210,210,2161
2010,3333,1781,1914,73662,76323,110,5.663,167,8.597,5297,1304,3993,1.709,6.940,10558,2826,7732,3.703,13.833,-5261,-6.893,13.881,106,106,618
2010,3334,1460,1724,118098,125109,97,5.591,119,6.859,10173,3374,6799,2.697,8.131,23792,5559,18233,4.443,19.017,-13619,-10.886,16.263,68,69,2033
2010,3335,6517,6718,129859,136192,252,3.656,603,8.747,10371,2705,7666,1.986,7.615,23132,4432,18700,3.254,16.985,-12761,-9.370,15.230,419,420,2752
2010,3336,804,982,91009,96661,46,4.665,54,5.477,4872,1765,3107,1.826,5.040,15974,1987,13987,2.056,16.526,-11102,-11.486,10.081,30,30,343
2010,3339,5121,5760,245630,256837,266,4.564,403,6.914,13744,3321,10423,1.293,5.351,35889,4915,30974,1.914,13.973,-22145,-8.622,10.703,261,262,2034
2010,3341,965,1014,69272,75142,88,8.540,121,11.742,6396,1566,4830,2.084,8.512,18800,4939,13861,6.573,25.019,-12404,-16.507,17.024,84,85,745
2010,3342,1266,1411,112864,126349,95,6.657,127,8.900,5783,2456,3327,1.944,4.577,31494,3442,28052,2.724,24.926,-25711,-20.349,9.154,79,79,1094
2010,3343,423,427,8288,9735,51,11.916,53,12.383,600,292,308,3.000,6.164,3503,1368,2135,14.053,35.985,-2903,-29.822,12.327,32,33,273
2010,3344,3678,4142,280144,289499,230,5.491,323,7.712,23733,5195,18538,1.794,8.198,42362,11800,30562,4.076,14.633,-18629,-6.435,16.396,217,217,3164
2010,3345,4256,4930,385736,391860,303,6.105,369,7.435,27307,4900,22407,1.250,6.969,39121,8781,30340,2.241,9.983,-11814,-3.015,13.937,221,222,2063
2010,3346,540,559,19147,20127,57,9.887,92,15.958,1482,711,771,3.533,7.363,3401,1150,2251,5.714,16.898,-1919,-9.535,14.727,70,72,601
2010,3351,980,1064,45054,47422,74,6.884,96,8.930,2648,799,1849,1.685,5.584,7448,1091,6357,2.301,15.706,-4800,-10.122,11.168,69,69,511
2010,3352,227,269,44884,46661,21,7.623,34,12.341,2104,338,1766,0.724,4.509,5686,1823,3863,3.907,12.186,-3582,-7.677,9.018,22,22,138
2010,3353,1857,2155,111682,117839,80,3.657,145,6.629,5415,949,4466,0.805,4.595,17765,3926,13839,3.332,15.076,-12350,-10.480,9.191,82,82,479
2010,3359,1773,2059,124968,129596,127,6.131,152,7.338,8336,2090,6246,1.613,6.432,17494,4615,12879,3.561,13.499,-9158,-7.067,12.865,86,92,1233
2010,3361,270,332,131442,133653,43,13.011,40,12.103,15634,3125,12509,2.338,11.697,19766,4515,15251,3.378,14.789,-4132,-3.092,23.395,21,21,188
2010,3362,1580,1822,93822,94390,121,6.493,204,10.947,14534,3008,11526,3.187,15.398,16068,6179,9889,6.546,17.023,-1534,-1.625,30.796,134,136,3001
2010,3363,4014,4920,400376,414610,270,5.392,444,8.868,42102,10396,31706,2.507,10.155,70285,21766,48519,5.250,16.952,-28183,-6.797,20.309,268,278,6713
2010,3364,1209,1648,388743,395157,127,7.702,129,7.823,25912,3639,22273,0.921,6.557,39685,5756,33929,1.457,10.043,-13773,-3.485,13.115,78,79,1697
2010,3365,148,219,23914,25817,14,6.378,15,6.834,1768,771,997,2.986,6.848,5612,732,4880,2.835,21.738,-3844,-14.890,13.697,8,8,146
2010,3366,1328,1440,129055,132880,127,8.669,177,12.082,8222,2523,5699,1.899,6.188,16087,3347,12740,2.519,12.106,-7865,-5.919,12.375,134,135,1266
2010,3369,744,773,38434,41493,87,11.055,115,14.612,2335,534,1801,1.287,5.628,8436,1253,7183,3.020,20.331,-6101,-14.704,11.255,82,82,321
2010,3371,11325,11576,211133,222922,781,6.456,1824,15.077,17574,5095,12479,2.286,7.883,41208,13580,27628,6.092,18.485,-23634,-10.602,15.767,1313,1314,7401
2010,3372,3473,3656,100875,108210,174,4.613,406,10.764,7954,1500,6454,1.386,7.351,22497,4967,17530,4.590,20.790,-14543,-13.440,14.701,300,303,2701
2010,3379,760,859,32303,33464,63,7.131,112,12.677,3092,664,2428,1.984,9.240,5432,2531,2901,7.563,16.232,-2340,-6.993,18.480,78,78,1057
2010,3391,10173,11047,284636,291908,688,6.185,841,7.561,21798,4752,17046,1.628,7.467,36518,12537,23981,4.295,12.510,-14720,-5.043,14.935,582,583,3607
2010,3399,14842,15255,271316,280977,1140,7.347,1664,10.724,22234,5542,16692,1.972,7.913,41493,11331,30162,4.033,14.767,-19259,-6.854,15.826,1263,1268,6825
2010,4231,16472,23876,349309,354534,1681,7.009,1899,7.917,33279,11874,21405,3.349,9.387,44120,13341,30779,3.763,12.445,-10841,-3.058,18.773,1241,1325,7361
2010,4232,9977,11655,135861,141285,858,7.214,1336,11.233,13714,4113,9601,2.911,9.707,24619,7620,16999,5.393,17.425,-10905,-7.718,19.413,995,1045,5500
2010,4233,10319,16859,196300,205173,1033,5.972,1907,11.026,20294,6994,13300,3.409,9.891,38292,11509,26783,5.609,18.663,-17998,-8.772,19.782,1055,1115,5998
2010,4234,22317,32327,669350,682589,2850,8.782,3100,9.553,87023,31907,55116,4.674,12.749,113047,29067,83980,4.258,16.562,-26024,-3.813,25.498,1709,1793,9840
2010,4235,7416,10269,139424,145748,526,5.057,790,7.595,10530,3271,7259,2.244,7.225,23198,5674,17524,3.893,15.917,-12668,-8.692,14.450,446,485,3164
2010,4236,17782,27534,485877,499885,2338,8.475,2445,8.863,46331,17087,29244,3.418,9.268,74851,23020,51831,4.605,14.974,-28520,-5.705,18.537,1423,1474,9026
2010,4237,9853,18392,202840,209542,911,4.907,1257,6.771,17421,5850,11571,2.792,8.314,30886,7949,22937,3.794,14.740,-13465,-6.426,16.628,615,655,3066
2010,4238,38956,55539,653353,678652,3163,5.643,4194,7.482,55703,19778,35925,2.914,8.208,105702,26214,79488,3.863,15.575,-49999,-7.367,16.416,2304,2401,12024
2010,4239,26386,29552,309345,313564,3092,10.451,3161,10.684,42612,14075,28537,4.489,13.590,50977,16612,34365,5.298,16.257,-8365,-2.668,27.179,2344,2377,11205
2010,4241,7789,10403,149623,152483,651,6.194,866,8.239,12711,5011,7700,3.286,8.336,18660,4898,13762,3.212,12.237,-5949,-3.901,16.672,536,557,2290
2010,4242,5593,8617,267252,270557,932,10.940,737,8.651,33324,11094,22230,4.100,12.317,40713,16767,23946,6.197,15.048,-7389,-2.731,24.634,460,469,2563
2010,4243,13002,14175,179839,183936,1626,11.388,1833,12.837,23546,7357,16189,4.000,12.801,32048,9369,22679,5.094,17.423,-8502,-4.622,25.602,1425,1457,6703
2010,4244,24105,30845,758557,761388,2469,8.002,2492,8.076,78538,18814,59724,2.471,10.315,82935,24137,58798,3.170,10.893,-4397,-0.577,20.630,1769,1787,13979
2010,4245,3354,5990,62799,61547,365,6.118,317,5.313,8785,2804,5981,4.556,14.274,6363,1778,4585,2.889,10.338,2422,3.935,20.677,160,173,972
2010,4246,7845,11888,138008,141004,746,6.254,828,6.941,12116,3688,8428,2.616,8.593,18132,4779,13353,3.389,12.859,-6016,-4.267,17.185,423,438,1960
2010,4247,4746,7044,106402,108993,329,4.647,402,5.678,8901,2087,6814,1.915,8.167,14269,2698,11571,2.475,13.092,-5368,-4.925,16.333,222,235,1296
2010,4248,3048,3982,175436,176039,338,8.541,289,7.303,13119,4348,8771,2.470,7.452,14529,4262,10267,2.421,8.253,-1410,-0.801,14.905,201,205,2605
2010,4249,20160,26184,323716,329098,2329,8.823,2754,10.433,39097,12140,26957,3.689,11.880,49177,15531,33646,4.719,14.943,-10080,-3.063,23.760,1871,1909,8290
2010,4251,39123,41339,297411,294030,4772,11.411,5735,13.713,66260,32274,33986,10.976,22.535,57854,21626,36228,7.355,19.676,8406,2.859,39.352,4158,4189,15453
2010,4411,37698,42416,1035217,1041170,3246,7.510,4863,11.251,111514,34100,77414,3.275,10.710,123185,55120,68065,5.294,11.831,-11671,-1.121,21.421,3751,3824,43109
2010,4412,12253,13820,121769,129301,979,6.886,1773,12.471,12272,4325,7947,3.345,9.491,27674,8482,19192,6.560,21.403,-15402,-11.912,18.982,1214,1269,6010
2010,4413,27506,54733,471453,467662,2883,5.266,2914,5.323,52013,16699,35314,3.571,11.122,45070,15181,29889,3.246,9.637,6943,1.485,19.275,1872,1952,6914
2010,4421,15035,23588,204639,210630,1620,6.721,2651,10.998,23055,9391,13664,4.459,10.946,35198,12503,22695,5.936,16.711,-12143,-5.765,21.892,1776,1972,9182
2010,4422,20261,28048,221925,226093,1731,5.991,3419,11.834,27909,8142,19767,3.601,12.344,36044,12600,23444,5.573,15.942,-8135,-3.598,24.688,2328,2492,8094
2010,4431,25372,46253,425772,445905,5333,11.325,7009,14.884,66353,28672,37681,6.430,14.881,102682,69669,33013,15.624,23.028,-36329,-8.147,29.761,3050,4441,58079
2010,4441,39641,62398,1061432,1065390,2544,4.011,4599,7.251,84496,17256,67240,1.620,7.931,94263,24530,69733,2.302,8.848,-9767,-0.917,15.862,2916,3038,12602
2010,4442,13764,17260,145347,147406,958,5.495,1308,7.502,16709,4993,11716,3.387,11.335,20960,5004,15956,3.395,14.219,-4251,-2.884,22.671,814,838,2888
2010,4451,57404,83422,2525111,2540787,8558,10.354,7020,8.493,203429,82605,120824,3.251,8.007,235027,57181,177846,2.251,9.250,-31598,-1.244,16.013,5149,5232,26818
2010,4452,16814,20746,142309,142043,2363,11.382,2392,11.522,25126,10684,14442,7.522,17.689,24584,9333,15251,6.571,17.307,542,0.382,34.615,1774,1804,6942
2010,4453,25625,29401,147561,147301,2531,8.671,2110,7.228,21169,8358,12811,5.674,14.371,20736,6554,14182,4.449,14.077,433,0.294,28.155,1617,1645,5154
2010,4461,39056,85904,991020,986663,5744,6.703,5314,6.201,97447,29965,67482,3.037,9.876,88210,26657,61553,2.702,8.940,9237,0.936,17.880,2866,3026,13584
2010,4471,61796,107730,853587,854327,7471,6.925,7792,7.222,116021,41655,74366,4.876,13.580,117595,42548,75047,4.980,13.765,-1574,-0.184,27.161,4862,5171,23739
2010,4481,32970,90837,1205635,1203866,7374,8.079,8256,9.045,176379,68940,107439,5.727,14.651,171391,58286,113105,4.842,14.237,4988,0.414,28.473,4364,5220,25374
2010,4482,5710,25482,196848,196198,1059,4.115,1565,6.081,23128,6796,16332,3.464,11.788,21656,6710,14946,3.420,11.038,1472,0.750,22.076,596,770,2170
2010,4483,16003,23146,127426,132263,1510,6.362,2685,11.313,16287,5260,11027,3.977,12.314,25846,12988,12858,9.820,19.541,-9559,-7.227,24.628,1275,1421,5360
2010,4511,25441,35382,402860,400989,2840,7.950,3522,9.859,52379,14643,37736,3.652,13.062,48136,14773,33363,3.684,12.004,4243,1.058,24.009,2490,2776,10484
2010,4512,4567,9560,121201,128638,560,5.700,1090,11.094,14643,3751,10892,2.916,11.383,29245,6507,22738,5.058,22.734,-14602,-11.351,22.766,560,584,2035
2010,4522,34,5071,604592,608663,86,1.690,121,2.378,28956,8653,20303,1.422,4.757,37961,6986,30975,1.148,6.237,-9005,-1.479,9.515,14,14,63
2010,4523,7073,39342,2186345,2242057,2289,5.882,1441,3.703,90012,34262,55750,1.528,4.015,198807,8615,190192,0.384,8.867,-108795,-4.852,8.029,905,942,3083
2010,4531,14376,15041,70340,72820,1028,6.622,1996,12.857,9557,3851,5706,5.288,13.124,14615,5205,9410,7.148,20.070,-5058,-6.946,26.248,1604,1640,4331
2010,4532,21360,32031,269125,273136,2265,6.902,3834,11.684,30450,8766,21684,3.209,11.148,38505,13979,24526,5.118,14.097,-8055,-2.949,22.297,2729,2939,9543
2010,4533,11546,16566,147288,144220,1726,10.534,1364,8.325,22236,9761,12475,6.768,15.418,16354,4403,11951,3.053,11.340,5882,4.079,22.679,1028,1048,2933
2010,4539,28114,36923,231122,234807,3642,9.772,4335,11.631,32351,14630,17721,6.231,13.778,39780,13347,26433,5.684,16.942,-7429,-3.164,27.555,3043,3154,9567
2010,4541,19139,20205,315282,315176,3095,15.522,2563,12.854,46944,17343,29601,5.503,14.895,47052,14870,32182,4.718,14.929,-108,-0.034,29.789,1977,1991,9176
2010,4542,3584,4062,36493,37230,379,9.140,548,13.216,4408,2106,2302,5.657,11.840,5945,1840,4105,4.942,15.968,-1537,-4.128,23.680,398,422,1287
2010,4543,20990,26911,190823,194965,1999,7.354,2540,9.345,20517,6690,13827,3.431,10.523,28727,9960,18767,5.109,14.734,-8210,-4.211,21.047,1823,1857,7016
2010,4811,422,2621,384371,394516,226,8.344,401,14.805,40494,5252,35242,1.331,10.264,60998,31884,29114,8.082,15.461,-20504,-5.197,20.528,54,56,377
2010,4812,1924,2101,32552,33630,260,12.337,273,12.954,4127,2136,1991,6.351,12.272,6330,2424,3906,7.208,18.822,-2203,-6.551,24.544,200,206,859
2010,4831,670,1030,46227,47402,104,10.107,102,9.913,4541,1585,2956,3.344,9.580,7018,1343,5675,2.833,14.805,-2477,-5.226,19.160,67,68,676
2010,4832,433,493,17192,17995,44,8.791,59,11.788,757,215,542,1.195,4.207,2392,537,1855,2.984,13.293,-1635,-9.086,8.414,41,41,399
2010,4841,43738,52832,842547,861877,7229,13.482,8805,16.421,105668,33744,71924,3.915,12.260,142564,44538,98026,5.168,16.541,-36896,-4.281,24.520,6176,6232,24453
2010,4842,36259,40378,420597,431316,4316,10.492,5829,14.171,59243,20403,38840,4.730,13.735,80418,24292,56126,5.632,18.645,-21175,-4.909,27.471,3902,3935,16069
2010,4851,548,785,47936,48077,65,8.166,87,10.930,5140,3080,2060,6.406,10.691,5449,2014,3435,4.189,11.334,-309,-0.643,21.383,58,58,356
2010,4852,192,375,12690,12159,35,9.198,46,12.089,3140,390,2750,3.208,25.824,1968,896,1072,7.369,16.186,1172,9.639,32.371,17,17,217
2010,4853,6016,6137,63824,64158,966,15.737,969,15.786,9553,4566,4987,7.117,14.890,10321,3832,6489,5.973,16.087,-768,-1.197,29.780,748,748,3093
2010,4854,2748,4324,212085,212717,278,6.389,332,7.630,21018,7830,13188,3.681,9.881,22570,6824,15746,3.208,10.610,-1552,-0.730,19.762,150,150,2254
2010,4855,1136,1254,29883,29683,126,10.032,130,10.350,4001,1151,2850,3.878,13.479,3592,968,2624,3.261,12.101,409,1.378,24.203,98,98,760
2010,4859,3086,3499,73172,71467,566,16.672,358,10.545,11887,4821,7066,6.746,16.633,8557,3245,5312,4.541,11.973,3330,4.659,23.947,272,276,2263
2010,4861,52,428,7905,7824,57,13.801,27,6.538,1354,420,934,5.368,17.306,1180,576,604,7.362,15.082,174,2.224,30.164,D,D,D
2010,4862,117,1843,29275,28855,141,7.801,70,3.873,5620,645,4975,2.235,19.477,4805,499,4306,1.729,16.652,815,2.824,33.304,8,8,51
2010,4869,57,696,7777,8075,29,4.108,49,6.941,1424,127,1297,1.573,17.635,1982,328,1654,4.062,24.545,-558,-6.910,35.269,4,4,49
2010,4871,474,512,8710,8792,75,14.663,74,14.467,1235,341,894,3.879,14.047,1416,623,793,7.086,16.106,-181,-2.059,28.094,52,52,368
2010,4872,1110,1154,9975,10188,155,13.175,200,17.000,1594,506,1088,4.967,15.646,2056,590,1466,5.791,20.181,-462,-4.535,31.292,120,120,368
2010,4879,139,153,1966,2102,22,14.618,17,11.296,296,94,202,4.472,14.082,588,429,159,20.409,27.973,-292,-13.892,28.164,7,7,358
2010,4881,3737,5403,160321,163036,571,10.589,550,10.199,23035,11687,11348,7.168,14.129,28318,8357,19961,5.126,17.369,-5283,-3.240,28.258,294,306,2482
2010,4882,468,1132,25943,26132,149,13.466,98,8.857,3892,2169,1723,8.300,14.894,4375,1316,3059,5.036,16.742,-483,-1.848,29.787,37,38,324
2010,4883,1643,2188,84188,84375,175,8.009,169,7.735,9696,2288,7408,2.712,11.492,10070,1504,8566,1.783,11.935,-374,-0.443,22.983,109,110,668
2010,4884,8417,9227,73090,74258,1162,12.679,1037,11.315,12451,5428,7023,7.310,16.767,14887,6208,8679,8.360,20.048,-2436,-3.280,33.534,771,775,4197
2010,4885,13162,19200,214672,221140,1841,9.504,2183,11.269,28227,9951,18276,4.500,12.764,41140,13116,28024,5.931,18.604,-12913,-5.839,25.529,1175,1250,5937
2010,4889,1173,1294,23894,24314,150,11.477,176,13.466,2393,978,1415,4.022,9.842,3254,1138,2116,4.681,13.384,-861,-3.541,19.685,134,134,594
2010,4921,3149,8188,486675,500827,682,8.077,1193,14.129,22421,5903,16518,1.179,4.477,50372,16570,33802,3.309,10.058,-27951,-5.581,8.954,440,465,3067
2010,4922,3673,3937,30072,30840,499,12.531,589,14.792,5453,2273,3180,7.370,17.682,7011,2347,4664,7.610,22.733,-1558,-5.052,35.363,471,480,2009
2010,4931,6843,14109,668183,675501,1101,7.779,1189,8.401,75657,25841,49816,3.825,11.200,89528,23558,65970,3.487,13.254,-13871,-2.053,22.400,417,451,5623
2010,5111,13400,19351,536641,560679,1282,6.494,2061,10.440,41109,13576,27533,2.421,7.332,88953,19481,69472,3.475,15.865,-47844,-8.533,14.664,1195,1219,7368
2010,5112,5055,7326,372614,374520,627,8.438,837,11.264,42156,21034,21122,5.616,11.256,46288,18229,28059,4.867,12.359,-4132,-1.103,22.512,364,389,5016
2010,5121,12380,15775,294278,299188,2125,13.374,2352,14.803,36505,13687,22818,4.575,12.201,46451,12942,33509,4.326,15.526,-9946,-3.324,24.403,1452,1481,6601
2010,5122,2780,3068,23228,23401,430,14.071,406,13.285,4158,2604,1554,11.128,17.769,4612,1252,3360,5.350,19.709,-454,-1.940,35.538,281,282,902
2010,5151,4102,8945,219182,224316,701,7.939,470,5.323,16150,6156,9994,2.744,7.200,25786,7405,18381,3.301,11.495,-9636,-4.296,14.399,256,259,3432
2010,5152,401,692,42797,42169,76,11.047,68,9.884,6395,2983,3412,7.074,15.165,4917,1148,3769,2.722,11.660,1478,3.505,23.321,35,35,218
2010,5173,4210,43905,1056017,1086148,4500,10.158,5292,11.946,106332,46843,59489,4.313,9.790,164201,66527,97674,6.125,15.118,-57869,-5.328,19.580,384,402,3115
2010,5174,388,501,7599,7789,83,16.550,84,16.750,1307,760,547,9.757,16.780,1701,944,757,12.120,21.838,-394,-5.058,33.560,55,56,393
2010,5179,3921,4367,52342,53873,622,13.918,826,18.483,8787,3086,5701,5.728,16.311,11892,4044,7848,7.507,22.074,-3105,-5.764,32.621,658,667,2710
2010,5182,7905,11876,391430,394739,1450,12.186,1496,12.572,76423,25742,50681,6.521,19.360,82719,26148,56571,6.624,20.955,-6296,-1.595,38.721,694,713,6807
2010,5191,6244,7783,137865,139852,1305,17.151,957,12.577,28947,15073,13874,10.778,20.698,32763,6753,26010,4.829,23.427,-3816,-2.729,41.397,637,638,2811
2010,5211,12,47,18192,18484,D,D,D,D,343,D,338,D,1.856,933,D,874,D,5.048,-590,-3.192,3.711,D,D,D
2010,5221,14000,124165,1982996,2007559,5028,4.005,7762,6.183,207007,47634,159373,2.373,10.311,254229,71866,182363,3.580,12.664,-47222,-2.352,20.623,384,747,10637
2010,5222,13962,39262,519176,538602,4514,11.214,6500,16.147,104684,50192,54492,9.319,19.436,142849,50449,92400,9.367,26.522,-38165,-7.086,38.872,1826,2123,12085
2010,5223,14007,30726,252284,261536,2644,8.143,6130,18.880,39290,14982,24308,5.728,15.023,57674,27103,30571,10.363,22.052,-18384,-7.029,30.046,3610,3896,15557
2010,5231,11590,41219,427845,457010,6001,14.421,6789,16.315,77165,26420,50745,5.781,16.885,134763,40381,94382,8.836,29.488,-57598,-12.603,33.770,971,1020,3595
2010,5232,16,75,4957,5193,D,D,16,20.645,172,D,104,D,3.312,628,45,583,0.867,12.094,-456,-8.782,6.625,8,8,16
2010,5239,37616,43192,436434,434227,5900,13.744,5372,12.514,81758,42743,39015,9.843,18.828,76999,29071,47928,6.695,17.732,4759,1.096,35.465,3575,3619,13374
2010,5241,5449,31198,1418555,1450011,4347,13.610,5830,18.253,147927,65201,82726,4.497,10.202,210702,65353,145349,4.507,14.531,-62775,-4.329,20.404,469,532,4015
2010,5242,118760,133269,850471,862135,10581,7.917,11340,8.485,106992,39962,67030,4.635,12.410,130936,47330,83606,5.490,15.187,-23944,-2.777,24.820,7664,7744,21707
2010,5259,609,624,6397,6155,129,20.204,158,24.745,1423,959,464,15.581,23.119,956,505,451,8.205,15.532,467,7.587,31.064,124,124,336
2010,5311,82541,105184,513551,513570,9495,9.068,8537,8.153,78822,39085,39737,7.610,15.348,78850,28169,50681,5.485,15.353,-28,-0.005,30.696,6040,6112,18147
2010,5312,59364,69704,274333,282072,11475,16.348,12450,17.737,57207,30364,26843,10.765,20.281,71947,34095,37852,12.087,25.507,-14740,-5.226,40.562,7787,7957,16553
2010,5313,59366,73128,609412,613432,9527,13.129,8396,11.571,91640,42936,48704,6.999,14.939,99234,37122,62112,6.052,16.177,-7594,-1.238,29.878,5347,5402,20982
2010,5321,3668,10440,147333,157022,1123,9.699,3401,29.372,17320,8910,8410,5.674,11.030,37507,26782,10725,17.056,23.886,-20187,-12.856,22.061,448,466,1723
2010,5322,8734,25812,191983,199827,1339,4.971,3589,13.324,23039,6507,16532,3.256,11.529,39038,20084,18954,10.051,19.536,-15999,-8.006,23.059,1203,1296,5672
2010,5323,2585,3998,24599,25141,185,4.580,267,6.611,2096,725,1371,2.884,8.337,3151,958,2193,3.811,12.534,-1055,-4.196,16.674,161,165,523
2010,5324,7083,12700,141657,148072,972,7.545,1337,10.378,16894,5968,10926,4.030,11.409,29839,8582,21257,5.796,20.152,-12945,-8.742,22.819,643,653,3252
2010,5331,1980,2065,28650,30298,235,11.347,247,11.927,4098,1553,2545,5.126,13.526,7253,3983,3270,13.146,23.939,-3155,-10.413,27.051,173,173,1509
2010,5411,161002,170846,1148785,1159339,13777,8.083,12992,7.622,120685,46039,74646,3.971,10.410,142565,37240,105325,3.212,12.297,-21880,-1.887,20.820,9304,9384,26144
2010,5412,97329,112812,1269688,1277417,11569,10.314,10271,9.157,204169,83154,121015,6.510,15.983,220369,68101,152268,5.331,17.251,-16200,-1.268,31.966,5909,5964,33709
2010,5413,80302,96657,1285933,1316883,9263,9.447,12059,12.298,161982,57944,104038,4.400,12.300,223762,54206,169556,4.116,16.992,-61780,-4.691,24.601,7058,7169,25968
2010,5414,24476,24738,104499,109678,3106,12.162,4708,18.435,15001,6943,8058,6.330,13.677,25291,10662,14629,9.721,23.059,-10290,-9.382,27.355,3241,3245,7647
2010,5415,86044,103033,1416053,1384781,17713,17.310,16302,15.931,281016,103291,177725,7.459,20.293,218468,76354,142114,5.514,15.776,62548,4.517,31.553,9868,10025,36786
2010,5416,103487,111135,864365,860559,20501,18.539,19397,17.541,177318,78631,98687,9.137,20.605,170251,69135,101116,8.034,19.784,7067,0.821,39.568,13303,13356,39440
2010,5417,11845,14729,641434,646130,1893,12.948,1675,11.457,78942,22780,56162,3.526,12.218,88331,28825,59506,4.461,13.671,-9389,-1.453,24.435,1036,1050,7343
2010,5418,29891,33370,410796,419975,3593,10.570,4838,14.233,57506,25570,31936,6.088,13.693,76647,28818,47829,6.862,18.250,-19141,-4.558,27.385,3439,3481,20132
2010,5419,51787,61082,582072,590465,5524,9.000,6113,9.960,75448,24186,51262,4.096,12.778,92351,32650,59701,5.530,15.640,-16903,-2.863,25.555,3987,4042,16467
2010,5511,26850,50068,2837069,2842990,4115,8.168,4736,9.401,395550,125873,269677,4.427,13.913,406385,115438,290947,4.060,14.294,-10835,-0.381,27.826,913,983,15674
2010,5611,22829,24927,402411,398661,3247,13.064,3103,12.484,69716,25674,44042,6.440,17.488,61557,22427,39130,5.626,15.441,8159,2.047,30.882,2300,2306,15705
2010,5612,1692,5480,240984,235228,1292,25.173,597,11.632,55528,28710,26818,12.205,23.606,42377,14462,27915,6.148,18.015,13151,5.591,36.031,105,105,1339
2010,5613,24387,43514,3981615,3937980,4916,10.898,8105,17.968,907950,194622,713328,4.942,23.056,819255,251813,567442,6.394,20.804,88695,2.252,41.608,3579,3838,112980
2010,5614,25340,32115,766976,793151,3238,10.011,3700,11.439,111615,43285,68330,5.457,14.072,166083,48837,117246,6.157,20.940,-54468,-6.867,28.145,2635,2672,22889
2010,5615,13424,18881,227566,230645,1930,9.959,2925,15.094,32511,9754,22757,4.229,14.096,38453,14062,24391,6.097,16.672,-5942,-2.576,28.191,1379,1435,5587
2010,5616,17388,23413,778707,786771,2553,10.865,2722,11.584,107400,34669,72731,4.406,13.651,123535,39059,84476,4.964,15.702,-16135,-2.051,27.301,1612,1756,12741
2010,5617,134892,142023,1616944,1619931,19530,13.744,19678,13.848,267086,94860,172226,5.856,16.487,274214,87299,186915,5.389,16.928,-7128,-0.440,32.975,12790,12809,57364
2010,5619,15798,17827,256907,266724,1702,9.441,2102,11.660,33352,9807,23545,3.677,12.504,53697,20239,33458,7.588,20.132,-20345,-7.628,25.009,1392,1401,14733
2010,5621,7146,9500,187754,188822,913,9.674,788,8.350,20195,9515,10680,5.039,10.695,22306,7312,14994,3.872,11.813,-2111,-1.118,21.391,532,536,3610
2010,5622,1330,2464,51217,52532,205,8.369,176,7.185,5976,2594,3382,4.938,11.376,8928,3207,5721,6.105,16.995,-2952,-5.619,22.752,84,84,521
2010,5629,7533,8638,116826,117373,777,8.980,807,9.326,20373,6022,14351,5.131,17.357,21640,6281,15359,5.351,18.437,-1267,-1.079,34.715,502,523,4586
2010,6111,17916,20270,851466,853009,870,4.290,886,4.369,60020,13434,46586,1.575,7.036,63019,13819,49200,1.620,7.388,-2999,-0.352,14.073,645,659,8931
2010,6112,452,903,86225,81421,66,7.470,27,3.056,12897,3090,9807,3.795,15.840,3438,684,2754,0.840,4.222,9459,11.617,8.445,19,19,221
2010,6113,2145,3985,1717282,1693850,186,4.679,166,4.176,97070,5560,91510,0.328,5.731,50305,3917,46388,0.231,2.970,46765,2.761,5.940,87,87,2834
2010,6114,6143,6684,62641,62998,756,11.217,868,12.878,10202,4282,5920,6.797,16.194,10916,3584,7332,5.689,17.328,-714,-1.133,32.389,585,595,2482
2010,6115,6045,7664,130853,126333,829,10.949,644,8.506,24618,7861,16757,6.222,19.487,15450,4733,10717,3.746,12.230,9168,7.257,24.459,473,479,3128
2010,6116,33195,36020,336585,330479,5064,14.280,3946,11.128,73083,32159,40924,9.731,22.114,60692,19691,41001,5.958,18.365,12391,3.749,36.730,2829,2846,13204
2010,6117,5336,6101,80341,78909,1046,17.299,937,15.497,15898,6891,9007,8.733,20.147,13105,3596,9509,4.557,16.608,2793,3.540,33.215,529,533,1835
2010,6211,175248,207388,2204461,2202557,15470,7.497,13389,6.489,262694,98811,163883,4.486,11.927,258647,72642,186005,3.298,11.743,4047,0.184,23.486,9416,9628,47262
2010,6212,117697,124679,846167,842355,6183,4.991,4603,3.715,92890,30799,62091,3.656,11.027,85240,21316,63924,2.531,10.119,7650,0.908,20.238,3609,3653,16355
2010,6213,108197,121858,678606,666733,11922,9.937,8167,6.807,110685,42097,68588,6.314,16.601,87320,26609,60711,3.991,13.097,23365,3.504,26.193,5535,5587,16565
2010,6214,14535,32235,713564,706728,2829,8.938,1659,5.242,93321,35300,58021,4.995,13.205,79038,22297,56741,3.155,11.184,14283,2.021,22.367,805,848,8593
2010,6215,7115,12570,248990,247643,1283,10.227,1234,9.836,28390,9220,19170,3.723,11.464,25651,9897,15754,3.996,10.358,2739,1.106,20.716,650,708,5211
2010,6216,17468,25436,1172012,1139153,3705,15.090,1937,7.889,195175,63433,131742,5.568,17.133,129562,35374,94188,3.105,11.374,65613,5.760,22.747,1286,1341,19096
2010,6219,5827,9288,285187,285914,947,10.321,722,7.869,36382,12475,23907,4.363,12.725,38108,13444,24664,4.702,13.328,-1726,-0.604,25.450,343,354,3844
2010,6221,2952,5076,5146526,5144014,85,1.677,71,1.401,159702,29368,130334,0.571,3.105,155882,21070,134812,0.410,3.030,3820,0.074,6.061,38,38,13280
2010,6222,437,611,219463,218328,25,4.122,16,2.638,7730,1711,6019,0.784,3.541,5573,830,4743,0.380,2.553,2157,0.988,5.105,8,8,211
2010,6223,402,891,263273,258664,63,7.192,33,3.767,18263,6414,11849,2.480,7.061,9257,2393,6864,0.925,3.579,9006,3.482,7.158,21,21,492
2010,6231,8077,15670,1625719,1615540,790,5.041,792,5.054,121303,45241,76062,2.800,7.509,100630,31953,68677,1.978,6.229,20673,1.280,12.458,324,342,18248
2010,6232,8784,34618,643628,638493,3036,8.985,1381,4.087,86214,40093,46121,6.279,13.503,75527,13353,62174,2.091,11.829,10687,1.674,23.658,359,416,3789
2010,6233,14804,21162,819554,807053,2081,10.024,1276,6.147,93314,43613,49701,5.404,11.562,68094,23130,44964,2.866,8.437,25220,3.125,16.875,805,818,10145
2010,6239,3360,5695,142488,144783,348,6.034,492,8.531,14840,5362,9478,3.703,10.250,19357,5763,13594,3.980,13.370,-4517,-3.120,20.500,286,301,3210
2010,6241,41266,57872,1336173,1311509,5614,9.783,4641,8.087,195029,55554,139475,4.236,14.871,144448,32970,111478,2.514,11.014,50581,3.857,22.028,2928,3057,17696
2010,6242,10097,13784,177156,175277,847,6.157,792,5.757,22626,6262,16364,3.573,12.909,18647,5687,12960,3.245,10.639,3979,2.270,21.277,529,536,3761
2010,6243,4229,7850,347825,337890,853,11.174,421,5.515,59737,16195,43542,4.793,17.679,39975,6659,33316,1.971,11.831,19762,5.849,23.662,175,189,1619
2010,6244,55675,70932,861421,866088,6981,9.880,6438,9.111,108032,45465,62567,5.249,12.474,116706,37735,78971,4.357,13.475,-8674,-1.002,24.947,4654,4768,26641
2010,7111,6911,7045,116188,117787,727,10.220,864,12.146,16998,5292,11706,4.493,14.431,20035,5345,14690,4.538,17.010,-3037,-2.578,28.862,581,582,4049
2010,7112,3297,3468,120966,121747,474,13.630,493,14.177,12970,3255,9715,2.674,10.653,14695,3126,11569,2.568,12.070,-1725,-1.417,21.306,376,379,2287
2010,7113,5199,5522,127373,126434,586,10.562,638,11.500,19282,5126,14156,4.054,15.251,17648,4815,12833,3.808,13.958,1634,1.292,27.917,452,455,3656
2010,7114,2722,2814,17405,17810,418,14.875,410,14.591,2367,1028,1339,5.772,13.291,3220,1116,2104,6.266,18.080,-853,-4.790,26.581,282,283,794
2010,7115,13201,13233,43389,43364,2387,17.991,2456,18.511,12289,6552,5737,15.109,28.340,12092,5112,6980,11.789,27.885,197,0.454,55.770,1452,1452,3173
2010,7121,6310,6793,126138,127386,328,4.837,303,4.469,10051,3028,7023,2.377,7.890,12706,2602,10104,2.043,9.974,-2655,-2.084,15.780,185,185,1796
2010,7131,2108,2521,147175,143158,367,14.506,385,15.217,19222,3742,15480,2.614,13.427,10927,3093,7834,2.161,7.633,8295,5.794,15.266,279,283,2564
2010,7132,1719,2549,170327,171120,324,13.043,194,7.810,13297,6700,6597,3.915,7.771,14904,3676,11228,2.148,8.710,-1607,-0.939,15.541,152,158,3106
2010,7139,48712,55515,1126142,1134118,5604,10.056,6034,10.827,137388,57203,80185,5.044,12.114,154187,43615,110572,3.846,13.595,-16799,-1.481,24.228,4610,4665,33175
2010,7211,38545,49259,1772839,1787226,4053,8.265,3614,7.370,180854,85030,95824,4.758,10.119,209101,55545,153556,3.108,11.700,-28247,-1.580,20.239,2339,2378,30253
2010,7212,5202,5755,38546,38304,484,8.441,442,7.708,5968,1533,4435,4.002,15.581,5454,1272,4182,3.321,14.239,514,1.342,28.477,263,263,803
2010,7213,1887,1997,10548,10671,158,7.962,133,6.702,1310,543,767,5.089,12.276,1547,304,1243,2.849,14.497,-237,-2.221,24.553,99,99,220
2010,7223,11954,35725,631570,636971,4624,13.072,3921,11.085,101717,50800,50917,7.975,15.969,111576,38996,72580,6.122,17.517,-9859,-1.548,31.938,1518,1601,10019
2010,7224,39409,40143,347010,347272,4033,9.979,4578,11.327,64419,31780,32639,9.151,18.550,64938,27008,37930,7.777,18.699,-519,-0.149,37.100,3715,3720,22729
2010,7225,328807,454670,8504616,8558184,50431,11.172,43872,9.719,1154278,605085,549193,7.070,13.487,1253993,417347,836646,4.877,14.653,-99715,-1.165,26.975,34198,35123,301800
2010,8111,133051,145815,790609,797786,11874,8.112,12981,8.869,107381,42468,64913,5.323,13.460,121531,39930,81601,5.005,15.234,-14150,-1.774,26.920,9181,9327,28591
2010,8112,9986,11354,112771,114524,1133,9.907,1298,11.350,17220,6000,11220,5.239,15.036,20830,9214,11616,8.045,18.188,-3610,-3.152,30.072,898,906,3455
2010,8113,18355,19986,181719,186906,1508,7.435,2101,10.359,23945,9395,14550,5.027,12.811,34455,9035,25420,4.834,18.434,-10510,-5.623,25.623,1409,1410,4320
2010,8114,16829,17600,69984,71251,1886,10.617,2215,12.469,10839,4762,6077,6.683,15.213,13306,5576,7730,7.826,18.675,-2467,-3.462,30.425,1543,1543,3605
2010,8121,86245,102493,625872,621955,12161,11.893,11680,11.423,109681,48175,61506,7.746,17.635,102142,42265,59877,6.796,16.423,7539,1.212,32.845,8971,9089,32540
2010,8122,14555,19875,133888,134183,731,3.675,761,3.826,11948,3086,8862,2.300,8.904,12690,2619,10071,1.952,9.457,-742,-0.553,17.809,415,424,1452
2010,8123,29380,34860,305489,310799,2794,7.969,3200,9.126,32035,12635,19400,4.065,10.307,42589,13603,28986,4.377,13.703,-10554,-3.396,20.615,2417,2473,9263
2010,8129,21702,32212,240774,242353,4809,15.053,4279,13.394,47206,23858,23348,9.844,19.478,49481,25712,23769,10.609,20.417,-2275,-0.939,38.956,2177,2195,10004
2010,8131,174556,174901,1686482,1687694,8886,5.099,7621,4.373,154420,28039,126381,1.661,9.150,157211,21170,136041,1.254,9.315,-2791,-0.165,18.300,4789,4791,13590
2010,8132,14841,16805,167547,169373,1215,7.271,1027,6.146,16550,5604,10946,3.309,9.771,20269,4211,16058,2.486,11.967,-3719,-2.196,19.543,680,691,2451
2010,8133,13073,15455,141583,141508,1224,7.969,1032,6.719,17758,4220,13538,2.982,12.549,17590,3948,13642,2.790,12.430,168,0.119,24.861,666,703,2859
2010,8134,24106,25953,238525,241140,1111,4.257,1405,5.383,25701,6025,19676,2.499,10.658,30873,5824,25049,2.415,12.803,-5172,-2.145,21.316,943,944,3718
2010,8139,55977,58200,497532,501694,2966,5.108,2695,4.641,49329,11461,37868,2.284,9.832,57666,10039,47627,2.001,11.494,-8337,-1.662,19.665,1866,1873,7034
2011,1131,318,332,2021,2000,36,10.876,34,10.272,270,95,175,4.750,13.500,213,75,138,3.750,10.650,57,2.850,21.300,28,28,61
2011,1132,125,143,1550,1517,20,14.286,14,10.000,353,82,271,5.405,23.270,276,21,255,1.384,18.194,77,5.076,36.388,7,7,9
2011,1133,7148,7248,49718,49844,745,10.212,839,11.501,7626,2243,5383,4.500,15.300,7845,2686,5159,5.389,15.739,-219,-0.439,30.599,595,595,1989
2011,1141,1147,1158,6053,5992,201,17.121,233,19.847,1322,480,842,8.011,22.063,1148,569,579,9.496,19.159,174,2.904,38.318,129,129,317
2011,1142,236,236,1494,1493,29,12.367,26,11.087,226,88,138,5.896,15.142,237,53,184,3.551,15.879,-11,-0.737,30.285,20,20,30
2011,1151,3356,3706,63069,62263,392,10.600,376,10.168,9425,2461,6964,3.953,15.138,7820,2137,5683,3.432,12.560,1605,2.578,25.119,243,243,1371
2011,1152,3600,3699,19043,19062,424,11.384,475,12.753,2756,1048,1708,5.498,14.458,2812,1181,1631,6.196,14.752,-56,-0.294,28.916,361,361,942
2011,1153,1218,1309,10631,10603,178,13.666,165,12.668,2309,923,1386,8.705,21.777,2277,666,1611,6.281,21.475,32,0.302,42.950,93,93,438
2011,2111,5789,7160,114172,110972,707,9.962,581,8.187,19303,6649,12654,5.992,17.395,12884,3888,8996,3.504,11.610,6419,5.784,23.220,379,386,1544
2011,2121,542,982,84980,83518,105,10.709,102,10.403,10597,3044,7553,3.645,12.688,7612,1839,5773,2.202,9.114,2985,3.574,18.229,64,70,1036
2011,2122,237,297,34867,33476,46,16.140,22,7.719,4696,455,4241,1.359,14.028,1861,158,1703,0.472,5.559,2835,8.469,11.119,18,18,145
2011,2123,2860,4911,79273,79437,297,6.018,345,6.991,8543,1715,6828,2.159,10.754,8827,2293,6534,2.887,11.112,-284,-0.358,21.509,204,210,1373
2011,2131,9519,11895,335449,310782,1654,14.210,1144,9.828,90426,21462,68964,6.906,29.096,40742,12300,28442,3.958,13.110,49684,15.987,26.219,739,742,6210
2011,2211,1665,10076,514980,515267,646,6.391,709,7.015,38683,14640,24043,2.841,7.507,39557,14141,25416,2.744,7.677,-874,-0.170,15.015,49,51,356
2011,2212,432,2499,85439,85185,134,5.379,118,4.737,6513,2129,4384,2.499,7.646,5910,1215,4695,1.426,6.938,603,0.708,13.876,21,21,253
2011,2213,3406,4569,41861,42015,210,4.578,246,5.363,2968,855,2113,2.035,7.064,3208,915,2293,2.178,7.635,-240,-0.571,14.128,128,134,424
2011,2361,118714,119973,530943,548047,22451,18.340,27336,22.331,124938,57726,67212,10.533,22.797,159115,71505,87610,13.047,29.033,-34177,-6.236,45.594,17314,17354,46593
2011,2362,36166,37586,555231,568445,4237,11.131,5192,13.640,99416,24042,75374,4.229,17.489,125333,29122,96211,5.123,22.048,-25917,-4.559,34.978,3392,3409,16906
2011,2371,16304,17751,475681,475058,1733,9.707,1936,10.844,90308,18802,71506,3.958,19.010,88077,16630,71447,3.501,18.540,2231,0.470,37.081,1246,1251,8725
2011,2372,5901,5981,34564,36640,572,9.091,1194,18.976,4945,1682,3263,4.591,13.496,9118,3705,5413,10.112,24.885,-4173,-11.389,26.992,918,921,2715
2011,2373,8655,9495,259748,265126,668,6.942,922,9.582,35771,5069,30702,1.912,13.492,46419,7428,38991,2.802,17.508,-10648,-4.016,26.984,558,563,4266
2011,2379,3563,3706,63018,62681,417,11.119,506,13.492,14464,2560,11904,4.084,23.076,13819,3796,10023,6.056,22.047,645,1.029,44.093,300,300,1958
2011,2381,70134,70993,644896,667117,9995,13.734,13563,18.636,138386,36480,101906,5.468,20.744,181986,54710,127276,8.201,27.279,-43600,-6.536,41.488,8272,8280,37156
2011,2382,148068,152014,1580239,1596737,14709,9.605,16954,11.071,245891,51914,193977,3.251,15.400,279347,65671,213676,4.113,17.495,-33456,-2.095,30.799,11566,11598,46977
2011,2383,86103,87113,592007,608857,12783,14.397,16139,18.176,124035,37067,86968,6.088,20.372,157594,48533,109061,7.971,25.884,-33559,-5.512,40.744,10310,10327,33568
2011,2389,49201,49903,432745,434987,6964,13.741,8521,16.813,91994,23333,68661,5.364,21.149,96653,30154,66499,6.932,22.220,-4659,-1.071,42.297,5240,5253,20644
2011,3111,1076,1663,49991,50154,78,4.680,85,5.101,3740,788,2952,1.571,7.457,4032,799,3233,1.593,8.039,-292,-0.582,14.914,53,53,310
2011,3112,428,759,53216,53243,35,4.611,35,4.611,3249,590,2659,1.108,6.102,3313,713,2600,1.339,6.222,-64,-0.120,12.205,25,25,215
2011,3113,1445,1580,68751,68447,124,7.878,112,7.116,6006,1064,4942,1.554,8.775,5357,888,4469,1.297,7.826,649,0.948,15.653,79,79,560
2011,3114,1211,1570,154908,154797,90,5.734,89,5.671,11567,1633,9934,1.055,7.472,11275,2406,8869,1.554,7.284,292,0.189,14.567,54,54,1406
2011,3115,982,1484,135939,136127,86,5.803,82,5.533,8116,1367,6749,1.004,5.962,8505,1317,7188,0.967,6.248,-389,-0.286,11.924,60,60,552
2011,3116,2810,3401,486104,488303,187,5.497,189,5.556,28936,4918,24018,1.007,5.926,33361,7629,25732,1.562,6.832,-4425,-0.906,11.852,133,134,2985
2011,3117,455,547,31299,31427,33,5.925,53,9.515,2865,551,2314,1.753,9.117,3097,843,2254,2.682,9.855,-232,-0.738,18.233,35,35,485
2011,3118,8845,9571,279213,278312,998,10.550,776,8.203,27029,7215,19814,2.592,9.712,25168,6849,18319,2.461,9.043,1861,0.669,18.086,602,602,4519
2011,3119,2637,3078,162464,163138,290,9.601,175,5.794,13172,3603,9569,2.209,8.074,14530,3774,10756,2.313,8.907,-1358,-0.832,16.148,124,124,1497
2011,3121,3489,4073,129421,127415,544,13.809,277,7.031,16663,4749,11914,3.727,13.078,12558,3794,8764,2.978,9.856,4105,3.222,19.712,191,193,1117
2011,3122,94,117,15020,14550,23,21.005,8,7.306,1823,173,1650,1.189,12.529,912,118,794,0.811,6.268,911,6.261,12.536,6,6,32
2011,3131,246,322,27179,27354,24,7.524,18,5.643,2312,783,1529,2.862,8.452,2698,816,1882,2.983,9.863,-386,-1.411,16.904,14,14,131
2011,3132,871,965,51979,51544,54,5.533,76,7.787,5246,702,4544,1.362,10.178,4376,1256,3120,2.437,8.490,870,1.688,16.980,54,54,505
2011,3133,986,1029,30629,30785,74,7.126,93,8.955,3007,636,2371,2.066,9.768,3243,999,2244,3.245,10.534,-236,-0.767,19.535,71,71,581
2011,3141,1718,1841,53183,53609,140,7.495,194,10.385,4445,973,3472,1.815,8.292,5376,1615,3761,3.013,10.028,-931,-1.737,16.583,142,142,1047
2011,3149,3731,3840,59045,58874,323,8.309,418,10.752,7694,1626,6068,2.762,13.069,7380,2305,5075,3.915,12.535,314,0.533,25.070,316,316,1500
2011,3151,266,281,13130,13321,20,7.055,25,8.818,1040,105,935,0.788,7.807,1419,233,1186,1.749,10.652,-379,-2.845,15.614,20,20,201
2011,3152,4940,4995,88696,91111,799,15.776,938,18.521,15338,6794,8544,7.457,16.835,20117,9116,11001,10.005,22.080,-4779,-5.245,33.669,808,809,7662
2011,3159,564,576,9120,9387,45,7.653,69,11.735,925,193,732,2.056,9.854,1459,615,844,6.552,15.543,-534,-5.689,19.708,52,52,243
2011,3161,180,188,3729,3728,15,8.086,10,5.391,356,43,313,1.153,9.549,339,132,207,3.541,9.093,17,0.456,18.187,7,7,26
2011,3162,185,206,11555,11295,21,10.244,19,9.268,1323,118,1205,1.045,11.714,823,190,633,1.682,7.287,500,4.427,14.573,14,14,57
2011,3169,646,654,13121,12726,57,8.488,92,13.701,2401,430,1971,3.379,18.868,1523,816,707,6.412,11.968,878,6.900,23.936,74,74,288
2011,3211,2859,3248,79371,78763,218,6.655,273,8.335,9006,1818,7188,2.308,11.434,7751,2988,4763,3.794,9.841,1255,1.593,19.682,181,181,1264
2011,3212,1149,1440,61514,62920,62,4.164,160,10.745,5415,1044,4371,1.659,8.606,8033,3325,4708,5.284,12.767,-2618,-4.161,17.212,97,98,1409
2011,3219,7665,8587,204862,207199,579,6.639,847,9.712,22342,5166,17176,2.493,10.783,27040,8985,18055,4.336,13.050,-4698,-2.267,21.566,616,628,5491
2011,3221,214,431,110963,111111,9,2.050,25,5.695,4219,952,3267,0.857,3.797,4630,2025,2605,1.823,4.167,-411,-0.370,7.594,15,15,372
2011,3222,2647,3961,251086,252549,141,3.520,230,5.742,17794,4109,13685,1.627,7.046,20648,8960,11688,3.548,8.176,-2854,-1.130,14.092,134,136,2163
2011,3231,25342,26654,481125,490693,1499,5.514,2563,9.428,36895,8455,28440,1.723,7.519,55853,21207,34646,4.322,11.382,-18958,-3.864,15.038,2028,2041,12629
2011,3241,972,2113,98229,98691,108,5.061,150,7.029,5468,1235,4233,1.251,5.541,6464,1081,5383,1.095,6.550,-996,-1.009,11.081,69,69,427
2011,3251,1307,2380,155294,152691,134,5.633,132,5.549,12173,3143,9030,2.058,7.972,6856,1791,5065,1.173,4.490,5317,3.482,8.980,79,80,852
2011,3252,959,1270,86529,86258,51,4.003,59,4.631,7410,1417,5993,1.643,8.591,6878,1356,5522,1.572,7.974,532,0.617,15.948,40,42,774
2011,3253,613,852,27916,28399,70,8.255,62,7.311,1990,582,1408,2.049,7.007,2999,716,2283,2.521,10.560,-1009,-3.553,14.015,39,41,306
2011,3254,1484,1932,228251,229831,165,8.668,108,5.674,16400,4473,11927,1.946,7.136,19570,1517,18053,0.660,8.515,-3170,-1.379,14.271,83,83,639
2011,3255,1299,1636,52577,52212,71,4.290,109,6.586,4627,1021,3606,1.955,8.862,3874,1287,2587,2.465,7.420,753,1.442,14.840,74,77,588
2011,3256,1907,2095,91449,91654,158,7.571,142,6.804,7172,1342,5830,1.464,7.825,7729,2258,5471,2.464,8.433,-557,-0.608,15.650,106,106,1531
2011,3259,1804,2318,83176,84565,146,6.235,193,8.243,7207,1229,5978,1.453,8.522,9890,3434,6456,4.061,11.695,-2683,-3.173,17.045,113,122,879
2011,3261,8262,10498,562577,555425,460,4.354,594,5.622,58443,9576,48867,1.724,10.522,44089,14573,29516,2.624,7.938,14354,2.584,15.876,376,382,6003
2011,3262,1480,1896,122963,120492,78,4.084,106,5.550,11166,901,10265,0.748,9.267,6263,2123,4140,1.762,5.198,4903,4.069,10.396,69,69,734
2011,3271,992,1175,33837,33727,80,6.683,124,10.359,3285,625,2660,1.853,9.740,3139,430,2709,1.275,9.307,146,0.433,18.614,92,92,333
2011,3272,1385,1658,80656,80386,108,6.452,140,8.363,6595,867,5728,1.079,8.204,6002,1576,4426,1.961,7.467,593,0.738,14.933,96,96,436
2011,3273,4238,8689,148167,151461,341,3.866,604,6.848,13995,2399,11596,1.584,9.240,20564,4627,15937,3.055,13.577,-6569,-4.337,18.480,234,265,2156
2011,3274,174,298,12145,12550,16,5.281,26,8.581,523,71,452,0.566,4.167,1339,371,968,2.956,10.670,-816,-6.502,8.335,14,14,96
2011,3279,2517,2952,64227,63783,197,6.609,255,8.554,6883,1282,5601,2.010,10.791,5925,1931,3994,3.027,9.289,958,1.502,18.579,179,179,1288
2011,3311,338,474,102323,99952,39,8.202,42,8.833,6604,563,6041,0.563,6.607,1868,332,1536,0.332,1.869,4736,4.738,3.738,35,35,249
2011,3312,506,639,40106,38467,57,9.120,29,4.640,5743,1635,4108,4.250,14.930,2488,473,2015,1.230,6.468,3255,8.462,12.936,16,16,154
2011,3313,400,523,51241,50455,32,6.119,32,6.119,5617,794,4823,1.574,11.133,4155,1272,2883,2.521,8.235,1462,2.898,16.470,24,25,395
2011,3314,732,921,57832,56841,53,5.780,45,4.907,5366,638,4728,1.122,9.440,3358,1021,2337,1.796,5.908,2008,3.533,11.815,27,27,502
2011,3315,1620,1824,119845,115372,67,3.647,93,5.063,15253,724,14529,0.628,13.221,6423,1878,4545,1.628,5.567,8830,7.654,11.134,65,66,839
2011,3321,2244,2479,107397,104543,91,3.654,114,4.577,12347,1090,11257,1.043,11.810,6622,1974,4648,1.888,6.334,5725,5.476,12.668,73,73,760
2011,3322,1186,1284,40510,39922,71,5.508,81,6.284,3780,860,2920,2.154,9.469,2601,621,1980,1.556,6.515,1179,2.953,13.031,62,64,406
2011,3323,11195,12156,310511,310026,657,5.334,981,7.964,37756,8058,29698,2.599,12.178,36793,8786,28007,2.834,11.868,963,0.311,23.735,695,697,5762
2011,3324,1150,1442,79614,80549,63,4.389,50,3.483,8816,2134,6682,2.649,10.945,10557,1475,9082,1.831,13.106,-1741,-2.161,21.890,25,25,324
2011,3325,546,607,26776,26652,20,3.236,42,6.796,2222,230,1992,0.863,8.337,2048,477,1571,1.790,7.684,174,0.653,15.368,25,25,171
2011,3326,1170,1318,39614,38820,42,3.161,63,4.742,4600,650,3950,1.674,11.850,2961,959,2002,2.470,7.628,1639,4.222,15.255,37,37,458
2011,3327,21719,22141,357703,343127,1293,5.847,1239,5.603,54148,8083,46065,2.356,15.781,25022,8664,16358,2.525,7.292,29126,8.488,14.585,890,892,5464
2011,3328,4971,5480,117677,113522,279,5.081,302,5.499,16628,2644,13984,2.329,14.647,8274,2342,5932,2.063,7.288,8354,7.359,14.577,226,228,1631
2011,3329,5575,6108,251399,247559,403,6.601,398,6.519,26211,3603,22608,1.455,10.588,18327,4906,13421,1.982,7.403,7884,3.185,14.806,272,273,1913
2011,3331,2439,2792,183147,176950,208,7.538,143,5.182,22760,3407,19353,1.925,12.862,10091,2898,7193,1.638,5.703,12669,7.160,11.406,94,94,920
2011,3332,3111,3278,100843,99121,171,5.191,203,6.163,11189,1324,9865,1.336,11.288,7779,2196,5583,2.215,7.848,3410,3.440,15.696,141,143,1437
2011,3333,1789,1919,75105,74803,147,7.688,133,6.956,6383,1377,5006,1.841,8.533,5807,1788,4019,2.390,7.763,576,0.770,15.526,97,98,579
2011,3334,1452,1712,122326,120148,98,5.713,105,6.121,12938,1642,11296,1.367,10.768,8587,3556,5031,2.960,7.147,4351,3.621,14.294,69,73,1140
2011,3335,6423,6622,136728,132514,306,4.597,376,5.648,17937,2497,15440,1.884,13.536,9430,3262,6168,2.462,7.116,8507,6.420,14.232,279,281,2251
2011,3336,788,971,93583,92096,60,6.154,68,6.974,12316,2297,10019,2.494,13.373,9161,4014,5147,4.358,9.947,3155,3.426,19.894,49,49,575
2011,3339,5107,5714,259116,253843,285,4.971,324,5.651,27837,2804,25033,1.105,10.966,17221,5120,12101,2.017,6.784,10616,4.182,13.568,215,216,2094
2011,3341,938,985,66407,68362,77,7.774,88,8.884,3639,521,3118,0.762,5.323,7605,2102,5503,3.075,11.125,-3966,-5.801,10.646,63,63,526
2011,3342,1295,1429,111151,109856,119,8.351,111,7.789,11709,1200,10509,1.092,10.658,8739,2827,5912,2.573,7.955,2970,2.704,15.910,75,75,722
2011,3343,423,427,8067,8147,44,10.341,41,9.636,732,244,488,2.995,8.985,874,462,412,5.671,10.729,-142,-1.743,17.971,33,33,353
2011,3344,3635,4099,282995,280643,243,5.908,271,6.589,28372,4476,23896,1.595,10.110,24332,8061,16271,2.872,8.670,4040,1.440,17.340,188,188,2480
2011,3345,4261,4914,388001,385752,315,6.403,326,6.627,31228,5955,25273,1.544,8.095,26725,6400,20325,1.659,6.928,4503,1.167,13.856,207,207,2513
2011,3346,491,507,14161,15275,40,7.547,86,16.226,994,563,431,3.686,6.507,3363,1622,1741,10.619,22.016,-2369,-15.509,13.015,66,67,867
2011,3351,963,1043,45449,45414,80,7.597,100,9.497,3825,1072,2753,2.361,8.423,3798,1600,2198,3.523,8.363,27,0.059,16.726,70,70,867
2011,3352,232,272,43647,44475,26,9.612,23,8.503,2084,523,1561,1.176,4.686,3680,1619,2061,3.640,8.274,-1596,-3.589,9.372,12,12,81
2011,3353,1822,2098,111422,111393,104,4.900,153,7.208,9169,1386,7783,1.244,8.231,8925,3660,5265,3.286,8.012,244,0.219,16.024,97,97,719
2011,3359,1783,2075,130892,127637,135,6.528,121,5.851,15523,3823,11700,2.995,12.162,9138,3193,5945,2.502,7.159,6385,5.002,14.319,75,75,819
2011,3361,261,322,139253,132984,31,9.598,33,10.217,17304,356,16948,0.268,13.012,5073,1899,3174,1.428,3.815,12231,9.197,7.629,26,26,94
2011,3362,1528,1770,102482,97460,105,5.851,154,8.582,17347,2777,14570,2.849,17.799,7514,3039,4475,3.118,7.710,9833,10.089,15.420,107,112,1504
2011,3363,3965,4842,425855,413855,258,5.272,361,7.377,56207,9703,46504,2.345,13.581,32306,13920,18386,3.363,7.806,23901,5.775,15.612,218,227,3204
2011,3364,1232,1642,350233,357947,112,6.819,113,6.880,17805,2304,15501,0.644,4.974,34188,3358,30830,0.938,9.551,-16383,-4.577,9.948,61,61,539
2011,3365,148,216,25276,24847,14,6.467,15,6.928,3260,376,2884,1.513,13.121,2318,133,2185,0.535,9.329,942,3.791,18.659,8,8,65
2011,3366,1278,1392,127126,127736,114,8.062,158,11.174,10323,1392,8931,1.090,8.082,11408,2761,8647,2.161,8.931,-1085,-0.849,16.163,116,117,1551
2011,3369,761,788,36385,37012,93,11.877,83,10.600,3869,1830,2039,4.944,10.453,4953,680,4273,1.837,13.382,-1084,-2.929,20.907,62,63,290
2011,3371,10832,11066,202821,206913,856,7.534,1447,12.736,19017,4258,14759,2.058,9.191,27250,8660,18590,4.185,13.170,-8233,-3.979,18.382,1034,1037,5092
2011,3372,3300,3476,100913,101452,176,4.932,361,10.116,10728,1416,9312,1.396,10.575,11755,3783,7972,3.729,11.587,-1027,-1.012,21.149,276,280,2538
2011,3379,715,809,30797,31335,39,4.679,88,10.558,2546,522,2024,1.666,8.125,3641,1539,2102,4.911,11.620,-1095,-3.494,16.250,71,72,948
2011,3391,10090,10952,286988,285193,691,6.264,850,7.705,26895,5504,21391,1.930,9.430,23454,7512,15942,2.634,8.224,3441,1.207,16.448,632,635,3464
2011,3399,14696,15101,270505,270615,1311,8.641,1452,9.571,29505,7475,22030,2.762,10.903,29617,8848,20769,3.270,10.944,-112,-0.041,21.806,1087,1089,5625
2011,4231,16342,23727,356444,352565,1599,6.731,1654,6.963,37994,10515,27479,2.982,10.776,30402,9715,20687,2.756,8.623,7592,2.153,17.246,1132,1194,5888
2011,4232,9771,11563,134706,135287,998,8.580,1136,9.766,15454,5138,10316,3.798,11.423,16616,5141,11475,3.800,12.282,-1162,-0.859,22.846,843,875,4025
2011,4233,9942,16278,186589,191157,941,5.677,1537,9.272,18983,5152,13831,2.695,9.931,27812,10142,17670,5.306,14.549,-8829,-4.619,19.861,899,940,4934
2011,4234,22289,33730,656831,667651,3764,11.302,2912,8.744,87606,31699,55907,4.748,13.122,108563,49541,59022,7.420,16.260,-20957,-3.139,26.243,1581,1623,10784
2011,4235,7269,10155,144546,142805,523,5.111,679,6.635,16305,3191,13114,2.235,11.418,13004,3761,9243,2.634,9.106,3301,2.312,18.212,380,404,2134
2011,4236,17776,27575,500572,493225,2045,7.412,2074,7.517,68969,21524,47445,4.364,13.983,54002,18560,35442,3.763,10.949,14967,3.035,21.898,1221,1276,7858
2011,4237,9759,18518,210985,207290,1116,6.039,1040,5.628,24273,6412,17861,3.093,11.710,17076,4644,12432,2.240,8.238,7197,3.472,16.476,583,620,2647
2011,4238,38663,55373,667353,658969,3195,5.761,3374,6.083,80171,19485,60686,2.957,12.166,63773,19115,44658,2.901,9.678,16398,2.488,19.355,2023,2131,10785
2011,4239,26701,29973,316945,313461,3373,11.329,2975,9.992,47252,15225,32027,4.857,15.074,40198,15143,25055,4.831,12.824,7054,2.250,25.648,2150,2178,8520
2011,4241,7561,10078,148534,148724,554,5.401,912,8.891,13848,3697,10151,2.486,9.311,14259,5147,9112,3.461,9.588,-411,-0.276,18.622,544,562,2481
2011,4242,5660,8980,267218,266530,1043,11.843,697,7.914,29190,7185,22005,2.696,10.952,28178,7297,20881,2.738,10.572,1012,0.380,21.144,445,447,3199
2011,4243,12902,14092,182459,181892,1592,11.251,1708,12.071,27392,7648,19744,4.205,15.060,26270,8953,17317,4.922,14.443,1122,0.617,28.885,1301,1317,6360
2011,4244,24120,31142,757104,755805,2942,9.498,2606,8.414,82564,29163,53401,3.859,10.924,81103,22682,58421,3.001,10.731,1461,0.193,21.461,1738,1776,10887
2011,4245,3264,6007,63251,63446,304,5.050,330,5.482,7187,1723,5464,2.716,11.328,7589,1997,5592,3.148,11.961,-402,-0.634,22.656,182,196,1006
2011,4246,7736,11878,142881,140248,788,6.640,767,6.463,21663,8854,12809,6.313,15.446,16048,6528,9520,4.655,11.443,5615,4.004,22.885,402,419,1881
2011,4247,4627,6952,105010,105929,311,4.440,417,5.953,11257,2457,8800,2.319,10.627,13096,2665,10431,2.516,12.363,-1839,-1.736,21.254,233,237,1312
2011,4248,3091,4037,178791,177535,306,7.625,258,6.429,12912,2871,10041,1.617,7.273,10355,2911,7444,1.640,5.833,2557,1.440,11.665,186,194,2273
2011,4249,19900,25932,319374,320392,2233,8.579,2427,9.324,38558,12781,25777,3.989,12.035,40549,14130,26419,4.410,12.656,-1991,-0.621,24.069,1733,1759,7321
2011,4251,38366,40680,299064,297329,4655,11.368,5192,12.679,48413,14416,33997,4.849,16.283,44199,16516,27683,5.555,14.865,4214,1.417,29.731,3909,3941,12672
2011,4411,37130,42148,1056824,1045660,3661,8.663,3888,9.200,122085,39097,82988,3.739,11.675,100130,36610,63520,3.501,9.576,21955,2.100,19.152,3060,3141,29295
2011,4412,11854,13428,120669,121414,965,7.084,1352,9.925,15524,4903,10621,4.038,12.786,16908,6403,10505,5.274,13.926,-1384,-1.140,25.572,1011,1039,4993
2011,4413,27045,54411,481092,475979,2467,4.525,2672,4.902,48315,11742,36573,2.467,10.151,37958,10704,27254,2.249,7.975,10357,2.176,15.949,1745,1821,6479
2011,4421,14235,22719,196186,199219,1712,7.431,2354,10.217,22821,9227,13594,4.632,11.455,28748,10153,18595,5.096,14.430,-5927,-2.975,22.911,1489,1703,6577
2011,4422,19209,27020,226364,224387,1823,6.619,2869,10.416,32797,8018,24779,3.573,14.616,28932,9681,19251,4.314,12.894,3865,1.722,25.788,2034,2081,5685
2011,4431,24682,47523,440597,433074,6200,13.249,4746,10.142,71424,34585,36839,7.986,16.492,55620,18478,37142,4.267,12.843,15804,3.649,25.686,3024,3349,12300
2011,4441,38123,60823,1047391,1053659,2523,4.101,3918,6.369,66939,15323,51616,1.454,6.353,79844,17441,62403,1.655,7.578,-12905,-1.225,12.706,2656,2816,11894
2011,4442,13505,16995,146609,145753,1045,6.111,1256,7.345,19054,4217,14837,2.893,13.073,17069,4634,12435,3.179,11.711,1985,1.362,23.422,831,855,3050
2011,4451,58202,84377,2541986,2533464,8592,10.249,7502,8.949,205906,85512,120394,3.375,8.127,188529,55285,133244,2.182,7.442,17377,0.686,14.883,5587,5687,26902
2011,4452,16647,20471,143800,143076,2407,11.698,2616,12.714,25945,11637,14308,8.133,18.134,24389,10039,14350,7.017,17.046,1556,1.088,34.092,1831,1862,7298
2011,4453,25919,29778,148415,147988,2565,8.669,2187,7.391,20877,8160,12717,5.514,14.107,19979,7032,12947,4.752,13.500,898,0.607,27.001,1661,1678,5289
2011,4461,39363,88059,964904,977392,7841,9.016,5653,6.500,115408,45360,70048,4.641,11.808,142347,40677,101670,4.162,14.564,-26939,-2.756,23.615,2900,2967,13044
2011,4471,62040,107889,853027,853776,7769,7.202,7731,7.167,115012,43154,71858,5.054,13.471,115754,38672,77082,4.530,13.558,-742,-0.087,26.942,5134,5471,25536
2011,4481,32449,92221,1323117,1265559,8612,9.396,7490,8.172,266626,74446,192180,5.882,21.068,152074,54029,98045,4.269,12.016,114552,9.051,24.033,4047,4455,16412
2011,4482,5571,24957,207964,202396,1108,4.393,1635,6.483,32140,8175,23965,4.039,15.880,21349,7651,13698,3.780,10.548,10791,5.332,21.096,557,619,1969
2011,4483,15854,22799,127551,127371,1574,6.860,1864,8.124,17041,5015,12026,3.937,13.379,16505,6121,10384,4.806,12.958,536,0.421,25.916,1125,1190,3295
2011,4511,24985,35209,406539,404724,3068,8.693,3232,9.158,47602,16659,30943,4.116,11.762,43350,12530,30820,3.096,10.711,4252,1.051,21.422,2337,2428,8264
2011,4512,4282,9100,112491,116752,469,5.035,898,9.641,9428,1978,7450,1.694,8.075,18152,5895,12257,5.049,15.548,-8724,-7.472,16.151,514,529,1678
2011,4522,29,5019,607036,605703,49,0.972,96,1.904,27395,3988,23407,0.658,4.523,23882,3764,20118,0.621,3.943,3513,0.580,7.886,4,4,10
2011,4523,7196,40516,2228574,2207615,2586,6.473,1461,3.657,153277,36800,116477,1.667,6.943,111787,8763,103024,0.397,5.064,41490,1.879,10.127,916,980,3520
2011,4531,13628,14257,65956,67853,1009,6.883,1812,12.361,8916,2664,6252,3.926,13.140,12689,4917,7772,7.247,18.701,-3773,-5.561,26.280,1454,1468,3947
2011,4532,20237,31063,259309,264384,2649,8.403,3569,11.322,30393,10699,19694,4.047,11.496,41202,16778,24424,6.346,15.584,-10809,-4.088,22.992,2479,2586,8337
2011,4533,11816,17028,156440,151816,1848,10.994,1411,8.394,25110,9829,15281,6.474,16.540,15745,4637,11108,3.054,10.371,9365,6.169,20.742,1068,1094,3043
2011,4539,27862,36506,233077,232004,3951,10.766,4336,11.815,36559,15806,20753,6.813,15.758,33783,13625,20158,5.873,14.561,2776,1.197,29.123,2849,2946,9168
2011,4541,20459,21517,328123,322065,3631,17.315,2537,12.098,57910,19663,38247,6.105,17.981,45525,17747,27778,5.510,14.135,12385,3.845,28.271,1925,1944,8010
2011,4542,3444,3917,35509,36274,332,8.310,488,12.215,3001,1005,1996,2.771,8.273,4562,1844,2718,5.084,12.577,-1561,-4.303,16.547,390,392,1562
2011,4543,20556,26371,187389,188668,2163,8.146,2524,9.506,22784,6751,16033,3.578,12.076,25344,8483,16861,4.496,13.433,-2560,-1.357,24.152,1793,1830,6036
2011,4811,414,2642,389940,385093,145,5.482,151,5.709,26148,3095,23053,0.804,6.790,16094,2304,13790,0.598,4.179,10054,2.611,8.359,37,41,715
2011,4812,1916,2099,34140,33449,227,10.802,232,11.040,4960,1577,3383,4.715,14.829,3521,1067,2454,3.190,10.527,1439,4.302,21.053,177,177,663
2011,4831,659,999,45592,45327,99,9.846,112,11.139,5221,2325,2896,5.129,11.519,4561,1546,3015,3.411,10.062,660,1.456,20.125,58,58,946
2011,4832,416,471,17732,17325,46,9.674,55,11.567,2276,341,1935,1.968,13.137,1444,499,945,2.880,8.335,832,4.802,16.670,44,44,438
2011,4841,45160,54084,871269,853770,9498,17.830,7867,14.769,137773,46078,91695,5.397,16.137,102756,38462,64294,4.505,12.036,35017,4.101,24.071,5602,5653,21923
2011,4842,36195,40284,442661,435539,5022,12.434,5233,12.956,75773,21510,54263,4.939,17.398,61530,22519,39011,5.170,14.127,14243,3.270,28.255,3525,3550,14110
2011,4851,536,795,49111,48784,78,9.861,70,8.850,3622,1274,2348,2.612,7.425,3008,786,2222,1.611,6.166,614,1.259,12.332,47,47,241
2011,4852,203,420,15823,14756,76,18.765,46,11.358,4125,1430,2695,9.691,27.956,1924,1172,752,7.943,13.039,2201,14.916,26.078,19,23,374
2011,4853,6126,6261,66576,65248,1042,16.813,915,14.764,11226,4538,6688,6.955,17.205,8486,3695,4791,5.663,13.006,2740,4.199,26.012,706,706,3090
2011,4854,2714,4275,214032,213601,232,5.384,300,6.962,18881,5990,12891,2.804,8.839,18249,7195,11054,3.368,8.544,632,0.296,17.087,162,163,1832
2011,4855,1115,1217,27394,27153,115,9.399,128,10.462,3323,817,2506,3.009,12.238,2847,958,1889,3.528,10.485,476,1.753,20.970,86,87,471
2011,4859,3161,3580,75480,73879,542,15.348,445,12.601,12005,4338,7667,5.872,16.250,8765,3488,5277,4.721,11.864,3240,4.386,23.728,349,351,2656
2011,4861,47,647,9591,8799,245,45.245,34,6.279,2984,2332,652,26.503,33.913,1165,757,408,8.603,13.240,1819,20.673,26.480,D,D,D
2011,4862,108,1939,28913,28785,185,9.729,110,5.785,4774,1193,3581,4.145,16.585,4531,806,3725,2.800,15.741,243,0.844,31.482,10,10,40
2011,4869,45,650,6746,6610,69,10.748,53,8.255,1755,400,1355,6.051,26.551,1483,587,896,8.880,22.436,272,4.115,44.871,D,D,D
2011,4871,486,532,9478,9345,66,12.512,57,10.806,1282,358,924,3.831,13.719,1012,188,824,2.012,10.829,270,2.889,21.659,47,47,164
2011,4872,1123,1165,10904,10566,174,14.891,181,15.490,2073,543,1530,5.139,19.620,1345,466,879,4.411,12.730,728,6.890,25.460,105,108,293
2011,4879,150,170,2073,2031,35,21.605,19,11.728,317,106,211,5.219,15.608,237,97,140,4.776,11.669,80,3.939,23.338,12,12,79
2011,4881,3706,5453,155374,156508,605,11.140,561,10.330,21723,6070,15653,3.878,13.880,24419,8982,15437,5.739,15.602,-2696,-1.723,27.760,304,310,2062
2011,4882,479,1188,28648,27561,110,9.434,66,5.660,4286,1154,3132,4.187,15.551,2057,434,1623,1.575,7.463,2229,8.088,14.927,26,31,219
2011,4883,1663,2241,88073,87087,195,8.737,177,7.930,12632,5813,6819,6.675,14.505,10831,4225,6606,4.851,12.437,1801,2.068,24.874,89,90,419
2011,4884,8500,9453,75874,74948,1204,12.825,1074,11.440,13311,5217,8094,6.961,17.760,11391,4210,7181,5.617,15.199,1920,2.562,30.397,759,764,2893
2011,4885,13369,19027,229861,225886,1757,9.241,1728,9.089,33389,9268,24121,4.103,14.781,25126,9898,15228,4.382,11.123,8263,3.658,22.247,967,1013,4118
2011,4889,1152,1257,15816,15605,155,12.234,175,13.812,3114,830,2284,5.319,19.955,2695,990,1705,6.344,17.270,419,2.685,34.540,138,138,681
2011,4921,4011,8491,489867,487618,1438,17.309,1072,12.903,28319,6503,21816,1.334,5.808,22669,7891,14778,1.618,4.649,5650,1.159,9.298,426,436,1873
2011,4922,3916,4290,32438,31332,1075,26.248,686,16.750,7661,3785,3876,12.080,24.451,5339,2504,2835,7.992,17.040,2322,7.411,34.081,581,589,2102
2011,4931,6838,14164,681744,676527,1016,7.172,1019,7.194,87745,26004,61741,3.844,12.970,75011,17904,57107,2.646,11.088,12734,1.882,22.175,334,345,3015
2011,5111,12882,18617,493961,510123,1336,7.059,1953,10.319,40766,11871,28895,2.327,7.991,73018,26306,46712,5.157,14.314,-32252,-6.322,15.983,1062,1075,5591
2011,5112,5022,7586,380618,375113,956,12.827,690,9.258,52964,13897,39067,3.705,14.119,42604,18598,24006,4.958,11.358,10360,2.762,22.715,327,343,6835
2011,5121,12642,16041,288386,289170,2388,15.041,2060,12.975,41957,16297,25660,5.636,14.509,43933,12468,31465,4.312,15.193,-1976,-0.683,29.019,1256,1270,4916
2011,5122,2733,3013,22454,22528,435,14.371,463,15.296,2883,1122,1761,4.980,12.797,3015,1338,1677,5.939,13.383,-132,-0.586,25.595,320,321,848
2011,5151,4061,8729,211978,215382,1063,12.036,1269,14.368,23974,10811,13163,5.019,11.131,30837,12226,18611,5.676,14.317,-6863,-3.186,22.262,215,220,1662
2011,5152,394,777,48677,46737,111,14.751,62,8.239,10907,8155,2752,17.449,23.337,6718,2695,4023,5.766,14.374,4189,8.963,28.748,36,36,575
2011,5173,4160,44593,1045475,1051023,6402,14.481,5637,12.750,148472,78504,69968,7.469,14.126,159823,61271,98552,5.830,15.206,-11351,-1.080,28.253,349,385,3956
2011,5174,380,494,8305,8176,75,15.198,74,14.995,1237,336,901,4.110,15.130,974,485,489,5.932,11.913,263,3.217,23.826,50,50,368
2011,5179,3602,4051,51232,51890,489,11.704,743,17.784,9594,3325,6269,6.408,18.489,10905,4649,6256,8.959,21.016,-1311,-2.527,36.979,594,608,3314
2011,5182,7920,12551,419234,405444,1927,15.795,1225,10.041,98706,38743,59963,9.556,24.345,71736,19426,52310,4.791,17.693,26970,6.652,35.386,716,730,6941
2011,5191,6678,8679,177091,169276,1555,18.499,1009,12.003,35589,13142,22447,7.764,21.024,19522,7010,12512,4.141,11.533,16067,9.492,23.065,708,717,3197
2011,5211,12,47,18039,18449,0,0.000,D,D,468,0,468,0.000,2.537,1355,D,514,D,7.345,-887,-4.808,5.073,0,0,0
2011,5221,13623,123747,1999990,1989404,5444,4.393,5824,4.699,229573,53965,175608,2.713,11.540,211588,50756,160832,2.551,10.636,17985,0.904,21.271,356,539,6095
2011,5222,13460,39013,516322,517950,5099,13.032,5328,13.617,99800,35126,64674,6.782,19.268,101457,40989,60468,7.914,19.588,-1657,-0.320,38.537,1495,1667,8810
2011,5223,12531,28025,241786,246365,2346,7.976,5120,17.408,38230,15309,22921,6.214,15.518,47883,19602,28281,7.956,19.436,-9653,-3.918,31.035,2579,2872,9980
2011,5231,11640,41045,417932,424424,4907,11.912,5206,12.638,59280,18847,40433,4.441,13.967,71791,33509,38282,7.895,16.915,-12511,-2.948,27.934,907,933,4886
2011,5232,18,33,4975,4969,4,7.207,D,D,561,71,490,1.429,11.291,557,D,237,D,11.211,4,0.081,22.421,0,0,0
2011,5239,38148,43776,447223,442900,5769,13.243,5340,12.259,67130,27011,40119,6.099,15.157,58527,23859,34668,5.387,13.215,8603,1.942,26.429,3463,3503,11906
2011,5241,5400,29820,1382691,1399705,3444,11.283,4854,15.902,135127,51852,83275,3.704,9.654,169541,51914,117627,3.709,12.113,-34414,-2.459,19.308,395,426,2582
2011,5242,117358,131949,847048,848395,10445,7.878,11726,8.844,111453,43070,68383,5.077,13.137,114186,42840,71346,5.050,13.459,-2733,-0.322,26.274,8107,8244,24494
2011,5259,523,536,4320,5162,109,19.534,153,27.419,522,306,216,5.928,10.112,2158,934,1224,18.094,41.806,-1636,-31.693,20.225,132,132,880
2011,5311,82832,106419,513965,516286,9754,9.204,8878,8.377,71479,32702,38777,6.334,13.845,76313,31139,45174,6.031,14.781,-4834,-0.936,27.690,6135,6196,19050
2011,5312,56347,67064,263262,268212,10298,15.155,12076,17.771,49817,25691,24126,9.579,18.574,59285,27979,31306,10.432,22.104,-9468,-3.530,37.147,7266,7431,14905
2011,5313,59706,73941,610029,609014,8745,11.866,8255,11.201,88253,35423,52830,5.816,14.491,86317,36006,50311,5.912,14.173,1936,0.318,28.346,5211,5270,19316
2011,5321,3624,10717,148175,147738,1690,15.976,1413,13.357,23552,12303,11249,8.328,15.942,22780,14401,8379,9.748,15.419,772,0.523,30.838,342,354,1292
2011,5322,8187,22062,169976,179878,2282,9.599,5705,23.997,24166,8509,15657,4.730,13.435,45421,31322,14099,17.413,25.251,-21255,-11.816,26.869,1124,4017,22539
2011,5323,2499,3786,23851,24264,171,4.390,389,9.987,2785,703,2082,2.897,11.478,3679,1511,2168,6.227,15.163,-894,-3.685,22.956,176,254,766
2011,5324,7021,12926,146891,143948,1520,11.885,1247,9.750,25107,9290,15817,6.454,17.442,19361,6653,12708,4.622,13.450,5746,3.992,26.900,629,714,3602
2011,5331,1938,2049,29069,28904,267,13.028,268,13.076,4986,1962,3024,6.788,17.251,4697,2266,2431,7.840,16.251,289,1.000,32.501,200,200,829
2011,5411,159885,169897,1139901,1144087,13499,7.929,14221,8.353,117054,39620,77434,3.463,10.231,125673,38315,87358,3.349,10.985,-8619,-0.753,20.462,10276,10391,27687
2011,5412,97665,113160,1265990,1263625,10762,9.518,10592,9.367,212369,59804,152565,4.733,16.806,208873,78960,129913,6.249,16.530,3496,0.277,33.059,6621,6667,36414
2011,5413,79026,95318,1275178,1279794,9956,10.381,11135,11.610,185224,66649,118575,5.208,14.473,195112,60416,134696,4.721,15.246,-9888,-0.773,28.946,6255,6374,22264
2011,5414,24043,24312,106722,105601,3485,14.208,3919,15.977,21639,7637,14002,7.232,20.491,19705,9837,9868,9.315,18.660,1934,1.831,37.320,2648,2652,7150
2011,5415,88240,106148,1452461,1435361,18827,17.978,15971,15.251,307866,91243,216623,6.357,21.449,275443,97788,177655,6.813,19.190,32423,2.259,38.380,9871,9984,38560
2011,5416,105953,114380,920583,892762,21606,19.174,18212,16.162,200342,78647,121695,8.809,22.441,145227,63665,81562,7.131,16.267,55115,6.174,32.534,12779,12840,38495
2011,5417,12079,15448,682644,679846,1985,12.985,1662,10.872,73889,16707,57182,2.457,10.868,68764,23634,45130,3.476,10.115,5125,0.754,20.229,976,986,6641
2011,5418,29645,33135,424292,417718,3814,11.454,4143,12.442,66960,20016,46944,4.792,16.030,53545,22145,31400,5.301,12.818,13415,3.212,25.637,2981,3008,13742
2011,5419,51097,60694,576787,573113,5644,9.305,5567,9.178,83655,27209,56446,4.748,14.597,76604,23652,52952,4.127,13.366,7051,1.230,26.733,3991,4055,15613
2011,5511,26562,50568,2955969,2905433,4291,8.530,3760,7.475,472876,146118,326758,5.029,16.276,370517,89504,281013,3.081,12.753,102359,3.523,25.505,831,864,12898
2011,5611,23712,25885,412099,401736,3557,13.890,3002,11.723,76323,25359,50964,6.312,18.998,55006,21015,33991,5.231,13.692,21317,5.306,27.384,2133,2173,15023
2011,5612,1763,5487,268731,262313,590,10.705,639,11.594,46659,9863,36796,3.760,17.788,32599,10543,22056,4.019,12.428,14060,5.360,24.855,93,111,2391
2011,5613,24254,43303,4357418,4176443,5593,12.899,5707,13.162,1098994,170416,928578,4.080,26.314,724566,242793,481773,5.813,17.349,374428,8.965,34.698,2677,2814,93288
2011,5614,24834,31047,753032,761891,3096,9.874,3709,11.830,122030,37605,84425,4.936,16.017,139100,43723,95377,5.739,18.257,-17070,-2.240,32.033,2631,2683,22038
2011,5615,13038,18804,225515,226643,2646,14.054,2694,14.308,30635,12647,17988,5.580,13.517,32949,13230,19719,5.837,14.538,-2314,-1.021,27.034,1131,1164,4600
2011,5616,17260,23352,792602,786339,2403,10.258,2550,10.886,110480,30902,79578,3.930,14.050,98242,32017,66225,4.072,12.494,12238,1.556,24.987,1591,1615,15711
2011,5617,134825,141740,1625065,1612333,19266,13.577,19585,13.802,276039,78114,197925,4.845,17.120,252204,87911,164293,5.452,15.642,23835,1.478,31.284,12875,13037,56848
2011,5619,15613,17650,267602,261095,1807,10.248,1772,10.050,44073,11484,32589,4.398,16.880,31187,10945,20242,4.192,11.945,12886,4.935,23.889,1178,1187,5907
2011,5621,7156,10052,184763,185647,1399,14.265,910,9.279,28639,15194,13445,8.184,15.427,30856,8895,21961,4.791,16.621,-2217,-1.194,30.853,566,571,3661
2011,5622,1303,2589,52642,51993,271,10.705,156,6.162,7226,3146,4080,6.051,13.898,5864,1645,4219,3.164,11.279,1362,2.620,22.557,93,93,758
2011,5629,7643,9157,125679,121600,1229,13.798,729,8.185,27472,10027,17445,8.246,22.592,19604,4526,15078,3.722,16.122,7868,6.470,32.244,486,488,3166
2011,6111,18065,20421,870594,860586,962,4.730,800,3.933,74315,20447,53868,2.376,8.635,53854,11164,42690,1.297,6.258,20461,2.378,12.516,582,586,8123
2011,6112,451,919,91670,88682,53,5.834,32,3.522,11362,1557,9805,1.756,12.812,5415,772,4643,0.871,6.106,5947,6.706,12.212,20,22,254
2011,6113,2162,4036,1770663,1742794,496,12.366,446,11.119,124909,15855,109054,0.910,7.167,69362,7836,61526,0.450,3.980,55547,3.187,7.960,50,50,1281
2011,6114,6309,6888,65013,63913,874,12.780,776,11.347,11280,4134,7146,6.468,17.649,8985,3108,5877,4.863,14.058,2295,3.591,28.116,507,511,2050
2011,6115,6017,7722,137359,134926,714,9.268,678,8.801,22760,8676,14084,6.430,16.869,17924,4545,13379,3.369,13.284,4836,3.584,26.569,444,454,2282
2011,6116,34368,37381,362139,351397,4978,13.524,3832,10.411,77096,25563,51533,7.275,21.940,55153,16578,38575,4.718,15.695,21943,6.245,31.391,2865,2899,12259
2011,6117,5277,6077,89751,84454,975,16.340,755,12.653,20010,5289,14721,6.263,23.693,9379,3205,6174,3.795,11.105,10631,12.588,22.211,554,555,2021
2011,6211,173479,207513,2237138,2218580,15198,7.334,14615,7.053,280534,103008,177526,4.643,12.645,243072,86587,156485,3.903,10.956,37462,1.689,21.912,10306,10614,54573
2011,6212,118459,126002,854448,849997,6491,5.181,5033,4.018,95023,31713,63310,3.731,11.179,85775,22632,63143,2.663,10.091,9248,1.088,20.182,4054,4118,18520
2011,6213,110296,124662,707541,693754,11722,9.504,9085,7.366,118438,48745,69693,7.026,17.072,90404,31214,59190,4.499,13.031,28034,4.041,26.062,6208,6287,20444
2011,6214,14710,33077,740185,727463,2325,7.108,1593,4.870,88788,25965,62823,3.569,12.205,62683,17080,45603,2.348,8.617,26105,3.589,17.233,826,859,7569
2011,6215,7114,12505,249748,248916,1092,8.692,1208,9.616,27856,8039,19817,3.230,11.191,26128,8460,17668,3.399,10.497,1728,0.694,20.993,626,717,4413
2011,6216,18736,27105,1244081,1214359,3678,13.957,2171,8.239,191834,46708,145126,3.846,15.797,133173,36635,96538,3.017,10.967,58661,4.831,21.933,1416,1441,21918
2011,6219,6022,9485,286632,285322,914,9.692,805,8.536,35970,10680,25290,3.743,12.607,33384,12688,20696,4.447,11.700,2586,0.906,23.401,388,409,6012
2011,6221,2903,5061,5166892,5146376,62,1.225,61,1.205,196589,19989,176600,0.388,3.820,154124,20994,133130,0.408,2.995,42465,0.825,5.990,28,28,5761
2011,6222,427,600,217268,217989,14,2.326,18,2.990,6980,2262,4718,1.038,3.202,8367,2914,5453,1.337,3.838,-1387,-0.636,6.404,9,9,2176
2011,6223,367,888,262520,262897,38,4.301,29,3.282,15349,3409,11940,1.297,5.838,15880,4271,11609,1.625,6.040,-531,-0.202,11.677,17,17,2498
2011,6231,8023,16124,1633568,1627677,1286,8.129,677,4.280,120828,49696,71132,3.053,7.423,110053,37910,72143,2.329,6.761,10775,0.662,13.523,337,346,18204
2011,6232,8913,34663,647310,646335,1384,3.989,1444,4.162,62448,13698,48750,2.119,9.662,60338,13759,46579,2.129,9.335,2110,0.326,18.671,358,514,5761
2011,6233,15069,21523,832405,825244,1827,8.550,1518,7.104,82618,28966,53652,3.510,10.011,68767,28921,39846,3.505,8.333,13851,1.678,16.666,1018,1099,21083
2011,6239,3191,5612,139388,139987,474,8.463,452,8.070,15816,3748,12068,2.677,11.298,17166,5377,11789,3.841,12.263,-1350,-0.964,22.596,231,249,2692
2011,6241,42338,59296,1383508,1361819,5401,9.215,4028,6.873,177911,43059,134852,3.162,13.064,135041,33529,101512,2.462,9.916,42870,3.148,19.832,2506,2544,18051
2011,6242,9919,13610,178786,177906,621,4.535,791,5.776,20182,3919,16263,2.203,11.344,18354,6106,12248,3.432,10.317,1828,1.028,20.633,518,528,4291
2011,6243,4160,7973,356447,351268,551,6.993,363,4.607,47305,8467,38838,2.410,13.467,36967,4672,32295,1.330,10.524,10338,2.943,21.048,165,180,1966
2011,6244,55364,70832,866434,863790,6506,9.196,6332,8.950,109525,39392,70133,4.560,12.680,104067,36437,67630,4.218,12.048,5458,0.632,24.095,4688,4757,26115
2011,7111,6887,7028,112927,114640,757,10.727,815,11.549,19755,5595,14160,4.880,17.232,23666,4864,18802,4.243,20.644,-3911,-3.412,34.464,524,525,3479
2011,7112,3267,3433,124559,122732,448,12.961,495,14.321,17200,3347,13853,2.727,14.014,13349,3078,10271,2.508,10.877,3851,3.138,21.753,387,389,2619
2011,7113,5315,5659,129033,128798,667,11.885,573,10.210,18716,3541,15175,2.749,14.531,18387,4449,13938,3.454,14.276,329,0.255,28.552,430,430,1709
2011,7114,2787,2892,17536,17507,434,15.196,362,12.675,2781,1276,1505,7.289,15.885,2687,934,1753,5.335,15.348,94,0.537,30.696,263,263,661
2011,7115,13360,13387,42449,42831,2544,19.138,2356,17.724,11212,5699,5513,13.306,26.177,12215,5705,6510,13.320,28.519,-1003,-2.342,52.355,1411,1412,3222
2011,7121,6323,6794,128888,127513,314,4.617,327,4.808,10338,1150,9188,0.902,8.107,7603,1186,6417,0.930,5.963,2735,2.145,11.925,195,195,888
2011,7131,2243,2633,147901,147995,387,14.794,353,13.494,19881,6229,13652,4.209,13.434,19966,4135,15831,2.794,13.491,-85,-0.057,26.867,265,269,2497
2011,7132,1770,2630,164775,166262,273,10.510,208,8.008,12318,4773,7545,2.871,7.409,15526,3588,11938,2.158,9.338,-3208,-1.929,14.818,154,158,3042
2011,7139,48071,55021,1128291,1127795,5765,10.460,5950,10.796,139153,51447,87706,4.562,12.339,137978,43883,94095,3.891,12.234,1175,0.104,24.469,4475,4531,31991
2011,7211,38610,49600,1815817,1797791,3798,7.677,3540,7.156,183924,72352,111572,4.024,10.231,148966,53534,95432,2.978,8.286,34958,1.944,16.572,2392,2442,35671
2011,7212,5189,5768,38476,38543,454,7.850,485,8.386,5726,1485,4241,3.853,14.856,5883,1396,4487,3.622,15.263,-157,-0.407,29.712,283,284,841
2011,7213,1859,1973,10646,10535,110,5.568,115,5.821,1443,482,961,4.575,13.698,1235,278,957,2.639,11.723,208,1.974,23.447,75,76,214
2011,7223,12066,35786,664067,655498,3437,9.625,3286,9.202,89394,27208,62186,4.151,13.638,72514,23769,48745,3.626,11.062,16880,2.575,22.125,1494,1502,7704
2011,7224,38969,39710,347922,348337,3955,9.858,4778,11.909,64300,29873,34427,8.576,18.459,64972,27357,37615,7.854,18.652,-672,-0.193,36.918,3888,3895,22797
2011,7225,334173,461907,8681473,8592539,51165,11.167,43691,9.536,1270977,633091,637886,7.368,14.792,1088590,397680,690910,4.628,12.669,182387,2.123,25.338,34739,35789,297279
2011,8111,133028,145457,801482,796995,12295,8.438,12797,8.783,114158,42347,71811,5.313,14.324,105122,38429,66693,4.822,13.190,9036,1.134,26.380,9057,9258,27727
2011,8112,9900,11319,108999,110829,1279,11.262,1354,11.923,14995,7107,7888,6.413,13.530,18400,7692,10708,6.940,16.602,-3405,-3.072,27.060,968,988,3644
2011,8113,17961,19670,185145,183220,1616,8.187,1752,8.876,31078,8160,22918,4.454,16.962,27771,7179,20592,3.918,15.157,3307,1.805,30.314,1174,1183,4200
2011,8114,16653,17368,67792,68925,1955,11.174,2210,12.632,10861,4608,6253,6.686,15.758,13144,6002,7142,8.708,19.070,-2283,-3.312,31.516,1548,1550,3407
2011,8121,87216,103398,631744,629235,12439,12.080,11584,11.250,103630,46715,56915,7.424,16.469,98965,40198,58767,6.388,15.728,4665,0.741,31.456,9132,9268,31668
2011,8122,14404,20018,136249,135065,1013,5.079,868,4.352,17863,5694,12169,4.216,13.226,15711,3068,12643,2.272,11.632,2152,1.593,23.264,463,490,1664
2011,8123,29028,34426,296773,301156,2726,7.874,3114,8.995,30260,12254,18006,4.069,10.048,39109,14666,24443,4.870,12.986,-8849,-2.938,20.096,2316,2420,9787
2011,8129,22462,33073,243859,241910,4806,14.728,3923,12.022,47026,18348,28678,7.585,19.440,43643,16345,27298,6.757,18.041,3383,1.398,36.082,2160,2189,8662
2011,8131,174586,174924,1666398,1676996,8642,4.939,8761,5.007,158486,28529,129957,1.701,9.451,179830,24894,154936,1.484,10.723,-21344,-1.273,18.901,5478,5478,16152
2011,8132,15422,17380,171923,169498,1467,8.547,1034,6.024,20014,4182,15832,2.467,11.808,15063,4074,10989,2.404,8.887,4951,2.921,17.774,696,705,2703
2011,8133,13338,15761,146681,144102,1353,8.659,1080,6.912,19607,4534,15073,3.146,13.606,14575,3606,10969,2.502,10.114,5032,3.492,20.229,661,661,2395
2011,8134,23441,25324,235470,236971,1127,4.419,1484,5.819,24153,4969,19184,2.097,10.192,27083,5538,21545,2.337,11.429,-2930,-1.236,20.385,1035,1040,3771
2011,8139,54909,57211,488727,493913,2425,4.204,3367,5.837,44543,8401,36142,1.701,9.018,55076,12985,42091,2.629,11.151,-10533,-2.133,18.037,2318,2319,8307
2012,1131,321,336,2095,2048,30,8.982,26,7.784,302,68,234,3.320,14.746,207,75,132,3.662,10.107,95,4.639,20.215,18,18,44
2012,1132,127,144,1593,1574,18,12.457,19,13.149,382,66,316,4.193,24.269,374,61,313,3.875,23.761,8,0.508,47.522,11,11,39
2012,1133,7119,7212,48850,49273,695,9.614,729,10.084,7094,2102,4992,4.266,14.397,8004,2793,5211,5.668,16.244,-910,-1.847,28.795,513,513,1912
2012,1141,1197,1208,6077,6074,227,19.164,180,15.196,1160,519,641,8.545,19.099,1166,384,782,6.323,19.198,-6,-0.099,38.199,102,102,210
2012,1142,243,243,1609,1553,27,11.273,20,8.351,265,75,190,4.831,17.069,153,69,84,4.444,9.855,112,7.214,19.710,14,14,48
2012,1151,3477,3820,65952,65094,431,11.437,328,8.704,10737,2907,7830,4.466,16.495,9058,2118,6940,3.254,13.915,1679,2.579,27.831,211,214,1361
2012,1152,3664,3769,19856,19453,435,11.609,391,10.435,3394,1215,2179,6.246,17.447,2548,1017,1531,5.228,13.098,846,4.349,26.196,299,299,709
2012,1153,1248,1334,10499,10592,162,12.277,133,10.080,1803,427,1376,4.031,17.022,1970,560,1410,5.287,18.599,-167,-1.577,34.045,80,80,358
2012,2111,5898,7323,127985,121348,674,9.276,560,7.707,23294,6451,16843,5.316,19.196,10277,4354,5923,3.588,8.469,13017,10.727,16.938,360,365,1680
2012,2121,539,972,87881,86688,98,9.975,119,12.112,14069,4540,9529,5.237,16.229,11750,5602,6148,6.462,13.554,2319,2.675,27.109,52,53,1064
2012,2122,258,323,39972,37519,51,16.268,32,10.207,6085,343,5742,0.914,16.218,1361,517,844,1.378,3.627,4724,12.591,7.255,22,22,151
2012,2123,2818,4869,76702,78293,319,6.535,344,7.047,11188,2381,8807,3.041,14.290,14467,3183,11284,4.065,18.478,-3279,-4.188,28.580,161,165,1048
2012,2131,10242,12788,393518,364556,1877,15.119,1131,9.110,101169,27263,73906,7.478,27.751,43767,15361,28406,4.214,12.006,57402,15.746,24.011,714,729,7950
2012,2211,1667,10249,514368,515583,551,5.422,379,3.729,33236,10886,22350,2.111,6.446,35879,5674,30205,1.101,6.959,-2643,-0.513,12.893,72,73,1292
2012,2212,434,2428,84645,84280,128,5.182,212,8.583,7991,2666,5325,3.163,9.481,7354,3270,4084,3.880,8.726,637,0.756,17.451,20,25,201
2012,2213,3450,4647,43564,42943,267,5.792,193,4.187,4712,1530,3182,3.563,10.973,3488,724,2764,1.686,8.122,1224,2.850,16.245,106,106,255
2012,2361,119921,121005,530201,523482,23706,19.771,21504,17.934,136097,61895,74202,11.824,25.998,122107,54874,67233,10.482,23.326,13990,2.672,46.652,13252,13273,35058
2012,2362,35725,37063,550784,549380,3843,10.298,4353,11.665,99161,18929,80232,3.446,18.050,96384,27963,68421,5.090,17.544,2777,0.505,35.088,2863,2869,16387
2012,2371,16296,17728,485368,467642,1648,9.268,1757,9.881,98549,13279,85270,2.840,21.074,63957,15231,48726,3.257,13.677,34592,7.397,27.353,1057,1068,7529
2012,2372,4927,4988,23499,24432,485,9.339,895,17.235,3775,1281,2494,5.243,15.451,5558,2918,2640,11.943,22.749,-1783,-7.298,30.902,682,682,2214
2012,2373,8361,9144,260847,256844,688,7.481,793,8.623,44152,8298,35854,3.231,17.190,36199,6881,29318,2.679,14.094,7953,3.096,28.188,465,468,4013
2012,2379,3557,3670,87448,87584,464,12.779,386,10.631,13659,2491,11168,2.844,15.595,14071,3147,10924,3.593,16.066,-412,-0.470,31.191,224,224,1029
2012,2381,70829,71555,662151,650482,10980,15.422,10260,14.411,161689,40723,120966,6.260,24.857,138451,44391,94060,6.824,21.284,23238,3.572,42.569,6531,6593,30923
2012,2382,149307,153245,1620610,1603400,15261,9.981,14570,9.529,271876,55440,216436,3.458,16.956,236787,68026,168761,4.243,14.768,35089,2.188,29.536,9831,9857,43718
2012,2383,86435,87397,609130,608004,12344,14.093,12724,14.527,131751,35825,95926,5.892,21.669,129507,45524,83983,7.487,21.300,2244,0.369,42.601,8193,8222,33501
2012,2389,51302,51981,470316,459388,7438,14.445,6457,12.540,100206,22915,77291,4.988,21.813,77918,25241,52677,5.494,16.961,22288,4.852,33.923,4039,4049,17403
2012,3111,1036,1624,44274,46755,67,4.088,97,5.918,3577,655,2922,1.401,7.651,8187,1215,6972,2.599,17.511,-4610,-9.860,15.301,64,64,343
2012,3112,428,789,54445,54297,59,7.559,42,5.381,3954,904,3050,1.665,7.282,3615,1023,2592,1.884,6.658,339,0.624,13.316,22,22,379
2012,3113,1555,1722,70455,69739,153,8.963,123,7.206,7976,1741,6235,2.496,11.437,6446,1874,4572,2.687,9.243,1530,2.194,18.486,91,92,1145
2012,3114,1276,1635,155459,155463,122,7.536,90,5.559,12489,2334,10155,1.501,8.033,12636,2720,9916,1.750,8.128,-147,-0.095,16.067,57,57,1365
2012,3115,1014,1521,133734,134636,105,6.970,76,5.045,8326,1143,7183,0.849,6.184,10220,2583,7637,1.919,7.591,-1894,-1.407,12.368,43,43,1456
2012,3116,2820,3414,487952,488815,171,4.969,226,6.567,26699,3181,23518,0.651,5.462,28623,7804,20819,1.597,5.856,-1924,-0.394,10.924,158,158,3046
2012,3117,450,545,32135,31920,34,6.227,36,6.593,4013,1192,2821,3.734,12.572,3497,1100,2397,3.446,10.956,516,1.617,21.911,30,30,829
2012,3118,9116,9841,276812,276849,1067,11.005,776,8.004,29131,8735,20396,3.155,10.522,28664,7429,21235,2.683,10.354,467,0.169,20.707,609,618,4792
2012,3119,2610,3045,163718,161292,251,8.289,217,7.166,16723,4013,12710,2.488,10.368,11958,3451,8507,2.140,7.414,4765,2.954,14.828,169,169,2245
2012,3121,3794,4395,135270,133250,570,13.401,287,6.747,14641,3918,10723,2.940,10.988,10719,2855,7864,2.143,8.044,3922,2.943,16.089,200,203,1202
2012,3122,89,111,14876,15068,12,10.480,19,16.594,1400,266,1134,1.765,9.292,1779,269,1510,1.785,11.807,-379,-2.515,18.583,13,13,37
2012,3131,231,300,25019,26044,11,3.543,32,10.306,1020,45,975,0.173,3.917,3044,1027,2017,3.943,11.688,-2024,-7.772,7.833,20,20,139
2012,3132,835,920,50496,50358,43,4.601,72,7.705,4195,700,3495,1.390,8.330,3970,1501,2469,2.981,7.884,225,0.447,15.767,55,56,1076
2012,3133,966,1010,30624,30955,51,5.002,70,6.866,2310,463,1847,1.496,7.463,3006,1362,1644,4.400,9.711,-696,-2.248,14.925,52,52,693
2012,3141,1744,1868,51297,52689,114,5.961,203,10.614,4562,1487,3075,2.822,8.658,7310,2437,4873,4.625,13.874,-2748,-5.216,17.317,143,150,1008
2012,3149,3845,3950,61828,60461,317,8.028,314,7.952,8277,2039,6238,3.372,13.690,5509,1217,4292,2.013,9.112,2768,4.578,18.223,235,236,949
2012,3151,246,261,12821,13063,11,4.143,20,7.533,798,104,694,0.796,6.109,1303,408,895,3.123,9.975,-505,-3.866,12.218,17,17,404
2012,3152,4763,4810,88016,86631,785,16.246,829,17.156,17036,5907,11129,6.819,19.665,14103,7880,6223,9.096,16.279,2933,3.386,32.559,715,718,6358
2012,3159,489,500,8076,8244,53,10.362,76,14.858,719,263,456,3.190,8.722,1069,445,624,5.398,12.968,-350,-4.246,17.444,60,60,330
2012,3161,170,179,3512,3598,10,5.510,15,8.264,230,33,197,0.917,6.393,411,111,300,3.085,11.425,-181,-5.031,12.787,12,12,33
2012,3162,179,198,11248,11278,18,9.045,20,10.050,855,102,753,0.904,7.581,939,447,492,3.963,8.326,-84,-0.745,15.162,13,13,66
2012,3169,648,651,11966,11544,62,9.509,64,9.816,2127,1372,755,11.885,18.425,1335,371,964,3.214,11.564,792,6.861,23.129,47,48,296
2012,3211,2757,3134,76172,76628,207,6.532,277,8.741,7507,1834,5673,2.393,9.797,8453,3180,5273,4.150,11.031,-946,-1.235,19.593,175,184,1929
2012,3212,1115,1385,59500,60368,58,4.103,115,8.136,5622,960,4662,1.590,9.313,7298,3143,4155,5.206,12.089,-1676,-2.776,18.626,69,70,981
2012,3219,7528,8417,205735,205820,509,5.975,712,8.358,23220,4258,18962,2.069,11.282,23502,6971,16531,3.387,11.419,-282,-0.137,22.563,499,509,4659
2012,3221,149,364,107146,108648,13,3.537,20,5.442,2995,951,2044,0.875,2.757,5840,1708,4132,1.572,5.375,-2845,-2.619,5.513,8,8,744
2012,3222,2672,3960,247420,250952,126,3.145,219,5.466,15158,2743,12415,1.093,6.040,21988,7983,14005,3.181,8.762,-6830,-2.722,12.080,118,122,2606
2012,3231,24928,26190,473332,479187,1407,5.293,2196,8.260,38512,10058,28454,2.099,8.037,50355,19284,31071,4.024,10.508,-11843,-2.471,16.074,1718,1725,11098
2012,3241,948,2131,98723,99102,120,5.627,123,5.768,5933,730,5203,0.737,5.987,6821,2011,4810,2.029,6.883,-888,-0.896,11.974,51,51,377
2012,3251,1362,2430,155193,154942,124,5.131,97,4.014,10788,1777,9011,1.147,6.963,10098,1663,8435,1.073,6.517,690,0.445,13.035,54,54,701
2012,3252,1063,1388,90488,89056,54,3.881,61,4.384,8021,1108,6913,1.244,9.007,5109,1374,3735,1.543,5.737,2912,3.270,11.474,34,34,606
2012,3253,638,881,29512,29228,62,7.086,50,5.714,2621,362,2259,1.239,8.967,2056,554,1502,1.895,7.034,565,1.933,14.069,28,28,272
2012,3254,1571,2042,236807,234262,151,7.464,113,5.586,17789,2452,15337,1.047,7.594,12587,2969,9618,1.267,5.373,5202,2.221,10.746,79,79,2077
2012,3255,1308,1650,54949,54622,67,4.048,77,4.653,4385,910,3475,1.666,8.028,3730,768,2962,1.406,6.829,655,1.199,13.658,49,49,339
2012,3256,1901,2094,93144,93401,129,6.136,146,6.944,7500,2042,5458,2.186,8.030,8160,2243,5917,2.401,8.737,-660,-0.707,16.060,109,109,1022
2012,3259,1826,2310,81473,81464,138,5.957,151,6.518,7037,1309,5728,1.607,8.638,7054,2390,4664,2.934,8.659,-17,-0.021,17.276,88,93,1464
2012,3261,8215,10463,573636,571329,415,3.936,579,5.491,51412,8603,42809,1.506,8.999,46703,12243,34460,2.143,8.174,4709,0.824,16.349,376,377,5139
2012,3262,1479,1888,128208,126270,67,3.523,95,4.995,11044,2581,8463,2.044,8.746,7088,1770,5318,1.402,5.613,3956,3.133,11.227,56,56,365
2012,3271,965,1153,34160,34105,64,5.496,87,7.471,3406,884,2522,2.592,9.987,3223,404,2819,1.185,9.450,183,0.537,18.901,61,61,277
2012,3272,1433,1706,83600,83049,120,7.038,118,6.921,6935,1075,5860,1.294,8.350,5743,1982,3761,2.387,6.915,1192,1.435,13.830,72,72,415
2012,3273,4146,8467,146398,146979,415,4.840,628,7.325,18932,3671,15261,2.498,12.881,19838,4829,15009,3.286,13.497,-906,-0.616,25.762,224,248,1651
2012,3274,169,300,12254,12351,14,4.613,21,6.919,678,112,566,0.907,5.490,859,110,749,0.891,6.955,-181,-1.466,10.979,14,14,76
2012,3279,2564,3018,69776,68694,203,6.683,242,7.967,7987,1907,6080,2.776,11.627,5839,1625,4214,2.366,8.500,2148,3.127,17.000,181,182,1021
2012,3311,254,403,103994,102495,12,2.916,29,7.047,6082,340,5742,0.332,5.934,3081,405,2676,0.395,3.006,3001,2.928,6.012,18,18,138
2012,3312,521,647,47718,45955,39,6.014,42,6.476,5651,887,4764,1.930,12.297,2170,657,1513,1.430,4.722,3481,7.575,9.444,25,25,485
2012,3313,394,521,54689,53230,21,4.019,24,4.593,5132,577,4555,1.084,9.641,2218,267,1951,0.502,4.167,2914,5.474,8.334,17,17,138
2012,3314,801,1004,63181,62157,57,5.726,40,4.018,5443,642,4801,1.033,8.757,3389,777,2612,1.250,5.452,2054,3.305,10.905,28,28,530
2012,3315,1606,1805,126290,121209,74,4.083,89,4.910,15487,1683,13804,1.389,12.777,5330,1488,3842,1.228,4.397,10157,8.380,8.795,55,56,586
2012,3321,2262,2484,113008,109529,61,2.426,121,4.813,12773,1357,11416,1.239,11.662,5861,2372,3489,2.166,5.351,6912,6.311,10.702,78,78,1192
2012,3322,1053,1142,36130,36395,55,4.770,77,6.678,1996,146,1850,0.401,5.484,2525,608,1917,1.671,6.938,-529,-1.454,10.969,56,56,270
2012,3323,10921,11846,318942,314483,578,4.828,831,6.941,38164,6102,32062,1.940,12.135,29126,10307,18819,3.277,9.262,9038,2.874,18.523,583,587,6422
2012,3324,1181,1486,87972,86011,58,3.885,72,4.823,9703,1603,8100,1.864,11.281,5824,1463,4361,1.701,6.771,3879,4.510,13.543,53,55,851
2012,3325,529,584,27007,26965,31,5.286,36,6.138,1892,143,1749,0.530,7.017,1813,308,1505,1.142,6.724,79,0.293,13.447,27,27,173
2012,3326,1109,1253,37689,37437,40,3.166,61,4.828,3454,588,2866,1.571,9.226,2961,717,2244,1.915,7.909,493,1.317,15.819,46,46,581
2012,3327,22185,22643,385575,373645,1281,5.683,1079,4.787,48979,8933,40046,2.391,13.108,25152,7732,17420,2.069,6.732,23827,6.377,13.463,779,780,4969
2012,3328,5054,5568,122902,120368,284,5.103,279,5.013,14485,2612,11873,2.170,12.034,9467,3453,6014,2.869,7.865,5018,4.169,15.730,194,195,1968
2012,3329,5519,6045,253439,247421,438,7.298,351,5.849,28117,5412,22705,2.187,11.364,16097,5082,11015,2.054,6.506,12020,4.858,13.012,250,250,2741
2012,3331,2569,2932,213609,201535,154,5.271,133,4.552,32832,2846,29986,1.412,16.291,9028,2880,6148,1.429,4.480,23804,11.811,8.959,99,99,1409
2012,3332,2974,3137,96608,96428,154,4.883,187,5.930,9621,1342,8279,1.392,9.977,9111,2617,6494,2.714,9.449,510,0.529,18.897,135,135,1230
2012,3333,1812,1944,77733,78174,96,4.863,156,7.903,6037,765,5272,0.979,7.723,6963,1768,5195,2.262,8.907,-926,-1.185,15.445,117,117,1192
2012,3334,1494,1765,128805,127301,86,4.853,100,5.643,12749,3368,9381,2.646,10.015,9955,1703,8252,1.338,7.820,2794,2.195,15.640,73,73,997
2012,3335,6291,6494,141268,137221,229,3.510,290,4.445,15572,2245,13327,1.636,11.348,7453,2918,4535,2.127,5.431,8119,5.917,10.863,198,201,1764
2012,3336,777,978,106054,101951,36,3.642,57,5.766,15387,3023,12364,2.965,15.093,7017,1345,5672,1.319,6.883,8370,8.210,13.766,41,41,390
2012,3339,5343,5971,282742,275351,299,5.011,291,4.877,29973,3146,26827,1.143,10.885,15221,4910,10311,1.783,5.528,14752,5.358,11.056,176,178,1691
2012,3341,970,1005,63862,66646,100,9.935,103,10.233,4218,1484,2734,2.227,6.329,10010,3044,6966,4.567,15.020,-5792,-8.691,12.658,77,77,2389
2012,3342,1277,1412,103409,108062,73,5.107,108,7.555,6777,1099,5678,1.017,6.271,16121,2412,13709,2.232,14.918,-9344,-8.647,12.543,83,85,1671
2012,3343,420,426,9289,9129,39,9.166,38,8.931,1054,279,775,3.056,11.546,719,132,587,1.446,7.876,335,3.670,15.752,32,32,117
2012,3344,3597,4041,279170,279785,249,6.143,274,6.760,23352,4562,18790,1.631,8.346,24855,7437,17418,2.658,8.884,-1503,-0.537,16.693,188,190,3489
2012,3345,4472,5133,384107,389193,300,5.834,319,6.203,28944,6138,22806,1.577,7.437,38988,9823,29165,2.524,10.018,-10044,-2.581,14.874,196,196,3362
2012,3346,509,522,14838,15024,54,10.218,67,12.677,1473,716,757,4.766,9.805,1883,860,1023,5.724,12.534,-410,-2.729,19.609,43,43,338
2012,3351,975,1052,43789,43769,65,6.185,63,5.994,4079,446,3633,1.019,9.319,4089,1773,2316,4.051,9.342,-10,-0.023,18.639,42,42,310
2012,3352,195,235,43438,43262,17,7.173,21,8.861,2832,328,2504,0.758,6.546,2475,984,1491,2.275,5.721,357,0.825,11.442,18,18,173
2012,3353,1819,2097,114578,112255,100,4.759,109,5.187,11326,1451,9875,1.293,10.090,6606,1615,4991,1.439,5.885,4720,4.205,11.770,70,70,648
2012,3359,1799,2080,131509,130838,141,6.845,101,4.903,11062,2049,9013,1.566,8.455,9849,1974,7875,1.509,7.528,1213,0.927,15.055,63,63,747
2012,3361,265,323,151266,144248,30,9.259,32,9.877,19892,1613,18279,1.118,13.790,6435,2929,3506,2.031,4.461,13457,9.329,8.922,24,24,1961
2012,3362,1567,1825,117815,111375,118,6.494,102,5.614,18868,1639,17229,1.472,16.941,6151,2192,3959,1.968,5.523,12717,11.418,11.046,69,69,1062
2012,3363,4090,4966,464162,449004,262,5.268,277,5.570,59093,6506,52587,1.449,13.161,28630,10854,17776,2.417,6.376,30463,6.785,12.753,175,177,1928
2012,3364,1287,1691,361274,358486,87,5.109,111,6.518,33855,2531,31324,0.706,9.444,27303,6131,21172,1.710,7.616,6552,1.828,15.232,57,58,1261
2012,3365,153,230,29512,27646,14,6.034,18,7.759,5881,265,5616,0.959,21.273,2043,751,1292,2.717,7.390,3838,13.883,14.780,6,6,255
2012,3366,1344,1464,136333,132836,127,8.723,111,7.624,17368,4596,12772,3.460,13.075,9991,1104,8887,0.831,7.521,7377,5.553,15.043,73,73,538
2012,3369,788,817,34281,35506,91,11.193,83,10.209,4115,413,3702,1.163,11.590,6459,965,5494,2.718,18.191,-2344,-6.602,23.179,55,55,479
2012,3371,10574,10854,202201,202749,866,7.851,1218,11.043,21223,4641,16582,2.289,10.468,22567,8244,14323,4.066,11.131,-1344,-0.663,20.935,843,844,4854
2012,3372,3435,3609,107628,107447,198,5.417,290,7.934,11041,1484,9557,1.381,10.276,10746,3016,7730,2.807,10.001,295,0.275,20.002,196,196,1647
2012,3379,665,752,31120,31101,34,4.376,84,10.811,3289,415,2874,1.334,10.575,3118,1488,1630,4.784,10.026,171,0.550,20.051,60,64,1066
2012,3391,10024,10902,288784,287738,644,5.878,754,6.881,27166,6817,20349,2.369,9.441,24994,7127,17867,2.477,8.686,2172,0.755,17.373,570,570,3024
2012,3399,15148,15521,258163,254511,2102,13.919,1263,8.363,33293,11426,21867,4.489,13.081,26034,8644,17390,3.396,10.229,7259,2.852,20.458,940,942,5687
2012,4231,16242,23811,370664,365605,1601,6.724,1600,6.720,49470,11827,37643,3.235,13.531,39747,11452,28295,3.132,10.872,9723,2.659,21.743,940,992,5246
2012,4232,10152,11962,142152,141625,926,7.688,1092,9.066,18748,4843,13905,3.420,13.238,17711,6324,11387,4.465,12.506,1037,0.732,25.011,708,732,3832
2012,4233,9651,15830,187095,187908,963,5.982,1500,9.318,24021,5496,18525,2.925,12.783,25676,9002,16674,4.791,13.664,-1655,-0.881,25.567,749,784,4161
2012,4234,22321,33411,651992,645259,2692,8.023,2975,8.867,91593,22144,69449,3.432,14.195,77686,24621,53065,3.816,12.040,13907,2.155,24.079,1506,1553,9778
2012,4235,7433,10238,150780,147213,612,5.965,657,6.403,20972,4845,16127,3.291,14.246,13722,4742,8980,3.221,9.321,7250,4.925,18.642,330,340,2158
2012,4236,18655,28310,514847,508255,2344,8.242,2601,9.146,73626,18931,54695,3.725,14.486,60324,17548,42776,3.453,11.869,13302,2.617,23.738,1130,1150,6226
2012,4237,10300,19015,224326,223071,1000,5.254,1034,5.433,26647,7157,19490,3.208,11.946,23753,6219,17534,2.788,10.648,2894,1.297,21.296,436,474,2544
2012,4238,39534,56322,707824,692769,3241,5.735,3613,6.394,100531,20891,79640,3.016,14.511,70122,25257,44865,3.646,10.122,30409,4.389,20.244,1719,1848,10033
2012,4239,27756,31118,342497,332928,3712,12.133,2667,8.717,55701,16865,38836,5.066,16.731,36623,13190,23433,3.962,11.000,19078,5.730,22.001,1880,1927,8929
2012,4241,7892,10139,150286,153274,522,5.017,1055,10.139,13341,3899,9442,2.544,8.704,19501,8515,10986,5.555,12.723,-6160,-4.019,17.408,459,468,2115
2012,4242,5931,9112,285494,279612,833,9.143,830,9.110,43190,15007,28183,5.367,15.446,31133,8246,22887,2.949,11.134,12057,4.312,22.269,457,462,3282
2012,4243,13361,14552,196363,193831,1655,11.370,1662,11.418,30570,8628,21942,4.451,15.772,25443,8704,16739,4.491,13.126,5127,2.645,26.253,1242,1261,6251
2012,4244,24540,31432,754402,757152,2642,8.393,2732,8.679,86544,19941,66603,2.634,11.430,91698,25283,66415,3.339,12.111,-5154,-0.681,22.860,1729,1783,12998
2012,4245,3296,6020,59827,60360,275,4.543,341,5.634,7337,1608,5729,2.664,12.155,8457,1822,6635,3.019,14.011,-1120,-1.856,24.311,170,186,857
2012,4246,8211,12560,148338,147103,731,5.797,833,6.605,19484,4687,14797,3.186,13.245,16620,6703,9917,4.557,11.298,2864,1.947,22.596,369,378,2274
2012,4247,4343,6475,101451,101793,296,4.498,508,7.719,14752,3620,11132,3.556,14.492,15521,5198,10323,5.106,15.248,-769,-0.755,28.984,212,247,1648
2012,4248,3155,4094,184201,181834,333,8.136,331,8.087,17515,4058,13457,2.232,9.632,12678,5508,7170,3.029,6.972,4837,2.660,13.945,206,206,2214
2012,4249,20235,26502,321294,318760,2422,9.156,2321,8.775,44200,12257,31943,3.845,13.866,39443,12663,26780,3.973,12.374,4757,1.492,24.748,1507,1542,6703
2012,4251,34592,36871,272036,277237,4416,11.887,4973,13.386,53383,14917,38466,5.381,19.255,62759,19678,43081,7.098,22.637,-9376,-3.382,38.511,3616,3655,11636
2012,4411,37258,42248,1101947,1078216,3589,8.510,3438,8.152,125220,34308,90912,3.182,11.614,77997,31470,46527,2.919,7.234,47223,4.380,14.468,2412,2452,20884
2012,4412,11643,13155,124027,121604,972,7.331,1178,8.885,18448,5596,12852,4.602,15.171,13613,5498,8115,4.521,11.195,4835,3.976,22.389,772,797,3562
2012,4413,27259,54955,489749,484552,2876,5.253,2475,4.520,60196,15612,44584,3.222,12.423,50061,10256,39805,2.117,10.331,10135,2.092,20.663,1565,1626,6015
2012,4421,13650,22212,192248,193985,2207,9.858,2561,11.439,25192,8651,16541,4.460,12.987,28386,11532,16854,5.945,14.633,-3194,-1.647,25.973,1317,1536,7448
2012,4422,18625,26397,230987,227653,1974,7.393,2581,9.666,36203,16682,19521,7.328,15.903,29576,12863,16713,5.650,12.992,6627,2.911,25.983,1575,1638,5175
2012,4431,23557,45307,416422,420759,4546,9.936,5440,11.890,64583,22351,42232,5.312,15.349,73116,26351,46765,6.263,17.377,-8533,-2.028,30.698,2922,3199,13261
2012,4441,36336,58141,1023502,1025389,2598,4.416,3990,6.781,73124,14744,58380,1.438,7.131,76601,21616,54985,2.108,7.470,-3477,-0.339,14.263,2433,2574,10638
2012,4442,13213,16453,143892,142437,961,5.810,1135,6.862,19532,3928,15604,2.758,13.713,16519,4580,11939,3.215,11.597,3013,2.115,23.195,762,782,3154
2012,4451,58766,85100,2592696,2569335,8940,10.597,7460,8.843,248419,88593,159826,3.448,9.669,205028,60741,144287,2.364,7.980,43391,1.689,15.960,5374,5442,26518
2012,4452,15742,19508,138135,134428,2383,12.277,2189,11.277,29504,11019,18485,8.197,21.948,22069,8758,13311,6.515,16.417,7435,5.531,32.834,1639,1660,6649
2012,4453,26397,30250,150997,149179,2642,8.794,2227,7.413,23908,8508,15400,5.703,16.026,20250,6921,13329,4.639,13.574,3658,2.452,27.149,1650,1666,4992
2012,4461,39481,86623,997513,972666,5598,6.449,5962,6.868,161181,34240,126941,3.520,16.571,108166,36670,71496,3.770,11.121,53015,5.450,22.241,2847,2971,13070
2012,4471,62041,108081,856193,854021,7895,7.306,7844,7.259,126528,45715,80813,5.353,14.816,121775,39864,81911,4.668,14.259,4753,0.557,28.518,5016,5220,24593
2012,4481,32123,91620,1299849,1304558,7688,8.386,7797,8.505,208347,70205,138142,5.382,15.971,219671,67933,151738,5.207,16.839,-11324,-0.868,31.941,3569,3935,15349
2012,4482,5474,24567,201488,204751,1186,4.785,1620,6.536,28701,8316,20385,4.062,14.018,35135,7756,27379,3.788,17.160,-6434,-3.142,28.035,527,581,2026
2012,4483,15967,22808,129081,128089,1649,7.223,1693,7.416,18971,5729,13242,4.473,14.811,16844,6339,10505,4.949,13.150,2127,1.661,26.301,1039,1062,3868
2012,4511,24848,35059,421434,414231,3148,8.982,3126,8.919,56175,19426,36749,4.690,13.561,41667,13050,28617,3.150,10.059,14508,3.502,20.118,2057,2153,7651
2012,4512,3796,8020,92319,101368,541,6.423,1347,15.992,10916,3071,7845,3.030,10.769,26969,20924,6045,20.642,26.605,-16053,-15.836,21.537,466,1100,18500
2012,4522,15,5092,600851,605873,66,1.296,70,1.374,21516,4777,16739,0.788,3.551,30389,3679,26710,0.607,5.016,-8873,-1.464,7.102,6,6,17
2012,4523,7122,41818,2265741,2247300,2846,6.920,1470,3.574,141808,39607,102201,1.762,6.310,104401,9896,94505,0.440,4.646,37407,1.665,9.291,894,975,3141
2012,4531,13052,13613,63500,64064,1056,7.612,1575,11.353,9946,3127,6819,4.881,15.525,11065,4267,6798,6.661,17.272,-1119,-1.747,31.050,1210,1222,3174
2012,4532,19353,29488,243547,248301,2407,8.020,3457,11.518,30258,10666,19592,4.296,12.186,39996,16781,23215,6.758,16.108,-9738,-3.922,24.372,2173,2245,7554
2012,4533,12548,18013,170146,164527,2100,11.886,1410,7.981,29049,11075,17974,6.731,17.656,17957,5140,12817,3.124,10.914,11092,6.742,21.829,1013,1040,3093
2012,4539,27510,36524,232865,230215,4364,12.063,3670,10.145,38089,16607,21482,7.214,16.545,32793,12271,20522,5.330,14.245,5296,2.300,28.489,2502,2592,8300
2012,4541,23769,24821,365755,355502,4661,19.594,2596,10.913,71565,24791,46774,6.974,20.131,50552,16236,34316,4.567,14.220,21013,5.911,28.440,1951,1963,8374
2012,4542,3285,3777,40891,37848,401,10.473,505,13.189,11148,3148,8000,8.318,29.455,5324,2784,2540,7.356,14.067,5824,15.388,28.134,353,363,1527
2012,4543,21174,26592,174933,174925,2624,9.873,2593,9.757,26119,8740,17379,4.996,14.932,26405,9255,17150,5.291,15.095,-286,-0.163,29.863,1706,1779,6146
2012,4811,392,2539,398004,389888,117,4.563,167,6.513,28067,3299,24768,0.846,7.199,12186,2011,10175,0.516,3.126,15881,4.073,6.251,36,38,189
2012,4812,1909,2102,36371,35576,226,10.739,231,10.976,5290,1645,3645,4.624,14.870,3591,930,2661,2.614,10.094,1699,4.776,20.188,159,160,593
2012,4831,558,879,44338,44200,86,9.734,95,10.753,3724,1026,2698,2.321,8.425,3469,869,2600,1.966,7.848,255,0.577,15.697,49,49,179
2012,4832,402,465,20671,20150,57,12.405,46,10.011,3326,769,2557,3.816,16.507,2281,872,1409,4.328,11.320,1045,5.186,22.641,33,33,118
2012,4841,46520,55718,884478,873367,9282,16.951,7363,13.446,120867,40552,80315,4.643,13.839,98609,35526,63083,4.068,11.291,22258,2.549,22.581,5328,5391,22676
2012,4842,37557,41211,449992,443502,5787,14.207,4833,11.865,84943,25585,59358,5.769,19.153,71122,25645,45477,5.782,16.036,13821,3.116,32.073,3328,3359,16319
2012,4851,516,767,47862,46797,90,11.881,71,9.373,5208,2266,2942,4.842,11.129,3100,1390,1710,2.970,6.624,2108,4.505,13.249,51,52,879
2012,4852,284,478,15064,15617,35,7.307,37,7.724,1716,653,1063,4.181,10.988,2839,340,2499,2.177,18.179,-1123,-7.191,21.977,20,20,86
2012,4853,6257,6406,72354,69479,1077,17.049,899,14.231,14114,4932,9182,7.099,20.314,8482,3648,4834,5.251,12.208,5632,8.106,24.416,705,705,2973
2012,4854,2671,4171,214019,214165,194,4.603,282,6.690,16665,3785,12880,1.767,7.781,17411,5261,12150,2.457,8.130,-746,-0.348,15.563,160,160,2301
2012,4855,1183,1299,32601,32356,114,8.722,130,9.946,4272,1264,3008,3.907,13.203,3753,1368,2385,4.228,11.599,519,1.604,23.198,100,100,1046
2012,4859,3267,3736,81010,79740,635,17.331,491,13.401,13371,4666,8705,5.852,16.768,10942,4968,5974,6.230,13.722,2429,3.046,27.444,365,367,2971
2012,4861,41,650,10422,11361,34,5.203,41,6.274,939,129,810,1.136,8.265,2674,1015,1659,8.934,23.538,-1735,-15.272,16.531,D,D,D
2012,4862,112,2167,29923,27734,391,19.181,134,6.573,7577,3988,3589,14.380,27.321,3158,972,2186,3.505,11.387,4419,15.934,22.774,D,D,D
2012,4869,43,608,6070,6207,28,4.542,45,7.299,497,136,361,2.191,8.008,782,420,362,6.767,12.600,-285,-4.592,16.015,D,D,D
2012,4871,434,477,9138,8844,67,13.958,73,15.208,1475,374,1101,4.229,16.678,900,524,376,5.925,10.176,575,6.502,20.353,65,65,496
2012,4872,1166,1212,12410,11820,177,14.695,162,13.450,2412,733,1679,6.201,20.406,1244,464,780,3.926,10.525,1168,9.882,21.049,103,103,283
2012,4879,158,178,2357,2244,25,14.085,24,13.521,387,70,317,3.119,17.246,170,48,122,2.139,7.576,217,9.670,15.152,15,15,31
2012,4881,3772,5561,163022,161851,476,8.564,470,8.456,24437,9716,14721,6.003,15.099,22277,6842,15435,4.227,13.764,2160,1.335,27.528,240,240,1905
2012,4882,480,1259,32539,31611,88,7.012,80,6.375,4600,865,3735,2.736,14.552,2732,808,1924,2.556,8.643,1868,5.909,17.285,35,35,179
2012,4883,1742,2267,93374,90966,175,7.719,175,7.719,16380,1687,14693,1.855,18.007,11952,2176,9776,2.392,13.139,4428,4.868,26.278,89,90,722
2012,4884,8653,9961,84165,82802,1211,12.253,1056,10.684,15256,5851,9405,7.066,18.425,12386,4384,8002,5.295,14.959,2870,3.466,29.917,763,765,2967
2012,4885,13571,19020,228071,226173,1783,9.393,1709,9.003,33139,9300,23839,4.112,14.652,29203,11336,17867,5.012,12.912,3936,1.740,25.824,880,934,4616
2012,4889,1140,1224,14342,14621,157,12.816,159,12.980,3121,1345,1776,9.199,21.346,3650,1828,1822,12.503,24.964,-529,-3.618,42.692,114,114,452
2012,4921,4095,8635,498678,496415,738,8.616,599,6.993,22943,6021,16922,1.213,4.622,17893,2702,15191,0.544,3.604,5050,1.017,7.209,415,416,1363
2012,4922,3797,4187,31684,31926,591,14.103,598,14.270,5411,2073,3338,6.493,16.949,5858,3100,2758,9.710,18.349,-447,-1.400,33.898,482,487,1877
2012,4931,6711,13975,713539,708481,956,6.788,1172,8.322,89867,25095,64772,3.542,12.684,79198,20347,58851,2.872,11.179,10669,1.506,22.357,324,340,3814
2012,5111,12311,17888,454681,471518,1243,6.860,1706,9.415,43755,18524,25231,3.929,9.280,77145,24882,52263,5.277,16.361,-33390,-7.081,18.559,945,988,5768
2012,5112,5355,8266,417575,406089,856,10.484,654,8.010,58795,18855,39940,4.643,14.478,35711,14790,20921,3.642,8.794,23084,5.684,17.588,338,353,6037
2012,5121,13135,16424,318908,303685,2470,15.191,2141,13.168,67386,16639,50747,5.479,22.189,39833,11469,28364,3.777,13.117,27553,9.073,26.233,1243,1262,5461
2012,5122,2787,3102,22829,22970,444,14.503,363,11.857,3035,1046,1989,4.554,13.213,3305,1167,2138,5.081,14.389,-270,-1.175,26.426,255,261,853
2012,5151,4037,8495,219941,215941,498,5.801,677,7.886,28335,7238,21097,3.352,13.122,20039,6671,13368,3.089,9.280,8296,3.842,18.560,228,241,1656
2012,5152,380,732,50677,48978,62,8.345,84,11.306,7459,1557,5902,3.179,15.229,4056,1721,2335,3.514,8.281,3403,6.948,16.563,27,27,108
2012,5173,4272,44314,1003492,1025336,4972,11.073,6149,13.694,130591,51289,79302,5.002,12.736,176451,68554,107897,6.686,17.209,-45860,-4.473,25.473,280,366,3036
2012,5174,349,447,8468,8401,60,12.834,101,21.604,1451,612,839,7.285,17.272,1347,670,677,7.975,16.034,104,1.238,32.068,59,60,456
2012,5179,3070,3529,48452,48514,527,14.608,684,18.960,8452,2678,5774,5.520,17.422,8799,3943,4856,8.128,18.137,-347,-0.715,34.844,541,547,2807
2012,5182,8783,13393,490072,477642,1969,14.661,2043,15.212,107299,28411,78888,5.948,22.464,82051,37331,44720,7.816,17.178,25248,5.286,34.357,675,703,6550
2012,5191,7362,9323,211541,199483,1597,17.602,1097,12.091,48631,19050,29581,9.550,24.379,23947,8370,15577,4.196,12.005,24684,12.374,24.009,690,697,3353
2012,5211,13,57,17939,17989,D,D,D,D,799,D,698,D,4.442,855,D,851,D,4.753,-56,-0.311,8.883,0,0,0
2012,5221,13204,125157,2020652,1995958,6304,5.071,4610,3.708,250176,67555,182621,3.385,12.534,202556,41218,161338,2.065,10.148,47620,2.386,20.297,349,522,6708
2012,5222,12970,38446,534073,549510,5567,14.395,6022,15.571,117889,35735,82154,6.503,21.453,148373,94004,54369,17.107,27.001,-30484,-5.547,42.907,1145,1276,6677
2012,5223,12145,27258,242685,240740,2756,9.982,3461,12.535,43879,11412,32467,4.740,18.227,39555,15450,24105,6.418,16.431,4324,1.796,32.861,1588,1718,6584
2012,5231,11773,44808,417903,414961,6812,15.803,3405,7.899,61686,19877,41809,4.790,14.865,57256,19384,37872,4.671,13.798,4430,1.068,27.596,759,774,3301
2012,5232,15,31,5700,5697,D,D,5,15.625,229,D,226,D,4.020,231,10,221,0.176,4.055,-2,-0.035,8.040,D,D,D
2012,5239,38757,44308,476044,462186,5705,12.980,4991,11.356,81352,32582,48770,7.050,17.602,53461,19508,33953,4.221,11.567,27891,6.035,23.134,3226,3264,10693
2012,5241,4364,30265,1422082,1409743,4325,14.625,2942,9.948,166092,72794,93298,5.164,11.782,140806,37615,103191,2.668,9.988,25286,1.794,19.976,388,403,2602
2012,5242,118618,132619,853777,850480,11043,8.310,11587,8.719,119062,39828,79234,4.683,13.999,112997,42714,70283,5.022,13.286,6065,0.713,26.573,7270,7472,21243
2012,5259,422,423,4196,3114,114,26.481,129,29.965,2717,2394,323,76.891,87.265,445,340,105,10.920,14.293,2272,72.973,28.585,104,104,280
2012,5311,85986,110288,533484,532993,10504,9.572,9407,8.572,81655,33820,47835,6.345,15.320,80701,32225,48476,6.046,15.141,954,0.179,30.282,5992,6108,19182
2012,5312,55624,65916,244882,243506,9299,14.106,9307,14.119,47057,19785,27272,8.125,19.325,44056,19110,24946,7.848,18.092,3001,1.232,36.185,5441,5558,11037
2012,5313,61120,74114,619487,610873,8719,11.800,8273,11.196,101481,42502,58979,6.958,16.612,84450,34077,50373,5.578,13.824,17031,2.788,27.649,4679,4784,18376
2012,5321,3478,13282,139531,143579,4122,34.435,1499,12.522,52536,37943,14593,26.427,36.590,59657,11267,48390,7.847,41.550,-7121,-4.960,73.181,330,380,1342
2012,5322,7680,20880,154914,163406,2059,9.435,3945,18.077,26506,9431,17075,5.772,16.221,42178,24065,18113,14.727,25.812,-15672,-9.591,32.442,924,1273,5075
2012,5323,2362,2787,16973,16979,211,7.508,258,9.180,2767,778,1989,4.582,16.297,2799,1180,1619,6.950,16.485,-32,-0.188,32.593,143,159,699
2012,5324,6985,12944,158130,153486,1136,8.773,1145,8.843,28900,8017,20883,5.223,18.829,19972,7331,12641,4.776,13.012,8928,5.817,26.025,531,557,3495
2012,5331,1983,2137,33430,32139,293,13.979,211,10.067,5960,1935,4025,6.021,18.544,3241,890,2351,2.769,10.084,2719,8.460,20.169,150,150,627
2012,5411,160058,170089,1145538,1144557,13524,7.955,13360,7.858,127856,41640,86216,3.638,11.171,125943,38190,87753,3.337,11.004,1913,0.167,22.007,9410,9500,26522
2012,5412,98995,114151,1280470,1289711,10115,8.876,9732,8.540,178202,57883,120319,4.488,13.817,194566,78648,115918,6.098,15.086,-16364,-1.269,27.634,6115,6269,45372
2012,5413,79566,95100,1327455,1318382,9342,9.801,9779,10.259,204341,56011,148330,4.248,15.499,186743,63365,123378,4.806,14.165,17598,1.335,28.329,5280,5380,21283
2012,5414,24118,24391,99775,98698,3588,14.805,3276,13.518,18102,7829,10273,7.932,18.341,16001,8115,7886,8.222,16.212,2101,2.129,32.424,2254,2257,5853
2012,5415,91187,108700,1461730,1448359,19219,17.925,16254,15.160,320582,103540,217042,7.149,22.134,293126,118153,174973,8.158,20.238,27456,1.896,40.477,9456,9523,41014
2012,5416,109210,117351,992975,963373,21776,18.846,18164,15.720,218789,86338,132451,8.962,22.711,158366,63296,95070,6.570,16.439,60423,6.272,32.877,12481,12576,37359
2012,5417,12024,15003,595103,604035,1880,12.509,1932,12.855,68665,19656,49009,3.254,11.368,85939,34350,51589,5.687,14.227,-17274,-2.860,22.735,1017,1042,6319
2012,5418,29569,32814,441767,435987,3751,11.394,3963,12.038,74381,19684,54697,4.515,17.060,62772,26044,36728,5.974,14.398,11609,2.663,28.795,2674,2695,14222
2012,5419,50180,59904,574509,573088,5460,9.120,5389,9.001,85821,26510,59311,4.626,14.975,83340,26041,57299,4.544,14.542,2481,0.433,29.085,3652,3679,15127
2012,5511,26011,51374,3054139,3032965,4766,9.302,4494,8.771,480415,115777,364638,3.817,15.840,435939,129891,306048,4.283,14.373,44476,1.466,28.747,823,868,11363
2012,5611,24850,26897,380626,374038,3860,14.576,3030,11.442,75852,33125,42727,8.856,20.279,62472,27111,35361,7.248,16.702,13380,3.577,33.404,2056,2063,15634
2012,5612,1709,5212,257564,255131,497,9.555,476,9.151,38398,11480,26918,4.500,15.050,33700,9687,24013,3.797,13.209,4698,1.841,26.418,87,94,862
2012,5613,24086,43491,4697297,4540638,4881,11.236,4784,11.012,992464,163926,828538,3.610,21.857,679335,214205,465130,4.718,14.961,313129,6.896,29.922,2566,2731,122563
2012,5614,24325,30499,757008,750298,3008,9.780,3523,11.454,121788,37154,84634,4.952,16.232,107950,38798,69152,5.171,14.388,13838,1.844,28.775,2374,2424,21677
2012,5615,12884,18272,225420,222462,1444,7.814,1860,10.065,27871,11056,16815,4.970,12.528,21833,7551,14282,3.394,9.814,6038,2.714,19.629,969,992,3405
2012,5616,17656,23779,840645,825558,2483,10.497,2233,9.440,117782,35976,81806,4.358,14.267,86761,27042,59719,3.276,10.509,31021,3.758,21.019,1369,1407,16147
2012,5617,139712,146579,1680701,1651203,21814,15.131,16994,11.788,288380,86584,201796,5.244,17.465,229313,76286,153027,4.620,13.888,59067,3.577,27.775,11317,11348,46039
2012,5619,15348,17269,260407,259744,1746,10.112,1742,10.089,42330,11242,31088,4.328,16.297,40953,14775,26178,5.688,15.767,1377,0.530,31.533,1147,1165,5878
2012,5621,7315,10240,184417,186634,826,8.059,845,8.244,30176,7897,22279,4.231,16.169,34115,12531,21584,6.714,18.279,-3939,-2.111,32.337,497,502,3282
2012,5622,1199,2341,48929,48923,142,5.979,210,8.842,6833,1950,4883,3.986,13.967,6767,2027,4740,4.143,13.832,66,0.135,27.664,94,99,650
2012,5629,7852,9217,125793,125662,887,9.612,910,9.861,24541,6546,17995,5.209,19.529,24360,9409,14951,7.488,19.385,181,0.144,38.771,485,492,3041
2012,6111,18184,20535,894418,880809,997,4.872,852,4.164,78418,17028,61390,1.933,8.903,51430,12930,38500,1.468,5.839,26988,3.064,11.678,601,609,9112
2012,6112,443,932,81669,82465,55,5.995,26,2.834,5878,1058,4820,1.283,7.128,7277,596,6681,0.723,8.824,-1399,-1.696,14.256,16,16,72
2012,6113,2202,4233,1805589,1789491,273,6.576,110,2.650,101565,7291,94274,0.407,5.676,67973,6579,61394,0.368,3.798,33592,1.877,7.597,39,39,289
2012,6114,6866,7349,64833,64845,950,13.029,835,11.452,12707,5034,7673,7.763,19.596,13029,6154,6875,9.490,20.093,-322,-0.497,39.192,487,492,1957
2012,6115,6020,7833,139021,137675,743,9.554,631,8.114,22014,6305,15709,4.580,15.990,19356,3535,15821,2.568,14.059,2658,1.931,28.118,411,423,2019
2012,6116,36177,39090,382375,373436,5355,13.983,3770,9.844,78304,24523,53781,6.567,20.969,60366,20874,39492,5.590,16.165,17938,4.804,32.330,2603,2624,12717
2012,6117,5081,5895,92191,91064,916,15.665,821,14.040,14999,4282,10717,4.702,16.471,12686,3567,9119,3.917,13.931,2313,2.540,27.862,540,541,2054
2012,6211,169817,204533,2203214,2187101,15167,7.405,15719,7.675,299963,104881,195082,4.795,13.715,266606,101351,165255,4.634,12.190,33357,1.525,24.380,10795,11073,66222
2012,6212,119223,127152,873978,864981,6389,5.041,5563,4.389,105409,33245,72164,3.843,12.186,87696,25994,61702,3.005,10.138,17713,2.048,20.277,4362,4469,20886
2012,6213,113451,128248,749410,732727,12068,9.474,10339,8.116,130431,43226,87205,5.899,17.801,98153,39121,59032,5.339,13.396,32278,4.405,26.791,5869,7417,29019
2012,6214,14968,34605,773756,762340,2860,8.394,1790,5.254,106228,34506,71722,4.526,13.934,82632,20654,61978,2.709,10.839,23596,3.095,21.679,824,940,10356
2012,6215,7189,12816,245419,245858,1257,9.849,1151,9.018,31898,10984,20914,4.468,12.974,33480,9953,23527,4.048,13.618,-1582,-0.643,25.948,611,642,4824
2012,6216,19442,27625,1251050,1223228,3371,12.424,2389,8.804,194012,43569,150443,3.562,15.861,137796,36803,100993,3.009,11.265,56216,4.596,22.530,1387,1439,17960
2012,6219,6058,9401,287377,283658,820,8.738,786,8.376,41947,11279,30668,3.976,14.788,34619,11914,22705,4.200,12.204,7328,2.583,24.409,410,422,6402
2012,6221,2820,5022,5251440,5208318,96,1.917,69,1.378,274648,55738,218910,1.070,5.273,190831,20455,170376,0.393,3.664,83817,1.609,7.328,35,38,8383
2012,6222,415,592,226572,225018,11,1.847,18,3.023,22410,2346,20064,1.043,9.959,19392,4905,14487,2.180,8.618,3018,1.341,17.236,15,15,4394
2012,6223,345,882,271206,267413,27,3.068,23,2.614,19753,4112,15641,1.538,7.387,12304,2335,9969,0.873,4.601,7449,2.786,9.202,8,8,1308
2012,6231,8138,16027,1675327,1663231,923,5.770,861,5.383,148825,65894,82931,3.962,8.948,124548,42206,82342,2.538,7.488,24277,1.460,14.977,439,447,27788
2012,6232,9330,35976,698486,691810,1806,5.040,1525,4.256,84062,16261,67801,2.351,12.151,71199,14845,56354,2.146,10.292,12863,1.859,20.583,323,400,4755
2012,6233,15105,21290,821034,813567,1696,8.028,1370,6.485,84509,28561,55948,3.511,10.387,68776,24383,44393,2.997,8.454,15733,1.934,16.907,928,959,15920
2012,6239,2928,4973,130292,131914,282,5.531,533,10.454,14489,2678,11811,2.030,10.984,17697,6301,11396,4.777,13.416,-3208,-2.432,21.967,193,208,2465
2012,6241,44079,60464,1452598,1432400,5885,9.836,4617,7.717,195952,45357,150595,3.167,13.680,155254,36938,118316,2.579,10.839,40698,2.841,21.677,2604,2674,17765
2012,6242,10005,14038,178420,177492,1064,7.674,718,5.179,25695,9236,16459,5.204,14.477,23801,5550,18251,3.127,13.410,1894,1.067,26.819,318,358,2787
2012,6243,4035,7615,328987,339262,361,4.672,586,7.583,43139,10406,32733,3.067,12.716,64219,19791,44428,5.834,18.929,-21080,-6.213,25.431,174,180,5959
2012,6244,55546,70619,869236,870039,6326,8.935,6695,9.456,111428,36786,74642,4.228,12.807,113173,40318,72855,4.634,13.008,-1745,-0.201,25.614,4571,4659,26881
2012,7111,6848,6984,116955,114725,888,12.843,749,10.832,21110,6174,14936,5.382,18.401,16712,5141,11571,4.481,14.567,4398,3.834,29.134,499,500,3768
2012,7112,3229,3388,120253,119639,470,13.903,455,13.460,15402,4285,11117,3.582,12.874,14255,2807,11448,2.346,11.915,1147,0.959,23.830,328,329,1942
2012,7113,5466,5767,139252,137594,654,11.399,595,10.370,18637,3060,15577,2.224,13.545,15419,4394,11025,3.193,11.206,3218,2.339,22.412,399,403,2384
2012,7114,2838,2946,17307,17415,407,13.929,359,12.286,3131,1138,1993,6.535,17.979,3320,1446,1874,8.303,19.065,-189,-1.085,35.959,247,249,657
2012,7115,13900,13939,41918,41197,2571,18.698,2194,15.956,11115,5776,5339,14.021,26.980,9649,4741,4908,11.508,23.422,1466,3.559,46.844,1285,1285,2865
2012,7121,6397,6840,136739,132998,362,5.324,281,4.133,14335,2117,12218,1.592,10.778,6952,1279,5673,0.962,5.227,7383,5.551,10.454,154,154,739
2012,7131,2376,2724,162764,155371,408,15.148,347,12.883,26938,4932,22006,3.174,17.338,11468,2609,8859,1.679,7.381,15470,9.957,14.762,236,238,2017
2012,7132,1814,2736,152397,148208,290,10.753,212,7.861,16364,6190,10174,4.177,11.041,8409,2401,6008,1.620,5.674,7955,5.367,11.348,152,158,1837
2012,7139,48334,55492,1177733,1156505,6224,11.290,5492,9.963,171200,60730,110470,5.251,14.803,128720,43143,85577,3.730,11.130,42480,3.673,22.260,3999,4051,29208
2012,7211,38673,49881,1891244,1875896,4101,8.252,3735,7.515,198268,87367,110901,4.657,10.569,168144,70558,97586,3.761,8.963,30124,1.606,17.927,2337,2384,39169
2012,7212,5311,5888,40982,40116,469,7.990,433,7.376,7220,1516,5704,3.779,17.998,5573,1150,4423,2.867,13.892,1647,4.106,27.785,249,251,703
2012,7213,1897,2023,11616,11068,128,6.312,138,6.805,2272,1113,1159,10.056,20.528,1164,399,765,3.605,10.517,1108,10.011,21.034,100,100,308
2012,7223,12462,34643,675900,671461,5093,14.468,6213,17.649,136768,48935,87833,7.288,20.369,127372,52508,74864,7.820,18.969,9396,1.399,37.939,1417,1428,9655
2012,7224,37702,38553,349166,342178,4044,10.456,4294,11.102,70452,32779,37673,9.580,20.589,56456,24975,31481,7.299,16.499,13996,4.090,32.998,3450,3455,20519
2012,7225,343174,471094,9016072,8858520,51911,11.111,44144,9.448,1436038,639733,796305,7.222,16.211,1117963,427001,690962,4.820,12.620,318075,3.591,25.240,33751,34899,303079
2012,8111,133733,146220,811460,805631,12500,8.584,11299,7.759,119938,42046,77892,5.219,14.887,107623,37480,70143,4.652,13.359,12315,1.529,26.718,8171,8277,26220
2012,8112,9785,11098,100205,102076,1207,10.812,1339,11.994,13960,4494,9466,4.403,13.676,17686,7692,9994,7.536,17.326,-3726,-3.650,27.352,868,950,4425
2012,8113,17778,19385,189037,182665,1791,9.303,1526,7.926,34823,9761,25062,5.344,19.064,21680,8541,13139,4.676,11.869,13143,7.195,23.738,1004,1007,3935
2012,8114,16767,17448,64838,64720,2003,11.528,1858,10.693,10957,4538,6419,7.012,16.930,10669,4545,6124,7.023,16.485,288,0.445,32.970,1319,1332,3119
2012,8121,89509,105939,639873,635559,13578,12.978,10952,10.468,113843,53575,60268,8.430,17.912,104711,40344,64367,6.348,16.475,9132,1.437,32.951,8237,8342,29427
2012,8122,14422,20074,136995,136393,751,3.747,687,3.428,17133,3078,14055,2.257,12.561,15660,2453,13207,1.798,11.482,1473,1.080,22.963,426,440,1739
2012,8123,28488,33780,291355,293571,2459,7.231,2912,8.563,37586,11188,26398,3.811,12.803,42120,14302,27818,4.872,14.347,-4534,-1.544,25.606,2173,2254,9212
2012,8129,23316,33135,253020,249305,5182,15.720,4839,14.680,55860,23300,32560,9.346,22.406,48469,24774,23695,9.937,19.442,7391,2.965,38.883,2101,2318,9997
2012,8131,176186,176511,1682678,1675062,8729,4.966,7273,4.137,155068,29009,126059,1.732,9.257,139907,19721,120186,1.177,8.352,15161,0.905,16.705,4661,4667,13613
2012,8132,15900,18007,176442,174275,1506,8.463,1084,6.091,20017,5805,14212,3.331,11.486,15690,4846,10844,2.781,9.003,4327,2.483,18.006,727,728,2913
2012,8133,13539,15892,150838,147761,1279,8.094,1098,6.949,21125,4817,16308,3.260,14.297,14982,4494,10488,3.041,10.139,6143,4.157,20.279,633,635,2194
2012,8134,23175,24933,229022,228717,1236,4.940,1412,5.643,26993,4881,22112,2.134,11.802,26375,6424,19951,2.809,11.532,618,0.270,23.063,905,915,3799
2012,8139,55116,57318,498611,493818,2803,4.892,2772,4.837,55156,12075,43081,2.445,11.169,45985,10235,35750,2.073,9.312,9171,1.857,18.624,1844,1863,6794
2013,1131,353,401,3032,2582,86,23.149,27,7.268,1033,835,198,32.346,40.015,183,75,108,2.905,7.089,850,32.927,14.178,15,15,29
2013,1132,112,128,1579,1576,15,11.152,28,20.818,202,31,171,1.968,12.821,201,87,114,5.522,12.758,1,0.063,25.516,20,20,49
2013,1133,7031,7121,49379,49071,660,9.210,751,10.479,7337,2080,5257,4.239,14.952,6669,2250,4419,4.585,13.591,668,1.361,27.181,530,530,1706
2013,1141,1190,1201,5954,5949,184,15.308,186,15.474,1001,340,661,5.716,16.828,967,358,609,6.018,16.256,34,0.572,32.512,85,85,179
2013,1142,258,258,1414,1451,38,14.990,29,11.440,180,94,86,6.481,12.410,253,75,178,5.171,17.442,-73,-5.033,24.819,15,15,58
2013,1151,3541,3872,63759,64652,409,10.607,377,9.777,8365,1993,6372,3.083,12.939,10117,4516,5601,6.985,15.649,-1752,-2.710,25.877,254,254,3263
2013,1152,3671,3774,18301,18628,435,11.531,432,11.451,2693,1058,1635,5.680,14.457,3412,1427,1985,7.661,18.317,-719,-3.860,28.913,342,342,1255
2013,1153,1225,1308,10457,10483,144,10.913,167,12.656,2116,828,1288,7.899,20.186,2232,1123,1109,10.713,21.293,-116,-1.107,40.372,117,117,974
2013,2111,5873,7350,130727,129219,622,8.458,630,8.567,19914,6029,13885,4.666,15.411,16987,5488,11499,4.247,13.146,2927,2.265,26.292,390,393,1570
2013,2121,484,913,85105,86296,77,8.191,131,13.936,7906,4327,3579,5.014,9.161,10348,2460,7888,2.851,11.991,-2442,-2.830,18.323,64,64,1024
2013,2122,261,329,41291,40647,41,12.519,38,11.603,3769,364,3405,0.896,9.273,2461,243,2218,0.598,6.055,1308,3.218,12.109,27,27,198
2013,2123,2744,4814,77021,75990,283,5.845,339,7.001,10894,3163,7731,4.162,14.336,8712,2145,6567,2.823,11.465,2182,2.871,22.929,181,182,938
2013,2131,10416,12926,396618,394016,1665,12.996,1436,11.209,73594,20120,53474,5.106,18.678,68739,25812,42927,6.551,17.446,4855,1.232,34.891,892,922,9269
2013,2211,1693,10398,510846,512263,595,5.762,451,4.368,35355,12664,22691,2.472,6.902,38171,8666,29505,1.692,7.451,-2816,-0.550,13.803,67,74,1394
2013,2212,426,2459,83169,83472,198,8.121,156,6.399,7589,3621,3968,4.338,9.092,8200,1728,6472,2.070,9.824,-611,-0.732,18.183,28,30,159
2013,2213,3458,4596,41891,42787,211,4.560,273,5.900,3065,775,2290,1.811,7.163,4829,1608,3221,3.758,11.286,-1764,-4.123,14.327,111,111,509
2013,2361,122256,123403,559678,545671,23027,18.831,20781,16.995,145139,62505,82634,11.455,26.598,117242,53712,63530,9.843,21.486,27897,5.112,42.972,12867,12872,35536
2013,2362,35353,36680,560714,554429,3653,9.897,4114,11.146,101467,18899,82568,3.409,18.301,88362,21994,66368,3.967,15.937,13105,2.364,31.875,2749,2768,14387
2013,2371,15972,17433,515396,503323,1486,8.465,1728,9.844,108582,19839,88743,3.942,21.573,85408,21110,64298,4.194,16.969,23174,4.604,33.938,1070,1109,15091
2013,2372,4647,4711,23662,23933,430,8.862,712,14.674,3964,1396,2568,5.833,16.563,4467,1978,2489,8.265,18.665,-503,-2.102,33.127,535,535,1506
2013,2373,8108,8900,252875,257300,544,6.020,816,9.031,32909,4651,28258,1.808,12.790,41535,6362,35173,2.473,16.143,-8626,-3.353,25.580,466,468,3606
2013,2379,3498,3603,81328,81319,375,10.309,444,12.206,13010,2835,10175,3.486,15.999,12919,3459,9460,4.254,15.887,91,0.112,31.774,267,268,1390
2013,2381,69142,69865,676255,669114,8861,12.539,10470,14.815,150909,35500,115409,5.306,22.554,136918,43589,93329,6.514,20.463,13991,2.091,40.925,6240,6252,29634
2013,2382,150132,154068,1675513,1646895,14853,9.670,13928,9.067,276000,54346,221654,3.300,16.759,218537,59623,158914,3.620,13.270,57463,3.489,26.539,9498,9525,41305
2013,2383,86315,87292,632622,621325,11640,13.330,11705,13.404,132836,34224,98612,5.508,21.379,110168,36913,73255,5.941,17.731,22668,3.648,35.462,7523,7526,26185
2013,2389,51003,51683,479669,475153,6412,12.384,6600,12.747,89594,23087,66507,4.859,18.856,80505,24794,55711,5.218,16.943,9089,1.913,33.886,3904,3907,16680
2013,3111,1032,1631,46237,45381,94,5.760,96,5.882,5736,1612,4124,3.552,12.640,4065,1659,2406,3.656,8.957,1671,3.682,17.915,63,63,739
2013,3112,460,809,55186,54824,55,6.879,36,4.503,4508,1529,2979,2.789,8.223,3657,877,2780,1.600,6.670,851,1.552,13.341,22,22,110
2013,3113,1617,1782,73975,72175,161,9.200,97,5.543,8681,926,7755,1.283,12.028,5176,1644,3532,2.278,7.172,3505,4.856,14.343,73,73,454
2013,3114,1282,1640,156493,155957,111,6.764,113,6.886,11858,1594,10264,1.022,7.603,10860,3080,7780,1.975,6.963,998,0.640,13.927,81,81,1682
2013,3115,1059,1556,134922,134281,113,7.316,90,5.827,9423,1480,7943,1.102,7.017,8071,2281,5790,1.699,6.011,1352,1.007,12.021,60,60,532
2013,3116,2821,3420,477648,482523,172,5.016,190,5.541,21914,3033,18881,0.629,4.542,31698,8176,23522,1.694,6.569,-9784,-2.028,9.083,137,137,4052
2013,3117,443,538,31509,31836,33,6.077,43,7.919,2702,450,2252,1.413,8.487,3428,765,2663,2.403,10.768,-726,-2.280,16.974,28,29,610
2013,3118,9331,10026,272180,274693,961,9.623,883,8.841,28823,7791,21032,2.836,10.493,33222,16733,16489,6.092,12.094,-4399,-1.601,20.986,674,683,4629
2013,3119,2657,3082,176159,170499,262,8.526,244,7.940,23152,4421,18731,2.593,13.579,12260,4068,8192,2.386,7.191,10892,6.388,14.381,163,166,1833
2013,3121,4442,5044,145047,140291,861,18.151,260,5.481,17814,4701,13113,3.351,12.698,8290,1942,6348,1.384,5.909,9524,6.789,11.818,172,177,962
2013,3122,93,113,14457,14672,11,9.735,11,9.735,642,120,522,0.818,4.376,1093,296,797,2.017,7.450,-451,-3.074,8.751,6,6,49
2013,3131,242,310,24797,24874,23,7.504,16,5.220,1270,247,1023,0.993,5.106,1381,251,1130,1.009,5.552,-111,-0.446,10.212,10,11,79
2013,3132,834,915,50496,50596,53,5.758,64,6.953,3704,545,3159,1.077,7.321,3935,1221,2714,2.413,7.777,-231,-0.457,14.641,38,40,404
2013,3133,1019,1066,29529,30028,120,11.500,75,7.187,2931,808,2123,2.691,9.761,4052,1555,2497,5.179,13.494,-1121,-3.733,19.522,54,54,334
2013,3141,1696,1809,53182,52247,95,5.138,175,9.465,5159,813,4346,1.556,9.874,3217,1062,2155,2.033,6.157,1942,3.717,12.315,129,129,435
2013,3149,3932,4033,59855,60871,383,9.529,356,8.857,6516,1566,4950,2.573,10.705,8439,2676,5763,4.396,13.864,-1923,-3.159,21.409,258,258,1508
2013,3151,241,254,12243,12496,12,4.642,21,8.124,689,38,651,0.304,5.514,1158,551,607,4.409,9.267,-469,-3.753,11.028,18,18,180
2013,3152,4851,4896,91421,90259,770,15.703,785,16.009,17872,9022,8850,9.996,19.801,15696,6651,9045,7.369,17.390,2176,2.411,34.780,686,686,6010
2013,3159,505,513,8040,8144,57,11.100,58,11.295,880,321,559,3.942,10.806,1074,492,582,6.041,13.188,-194,-2.382,21.611,41,41,354
2013,3161,171,181,3546,3526,15,8.357,12,6.685,267,69,198,1.957,7.573,222,34,188,0.964,6.297,45,1.276,12.594,8,8,29
2013,3162,176,194,11602,11445,15,7.634,20,10.178,1199,61,1138,0.533,10.476,933,144,789,1.258,8.152,266,2.324,16.304,16,16,53
2013,3169,649,652,11137,11619,55,8.359,67,10.182,939,186,753,1.601,8.082,1881,783,1098,6.739,16.189,-942,-8.107,16.163,47,47,530
2013,3211,2633,3007,77075,76613,190,6.220,285,9.330,8032,2172,5860,2.835,10.484,7007,2959,4048,3.862,9.146,1025,1.338,18.292,197,201,1616
2013,3212,1075,1349,64362,62201,53,3.867,96,7.005,8505,1389,7116,2.233,13.673,4106,1808,2298,2.907,6.601,4399,7.072,13.202,65,66,895
2013,3219,7438,8310,212416,208398,541,6.459,673,8.035,27666,4682,22984,2.247,13.276,19745,7551,12194,3.623,9.475,7921,3.801,18.949,478,478,4877
2013,3221,221,433,107458,108031,11,2.511,21,4.795,4204,715,3489,0.662,3.891,5349,2358,2991,2.183,4.951,-1145,-1.060,7.783,6,6,555
2013,3222,2532,3823,244889,245135,133,3.461,172,4.476,14978,3252,11726,1.327,6.110,15655,4111,11544,1.677,6.386,-677,-0.276,12.220,101,103,1373
2013,3231,24194,25436,463451,468774,1343,5.198,2144,8.298,36179,9080,27099,1.937,7.718,46938,16668,30270,3.556,10.013,-10759,-2.295,15.436,1710,1714,10909
2013,3241,921,2094,97748,98178,109,5.167,140,6.637,6062,1134,4928,1.155,6.174,6874,1441,5433,1.468,7.002,-812,-0.827,12.349,44,47,299
2013,3251,1324,2397,158259,157071,86,3.557,128,5.294,12863,2785,10078,1.773,8.189,10638,2727,7911,1.736,6.773,2225,1.417,13.546,76,79,1547
2013,3252,1050,1384,91532,91080,62,4.490,56,4.055,6691,1517,5174,1.666,7.346,5725,1486,4239,1.632,6.286,966,1.061,12.571,34,34,858
2013,3253,629,869,29034,29250,57,6.552,59,6.782,2132,333,1799,1.138,7.289,2574,707,1867,2.417,8.800,-442,-1.511,14.578,38,38,317
2013,3254,1580,2033,233343,233250,149,7.389,116,5.753,23653,9468,14185,4.059,10.141,24548,2736,21812,1.173,10.524,-895,-0.384,20.281,83,83,1661
2013,3255,1276,1610,56847,55882,54,3.324,83,5.109,5926,1516,4410,2.713,10.605,3978,1546,2432,2.767,7.119,1948,3.486,14.237,55,55,443
2013,3256,1885,2075,94664,93987,120,5.758,138,6.622,7278,841,6437,0.895,7.744,5948,1819,4129,1.935,6.329,1330,1.415,12.657,104,104,866
2013,3259,1749,2229,79739,80355,111,4.926,160,7.100,7139,2103,5036,2.617,8.884,8243,2241,6002,2.789,10.258,-1104,-1.374,17.769,109,109,969
2013,3261,8087,10331,580931,577387,434,4.176,559,5.378,51396,8288,43108,1.435,8.901,44318,15309,29009,2.651,7.676,7078,1.226,15.351,364,376,7674
2013,3262,1456,1857,127889,128235,56,2.993,84,4.490,7408,971,6437,0.757,5.777,8250,1027,7223,0.801,6.434,-842,-0.657,11.554,53,53,498
2013,3271,921,1100,32816,33405,66,5.895,105,9.379,2537,386,2151,1.156,7.595,3788,927,2861,2.775,11.340,-1251,-3.745,15.189,74,74,475
2013,3272,1385,1649,85540,84411,100,5.990,141,8.446,7349,757,6592,0.897,8.706,5116,1970,3146,2.334,6.061,2233,2.645,12.122,100,101,1101
2013,3273,4047,8285,150215,148569,322,3.843,511,6.098,20960,5417,15543,3.646,14.108,18015,4689,13326,3.156,12.126,2945,1.982,24.251,196,201,1933
2013,3274,168,297,12201,12254,12,4.007,17,5.676,681,106,575,0.865,5.557,792,297,495,2.424,6.463,-111,-0.906,11.115,12,12,74
2013,3279,2521,2998,70236,69982,162,5.370,200,6.629,6565,1399,5166,1.999,9.381,6066,1818,4248,2.598,8.668,499,0.713,17.336,136,137,974
2013,3311,316,468,103118,103623,40,8.762,17,3.724,3722,693,3029,0.669,3.592,4810,1336,3474,1.289,4.642,-1088,-1.050,7.184,9,9,107
2013,3312,516,640,48313,48185,31,4.817,38,5.905,3565,492,3073,1.021,7.399,3281,380,2901,0.789,6.809,284,0.589,13.618,30,30,344
2013,3313,398,531,56396,55407,19,3.558,25,4.682,5196,1238,3958,2.234,9.378,3211,1318,1893,2.379,5.795,1985,3.583,11.591,16,16,177
2013,3314,772,967,61328,61576,42,4.346,41,4.242,3538,771,2767,1.252,5.746,4054,697,3357,1.132,6.584,-516,-0.838,11.492,30,31,470
2013,3315,1567,1768,124639,125606,56,3.149,77,4.329,8083,1337,6746,1.064,6.435,10037,1697,8340,1.351,7.991,-1954,-1.556,12.870,57,57,800
2013,3321,2228,2450,113082,112835,53,2.147,91,3.686,7935,1070,6865,0.948,7.032,7452,1276,6176,1.131,6.604,483,0.428,13.209,61,61,646
2013,3322,1044,1128,35507,35776,40,3.495,73,6.378,2044,134,1910,0.375,5.713,2602,823,1779,2.300,7.273,-558,-1.560,11.427,50,50,574
2013,3323,10810,11735,328220,323997,590,4.997,735,6.225,36916,6184,30732,1.909,11.394,28389,7865,20524,2.427,8.762,8527,2.632,17.524,518,529,4929
2013,3324,1182,1489,90103,88914,61,4.095,62,4.162,8461,1635,6826,1.839,9.516,6081,1255,4826,1.411,6.839,2380,2.677,13.678,46,46,711
2013,3325,518,570,25329,26040,28,4.891,33,5.764,1408,155,1253,0.595,5.407,2800,752,2048,2.888,10.753,-1392,-5.346,10.814,20,20,168
2013,3326,1083,1219,38775,38287,32,2.586,69,5.576,3681,933,2748,2.437,9.614,2727,804,1923,2.100,7.123,954,2.492,14.245,43,45,399
2013,3327,21973,22448,387109,385895,1046,4.642,1212,5.379,36832,7514,29318,1.947,9.545,34337,10284,24053,2.665,8.898,2495,0.647,17.796,912,915,6679
2013,3328,5008,5538,125790,124304,248,4.458,298,5.357,13009,2752,10257,2.214,10.466,9885,3006,6879,2.418,7.952,3124,2.513,15.905,225,226,1793
2013,3329,5551,6087,260803,257714,389,6.402,368,6.056,25031,3152,21879,1.223,9.713,18661,5072,13589,1.968,7.241,6370,2.472,14.482,262,263,2503
2013,3331,2542,2931,214669,213534,177,6.052,164,5.608,19444,2932,16512,1.373,9.106,17487,4582,12905,2.146,8.189,1957,0.916,16.379,119,119,2372
2013,3332,2972,3129,99694,97898,150,4.790,155,4.950,10377,1802,8575,1.841,10.600,6948,1733,5215,1.770,7.097,3429,3.503,14.194,111,112,1066
2013,3333,1811,1935,76302,77239,105,5.403,122,6.277,5339,1132,4207,1.466,6.912,7168,1831,5337,2.371,9.280,-1829,-2.368,13.825,78,78,612
2013,3334,1493,1754,127572,128037,84,4.750,113,6.390,10069,1419,8650,1.108,7.864,10862,3823,7039,2.986,8.484,-793,-0.619,15.728,70,71,669
2013,3335,6216,6437,146847,144289,223,3.443,301,4.648,14086,2568,11518,1.780,9.762,8913,2535,6378,1.757,6.177,5173,3.585,12.354,225,225,1685
2013,3336,842,1038,101786,104330,34,3.265,41,3.937,6551,375,6176,0.359,6.279,11835,3247,8588,3.112,11.344,-5284,-5.065,12.558,20,20,1019
2013,3339,5222,5871,286573,282738,255,4.336,275,4.676,24946,4672,20274,1.652,8.823,17279,4950,12329,1.751,6.111,7667,2.712,12.223,180,180,1453
2013,3341,954,989,61931,62618,71,7.129,85,8.534,3577,882,2695,1.409,5.712,4912,1486,3426,2.373,7.844,-1335,-2.132,11.425,56,56,469
2013,3342,1231,1358,102945,102985,74,5.362,118,8.551,7970,771,7199,0.749,7.739,8298,1604,6694,1.558,8.058,-328,-0.318,15.478,90,91,527
2013,3343,417,426,8791,8791,39,9.176,37,8.706,1136,219,917,2.491,12.922,1108,679,429,7.724,12.604,28,0.319,25.208,32,32,295
2013,3344,3505,3946,268424,273824,185,4.642,263,6.600,15421,2752,12669,1.005,5.632,26190,6966,19224,2.544,9.565,-10769,-3.933,11.263,190,192,3370
2013,3345,4404,5054,385152,383958,260,5.111,327,6.428,30940,5131,25809,1.336,8.058,28790,7359,21431,1.917,7.498,2150,0.560,14.996,212,212,2841
2013,3346,487,499,14005,14414,37,7.248,60,11.753,803,141,662,0.978,5.571,1618,696,922,4.829,11.226,-815,-5.654,11.142,45,45,483
2013,3351,965,1038,42970,43324,58,5.550,72,6.890,3302,576,2726,1.330,7.622,3997,933,3064,2.154,9.226,-695,-1.604,15.243,52,52,407
2013,3352,224,263,44222,43870,26,10.156,12,4.688,3115,529,2586,1.206,7.101,2333,1192,1141,2.717,5.318,782,1.783,10.636,7,7,51
2013,3353,1812,2092,115594,115030,96,4.586,99,4.729,8221,1006,7215,0.875,7.147,7119,2254,4865,1.959,6.189,1102,0.958,12.378,68,68,994
2013,3359,1763,2046,130307,131702,86,4.184,105,5.108,8586,1122,7464,0.852,6.519,11342,3451,7891,2.620,8.612,-2756,-2.093,13.039,64,64,898
2013,3361,259,314,161964,156602,23,7.244,30,9.449,17316,463,16853,0.296,11.057,6862,1384,5478,0.884,4.382,10454,6.676,8.764,21,21,211
2013,3362,1554,1813,120146,118666,111,6.117,114,6.283,12626,1704,10922,1.436,10.640,9764,2034,7730,1.714,8.228,2862,2.412,16.456,74,78,1192
2013,3363,4034,4915,489318,475594,259,5.257,282,5.724,58295,7527,50768,1.583,12.257,30859,7251,23608,1.525,6.489,27436,5.769,12.977,184,187,2189
2013,3364,1270,1670,362588,361569,96,5.725,110,6.559,25686,2135,23551,0.590,7.104,23731,4340,19391,1.200,6.563,1955,0.541,13.127,71,71,1019
2013,3365,149,226,30893,30288,20,8.909,17,7.572,5222,1769,3453,5.841,17.241,3803,697,3106,2.301,12.556,1419,4.685,25.113,10,10,217
2013,3366,1294,1410,135476,135861,103,7.218,137,9.601,11619,1009,10610,0.743,8.552,12134,6973,5161,5.132,8.931,-515,-0.379,17.104,96,97,1174
2013,3369,791,820,32805,33660,88,10.751,85,10.385,4441,2327,2114,6.913,13.194,6300,1257,5043,3.734,18.717,-1859,-5.523,26.387,57,57,326
2013,3371,10338,10603,207953,205624,800,7.465,1028,9.592,22181,4093,18088,1.991,10.787,17481,6558,10923,3.189,8.501,4700,2.286,17.003,715,717,4425
2013,3372,3401,3567,105147,106126,192,5.339,250,6.952,9213,1782,7431,1.679,8.681,11021,4123,6898,3.885,10.385,-1808,-1.704,17.362,176,178,1469
2013,3379,663,755,31499,31361,45,5.960,45,5.960,2662,580,2082,1.849,8.488,2403,667,1736,2.127,7.663,259,0.826,15.325,35,35,484
2013,3391,9752,10631,286255,287089,593,5.514,841,7.820,22570,3979,18591,1.386,7.862,24194,6185,18009,2.154,8.427,-1624,-0.566,15.723,617,622,3151
2013,3399,14145,14513,256966,257025,1423,9.797,1447,9.962,26697,6018,20679,2.341,10.387,26669,9814,16855,3.818,10.376,28,0.011,20.752,1124,1127,6686
2013,4231,15884,23565,371518,368324,1577,6.677,1685,7.134,44672,9803,34869,2.662,12.128,38124,11399,26725,3.095,10.351,6548,1.778,20.701,1118,1184,6938
2013,4232,9883,11683,143547,142572,941,8.023,1033,8.807,16824,4492,12332,3.151,11.800,14720,5728,8992,4.018,10.325,2104,1.476,20.649,746,773,3570
2013,4233,9514,15717,194568,191053,1013,6.422,1129,7.157,25190,6195,18995,3.243,13.185,18229,6838,11391,3.579,9.541,6961,3.643,19.083,652,672,3867
2013,4234,21849,33143,664459,660692,2951,8.877,3155,9.490,86840,31099,55741,4.707,13.144,79845,34564,45281,5.231,12.085,6995,1.059,24.170,1628,1667,10674
2013,4235,7301,10058,151234,150916,463,4.560,652,6.422,15315,3126,12189,2.071,10.148,14671,4000,10671,2.650,9.721,644,0.427,19.443,390,390,2149
2013,4236,18291,28006,521483,517467,2159,7.695,2264,8.069,100268,45036,55232,8.703,19.377,91879,26220,65659,5.067,17.756,8389,1.621,35.511,1179,1202,6631
2013,4237,10126,18817,226485,224991,1008,5.343,1105,5.857,24384,7550,16834,3.356,10.838,21811,5863,15948,2.606,9.694,2573,1.144,19.388,530,578,2971
2013,4238,38838,56000,733245,720637,3230,5.767,3243,5.790,92686,22968,69718,3.187,12.862,68027,20466,47561,2.840,9.440,24659,3.422,18.880,1931,2010,10933
2013,4239,27935,31421,337699,340304,3308,10.588,2952,9.449,42926,13827,29099,4.063,12.614,47725,17302,30423,5.084,14.024,-4799,-1.410,25.228,2224,2247,11591
2013,4241,7632,9847,147306,147878,498,5.002,716,7.192,11272,2491,8781,1.684,7.622,12453,3821,8632,2.584,8.421,-1181,-0.799,15.245,470,480,2291
2013,4242,5958,9171,293754,287650,953,10.477,803,8.828,39294,13264,26030,4.611,13.660,27300,6386,20914,2.220,9.491,11994,4.170,18.981,476,481,3453
2013,4243,13231,14399,198140,196003,1485,10.296,1533,10.629,29351,8077,21274,4.121,14.975,24982,8044,16938,4.104,12.746,4369,2.229,25.492,1213,1228,5280
2013,4244,24400,31280,771719,762161,2971,9.489,3028,9.671,117309,26982,90327,3.540,15.392,96058,36055,60003,4.731,12.603,21251,2.788,25.207,1792,1843,12083
2013,4245,3244,5961,60591,60439,268,4.480,310,5.182,6617,1132,5485,1.873,10.948,6241,1854,4387,3.068,10.326,376,0.622,20.652,150,161,971
2013,4246,8069,12443,153019,150727,829,6.643,901,7.220,21612,6202,15410,4.115,14.339,16962,6147,10815,4.078,11.253,4650,3.085,22.507,430,437,1896
2013,4247,4213,6379,102057,101342,366,5.694,464,7.218,16042,3416,12626,3.371,15.830,14420,5388,9032,5.317,14.229,1622,1.601,28.458,230,238,2208
2013,4248,3201,4131,187898,185468,374,9.110,323,7.867,16245,3310,12935,1.785,8.759,11426,4830,6596,2.604,6.161,4819,2.598,12.321,226,239,2988
2013,4249,20175,26480,327049,326056,2233,8.430,2250,8.494,38595,10816,27779,3.317,11.837,36681,11859,24822,3.637,11.250,1914,0.587,22.500,1569,1582,6943
2013,4251,36343,38695,286469,282994,4518,11.709,4300,11.144,46792,21411,25381,7.566,16.535,39715,17562,22153,6.206,14.034,7077,2.501,28.068,3133,3143,9752
2013,4411,37393,42628,1138302,1119887,3658,8.625,3228,7.611,117425,35359,82066,3.157,10.485,80801,26893,53908,2.401,7.215,36624,3.270,14.430,2451,2479,20459
2013,4412,11445,12965,126894,125729,875,6.711,1023,7.846,16453,4574,11879,3.638,13.086,14247,5066,9181,4.029,11.332,2206,1.755,22.663,720,737,3679
2013,4413,26980,54910,492661,491739,2645,4.813,2741,4.987,56133,13949,42184,2.837,11.415,54582,12560,42022,2.554,11.100,1551,0.315,22.200,1675,1778,7056
2013,4421,13381,22236,194490,193380,1871,8.408,1906,8.565,25738,9351,16387,4.836,13.310,23512,8719,14793,4.509,12.158,2226,1.151,24.317,1231,1361,6233
2013,4422,18122,26029,228263,229295,1841,7.035,2120,8.101,30163,8455,21708,3.687,13.155,31706,10807,20899,4.713,13.828,-1543,-0.673,26.309,1352,1398,3984
2013,4431,22853,44802,405637,413888,3489,7.676,4793,10.545,46778,16870,29908,4.076,11.302,63945,23042,40903,5.567,15.450,-17167,-4.148,22.604,2832,3035,11739
2013,4441,35608,57370,1088264,1055475,2472,4.284,3131,5.426,114240,13070,101170,1.238,10.824,49556,14572,34984,1.381,4.695,64684,6.128,9.390,2062,2119,8706
2013,4442,12847,16382,144987,143896,1145,6.991,1138,6.948,19060,7038,12022,4.891,13.246,16585,4441,12144,3.086,11.526,2475,1.720,23.051,783,793,2931
2013,4451,59600,85902,2603255,2597734,8616,10.100,7423,8.702,216985,85390,131595,3.287,8.353,204252,64966,139286,2.501,7.863,12733,0.490,15.725,5474,5521,27425
2013,4452,16172,19867,146924,143840,2480,12.557,2247,11.377,29878,12704,17174,8.832,20.772,23460,10156,13304,7.061,16.310,6418,4.462,32.620,1539,1552,6509
2013,4453,26727,30521,156290,153693,2622,8.631,2338,7.696,24547,9360,15187,6.090,15.971,19112,7315,11797,4.759,12.435,5435,3.536,24.870,1720,1807,5670
2013,4461,39715,87809,1007012,1003015,6189,7.094,5048,5.786,110683,31574,79109,3.148,11.035,104618,37948,66670,3.783,10.430,6065,0.605,20.861,3010,3185,15760
2013,4471,61600,107641,883126,869419,7546,6.991,8145,7.546,137404,45375,92029,5.219,15.804,110231,40810,69421,4.694,12.679,27173,3.125,25.357,5434,5683,25764
2013,4481,32155,91643,1382055,1341340,7287,7.949,7343,8.010,224638,63789,160849,4.756,16.747,142300,50127,92173,3.737,10.609,82338,6.138,21.218,3524,3931,17726
2013,4482,5368,24147,207172,204544,1339,5.499,1745,7.166,31660,10505,21155,5.136,15.478,26788,10289,16499,5.030,13.096,4872,2.382,26.193,479,728,4040
2013,4483,15715,22626,131756,130293,1545,6.821,1596,7.046,18073,6365,11708,4.885,13.871,15221,4964,10257,3.810,11.682,2852,2.189,23.364,1087,1109,3023
2013,4511,24797,35283,444326,432758,2990,8.496,2806,7.974,61182,19694,41488,4.551,14.138,37849,11254,26595,2.601,8.746,23333,5.392,17.492,2002,2028,6626
2013,4512,3636,7843,90939,92620,472,5.933,696,8.749,9141,2359,6782,2.547,9.869,12382,3703,8679,3.998,13.369,-3241,-3.499,19.739,386,402,1391
2013,4522,33,5041,575343,588572,60,1.183,122,2.405,23967,4138,19829,0.703,4.072,48666,7837,40829,1.332,8.268,-24699,-4.196,8.144,0,0,0
2013,4523,7155,43354,2221472,2243992,2879,6.757,1386,3.253,101973,38462,63511,1.714,4.544,145511,10655,134856,0.475,6.484,-43538,-1.940,9.089,890,898,2892
2013,4531,12574,13112,61712,62536,931,6.980,1385,10.383,9484,2723,6761,4.354,15.166,11135,4681,6454,7.485,17.806,-1651,-2.640,30.332,1124,1127,3243
2013,4532,18723,28845,243173,241759,2254,7.745,2772,9.524,32303,12126,20177,5.016,13.362,29867,11641,18226,4.815,12.354,2436,1.008,24.708,1960,2006,7317
2013,4533,12858,18492,184157,177381,1953,10.704,1461,8.007,33704,10650,23054,6.004,19.001,19835,5617,14218,3.167,11.182,13869,7.819,22.364,1109,1114,3362
2013,4539,28152,37417,241470,237811,4165,11.231,3498,9.433,38511,16054,22457,6.751,16.194,31408,11713,19695,4.925,13.207,7103,2.987,26.414,2574,2627,8759
2013,4541,25251,26359,391174,377535,4833,18.967,3078,12.079,77122,34132,42990,9.041,20.428,49339,20331,29008,5.385,13.069,27783,7.359,26.137,2289,2304,8785
2013,4542,3165,3628,40156,40562,324,8.776,452,12.243,5432,1211,4221,2.986,13.392,6197,3037,3160,7.487,15.278,-765,-1.886,26.784,332,338,1320
2013,4543,20709,25985,169125,171335,2602,9.970,2829,10.840,24114,8948,15166,5.223,14.074,28270,9438,18832,5.509,16.500,-4156,-2.426,28.148,1904,1922,5921
2013,4811,404,2425,382490,390453,261,10.459,402,16.109,60983,6843,54140,1.753,15.619,77328,52216,25112,13.373,19.805,-16345,-4.186,31.237,46,47,318
2013,4812,1904,2107,37420,37243,235,11.140,240,11.377,4587,1138,3449,3.056,12.317,4298,1412,2886,3.791,11.541,289,0.776,23.081,163,163,631
2013,4831,597,891,45344,45624,100,11.186,106,11.857,4188,888,3300,1.946,9.179,4743,2152,2591,4.717,10.396,-555,-1.216,18.359,52,52,205
2013,4832,421,487,21226,20872,63,13.194,44,9.215,2070,517,1553,2.477,9.918,1348,613,735,2.937,6.459,722,3.459,12.917,27,27,115
2013,4841,47830,57465,908218,896634,9208,16.264,7508,13.262,127717,43034,84683,4.800,14.244,104779,37794,66985,4.215,11.686,22938,2.558,23.372,5216,5264,21283
2013,4842,37147,40912,459792,455310,4943,12.032,5286,12.866,75648,24396,51252,5.358,16.615,66574,25295,41279,5.556,14.622,9074,1.993,29.243,3637,3654,15528
2013,4851,510,787,51824,50252,81,10.318,77,9.809,7462,3239,4223,6.446,14.849,4294,1818,2476,3.618,8.545,3168,6.304,17.090,50,50,1356
2013,4852,270,456,15239,15104,38,8.288,43,9.378,1586,373,1213,2.470,10.501,1315,480,835,3.178,8.707,271,1.794,17.413,20,20,94
2013,4853,6496,6652,73853,72945,1089,16.667,853,13.055,11003,4339,6664,5.948,15.084,9228,3626,5602,4.971,12.651,1775,2.433,25.301,657,658,2664
2013,4854,2588,4054,216449,215231,187,4.554,292,7.111,17554,3961,13593,1.840,8.156,15360,7608,7752,3.535,7.137,2194,1.019,14.273,190,193,3853
2013,4855,1149,1263,33299,32868,104,8.141,133,10.411,4188,973,3215,2.960,12.742,3389,1785,1604,5.431,10.311,799,2.431,20.622,90,94,763
2013,4859,3448,3902,80681,80576,608,15.764,518,13.430,12881,4211,8670,5.226,15.986,12780,7450,5330,9.246,15.861,101,0.125,31.722,366,369,3513
2013,4861,51,716,11529,11004,77,11.216,18,2.622,2097,719,1378,6.534,19.058,1056,106,950,0.963,9.597,1041,9.461,19.194,D,D,D
2013,4862,128,2302,31577,30934,206,9.207,77,3.441,5172,1358,3814,4.390,16.720,3949,1827,2122,5.906,12.766,1223,3.954,25.532,8,8,32
2013,4869,54,614,7133,6578,34,5.574,26,4.262,1735,483,1252,7.343,26.378,630,195,435,2.965,9.578,1105,16.800,19.156,D,D,D
2013,4871,444,488,9628,9415,61,12.669,48,9.969,1415,368,1047,3.909,15.029,1020,264,756,2.804,10.834,395,4.195,21.668,36,36,119
2013,4872,1179,1226,12491,12460,142,11.606,137,11.197,1644,406,1238,3.258,13.194,1556,387,1169,3.106,12.488,88,0.706,24.976,96,96,293
2013,4879,155,177,2409,2377,20,11.396,17,9.687,267,66,201,2.777,11.233,197,82,115,3.450,8.288,70,2.945,16.576,12,12,23
2013,4881,3735,5479,173415,167944,454,8.215,549,9.934,26931,7242,19689,4.312,16.036,16320,5504,10816,3.277,9.718,10611,6.318,19.435,278,288,2486
2013,4882,478,1354,34786,33557,192,14.690,98,7.498,5567,1973,3594,5.880,16.590,3055,933,2122,2.780,9.104,2512,7.486,18.208,28,30,266
2013,4883,1746,2289,97078,94583,208,9.157,173,7.616,15832,2969,12863,3.139,16.739,11100,2658,8442,2.810,11.736,4732,5.003,23.471,107,108,1567
2013,4884,8788,10019,84604,84105,1162,11.651,1071,10.738,14079,5090,8989,6.052,16.740,13242,4568,8674,5.431,15.745,837,0.995,31.489,765,766,3037
2013,4885,13544,18771,230123,228277,1608,8.542,1715,9.110,31732,8992,22740,3.939,13.901,27991,10799,17192,4.731,12.262,3741,1.639,24.524,943,981,5119
2013,4889,1228,1317,15218,14843,198,15.373,140,10.870,2655,832,1823,5.605,17.887,1883,748,1135,5.039,12.686,772,5.201,25.372,110,110,528
2013,4921,4126,8529,489482,494038,614,7.123,795,9.223,21088,5291,15797,1.071,4.268,30867,4102,26765,0.830,6.248,-9779,-1.979,8.537,394,403,1512
2013,4922,3761,4131,34111,33172,481,11.532,561,13.450,7407,2269,5138,6.840,22.329,5481,2640,2841,7.959,16.523,1926,5.806,33.046,425,429,1676
2013,4931,6838,13895,721968,716074,1261,9.033,1392,9.971,94403,26119,68284,3.648,13.183,81511,28169,53342,3.934,11.383,12892,1.800,22.766,315,332,3559
2013,5111,11928,17124,438778,447681,952,5.435,1735,9.906,47344,11257,36087,2.515,10.575,65353,24116,41237,5.387,14.598,-18009,-4.023,21.151,934,944,7334
2013,5112,5458,8229,426527,420459,875,10.643,859,10.449,68112,25061,43051,5.960,16.199,55796,24870,30926,5.915,13.270,12316,2.929,26.541,412,434,6697
2013,5121,13248,16483,312053,307755,2382,14.548,2163,13.210,40866,16121,24745,5.238,13.279,32547,11884,20663,3.862,10.576,8319,2.703,21.151,1373,1391,7213
2013,5122,2759,3019,22707,22628,371,12.190,420,13.800,3753,1049,2704,4.636,16.586,3473,2137,1336,9.444,15.348,280,1.237,30.696,286,286,638
2013,5151,4028,8675,219546,220242,570,6.602,487,5.641,20374,8353,12021,3.793,9.251,21880,5272,16608,2.394,9.935,-1506,-0.684,18.501,244,300,3163
2013,5152,379,732,56150,53418,55,7.468,64,8.690,10994,399,10595,0.747,20.581,5293,1080,4213,2.022,9.909,5701,10.672,19.817,34,34,288
2013,5173,4104,42310,1009438,1004449,5233,12.249,6055,14.173,185507,89348,96159,8.895,18.469,176688,83508,93180,8.314,17.591,8819,0.878,35.181,407,477,3098
2013,5174,375,459,8446,8327,78,17.314,61,13.541,1310,699,611,8.394,15.732,1123,543,580,6.521,13.486,187,2.246,26.972,32,32,293
2013,5179,3306,3903,54982,53502,585,14.958,601,15.367,12215,2498,9717,4.669,22.831,9241,4450,4791,8.318,17.272,2974,5.559,34.545,426,430,2101
2013,5182,8633,13581,505476,492138,1941,14.516,1522,11.382,88063,24928,63135,5.065,17.894,61699,25369,36330,5.155,12.537,26364,5.357,25.074,765,782,8476
2013,5191,7787,9752,219489,214899,1641,17.184,1236,12.943,40524,16497,24027,7.677,18.857,31493,9847,21646,4.582,14.655,9031,4.202,29.310,819,821,4807
2013,5211,13,57,18502,18221,0,0.000,0,0.000,778,0,778,0.000,4.270,227,0,227,0.000,1.246,551,3.024,2.492,0,0,0
2013,5221,12718,122284,2014580,2016569,3343,2.704,6035,4.882,198574,40293,158281,1.998,9.847,203067,45948,157119,2.279,10.070,-4493,-0.223,19.694,429,541,5681
2013,5222,13441,39258,571845,555460,4598,11.792,4065,10.425,117662,33501,84161,6.031,21.183,85217,31199,54018,5.617,15.342,32445,5.841,30.683,897,950,5548
2013,5223,12042,27052,250448,243105,2548,9.395,2687,9.907,52208,18721,33487,7.701,21.476,38066,18545,19521,7.628,15.658,14142,5.817,31.317,1235,1353,6050
2013,5231,11548,41371,401384,409918,3911,9.086,7257,16.859,50568,17045,33523,4.158,12.336,65791,23055,42736,5.624,16.050,-15223,-3.714,24.672,807,833,3394
2013,5232,16,32,5650,5675,5,16.129,D,D,220,119,101,2.097,3.877,268,D,264,D,4.723,-48,-0.846,7.754,0,0,0
2013,5239,39620,45381,464311,467886,6006,13.433,4667,10.438,59902,23963,35939,5.122,12.803,66702,29854,36848,6.381,14.256,-6800,-1.453,25.605,3202,3220,20139
2013,5241,4561,29989,1445595,1433125,4144,13.710,4618,15.278,160968,39618,121350,2.764,11.232,135846,48255,87591,3.367,9.479,25122,1.753,18.958,282,331,6297
2013,5242,117941,132006,875180,864225,10606,8.030,10753,8.141,122881,41866,81015,4.844,14.219,101155,40468,60687,4.683,11.705,21726,2.514,23.409,7416,7539,24044
2013,5259,647,668,5603,5326,187,29.801,106,16.892,1269,920,349,17.274,23.827,703,392,311,7.360,13.199,566,10.627,26.399,87,87,265
2013,5311,86341,111199,542149,538221,11300,10.235,9713,8.798,88803,44056,44747,8.185,16.499,80514,33305,47209,6.188,14.959,8289,1.540,29.919,6612,6764,21192
2013,5312,59212,70011,257786,251679,12625,18.561,8642,12.705,55893,29879,26014,11.872,22.208,44056,20534,23522,8.159,17.505,11837,4.703,35.010,4566,4629,9588
2013,5313,62433,76083,631855,625269,9314,12.427,7053,9.410,96933,39506,57427,6.318,15.503,83688,31494,52194,5.037,13.384,13245,2.118,26.769,4401,4461,19500
2013,5321,3504,13553,147834,144509,1215,9.051,957,7.129,32013,11830,20183,8.186,22.153,25365,8407,16958,5.818,17.553,6648,4.600,35.105,318,347,1101
2013,5322,7491,19524,147913,151657,1679,8.315,3016,14.936,23518,8168,15350,5.386,15.507,30542,17150,13392,11.308,20.139,-7024,-4.632,31.015,785,828,3077
2013,5323,2301,2739,17265,17091,175,6.360,200,7.269,2532,834,1698,4.880,14.815,2216,628,1588,3.675,12.966,316,1.849,25.933,148,152,460
2013,5324,7144,13157,170731,164305,1111,8.505,923,7.066,31981,7176,24805,4.368,19.464,19331,6455,12876,3.929,11.765,12650,7.699,23.531,537,564,3415
2013,5331,2034,2211,35115,34386,295,13.573,220,10.122,5850,1912,3938,5.560,17.013,4434,1509,2925,4.388,12.895,1416,4.118,25.790,153,153,796
2013,5411,159933,170789,1161378,1153041,13240,7.758,12972,7.601,129616,39946,89670,3.464,11.241,112630,35943,76687,3.117,9.768,16986,1.473,19.536,9459,9504,26268
2013,5412,99018,114601,1251235,1249873,10949,9.577,10396,9.093,212893,70203,142690,5.617,17.033,206289,72443,133846,5.796,16.505,6604,0.528,33.010,6292,6338,41676
2013,5413,79442,95202,1408831,1365263,9240,9.724,8883,9.348,253275,99505,153770,7.288,18.551,163768,54888,108880,4.020,11.995,89507,6.556,23.991,5056,5113,18875
2013,5414,24384,24647,103043,101236,3526,14.392,3230,13.184,18565,7573,10992,7.481,18.338,14873,7168,7705,7.081,14.691,3692,3.647,29.383,2185,2186,4895
2013,5415,93628,111888,1569710,1518205,20125,18.241,17005,15.413,339369,159256,180113,10.490,22.353,242889,105511,137378,6.950,15.998,96480,6.355,31.997,9920,9962,41976
2013,5416,113228,122441,1072782,1033637,23652,19.662,19352,16.088,257509,122347,135162,11.837,24.913,179507,80058,99449,7.745,17.367,78002,7.546,34.733,12967,13002,45475
2013,5417,12257,15490,623862,619020,1875,12.185,1670,10.853,84428,16510,67918,2.667,13.639,75430,19518,55912,3.153,12.185,8998,1.454,24.371,1050,1072,8098
2013,5418,29439,32684,445972,441956,3620,11.040,3834,11.692,67316,20782,46534,4.702,15.231,59750,22996,36754,5.203,13.519,7566,1.712,27.039,2706,2737,12314
2013,5419,51058,60353,573724,572660,5809,9.663,5333,8.871,76914,24293,52621,4.242,13.431,75265,27430,47835,4.790,13.143,1649,0.288,26.286,3300,3344,15771
2013,5511,25990,51783,3164210,3129676,4024,7.791,3756,7.272,492084,154520,337564,4.937,15.723,429770,123165,306605,3.935,13.732,62314,1.991,27.464,644,664,8447
2013,5611,24943,27217,435424,420008,3589,13.317,3058,11.346,90498,32355,58143,7.703,21.547,59856,25735,34121,6.127,14.251,30642,7.296,28.502,2302,2308,18367
2013,5612,1751,5100,250701,251259,620,12.154,622,12.194,34072,12548,21524,4.994,13.561,34650,12315,22335,4.901,13.791,-578,-0.230,27.121,99,104,1970
2013,5613,23948,44471,4986302,4881891,5222,11.881,4182,9.515,943852,177539,766313,3.637,19.334,733781,205403,528378,4.207,15.031,210071,4.303,30.061,2205,2290,102055
2013,5614,23906,30243,750239,752999,3253,10.719,3462,11.408,130387,46749,83638,6.208,17.316,135253,56921,78332,7.559,17.962,-4866,-0.646,34.631,2338,2363,16735
2013,5615,12857,20955,220112,222739,5749,29.368,2990,15.274,38102,18543,19559,8.325,17.106,43702,20937,22765,9.400,19.620,-5600,-2.514,34.212,922,929,3323
2013,5616,17603,24185,876307,857485,2700,11.253,2317,9.657,149853,44208,105645,5.156,17.476,112704,36598,76107,4.268,13.144,37149,4.332,26.287,1534,1544,16641
2013,5617,139123,145998,1706420,1692894,18960,12.978,19159,13.114,266355,76775,189580,4.535,15.734,238731,85251,153480,5.036,14.102,27624,1.632,28.204,12084,12096,49090
2013,5619,15360,17201,266240,265218,1667,9.689,1674,9.730,42932,9937,32995,3.747,16.187,41512,12153,29359,4.582,15.652,1420,0.535,31.304,1110,1180,7563
2013,5621,7274,10439,193921,189631,1014,9.790,850,8.207,32202,9804,22398,5.170,16.981,23999,7004,16995,3.693,12.656,8203,4.326,25.311,517,523,3322
2013,5622,1216,2425,52116,51802,234,9.760,179,7.466,6697,2480,4217,4.787,12.928,5949,1677,4272,3.237,11.484,748,1.444,22.968,100,100,628
2013,5629,7937,9311,127232,125926,872,9.403,798,8.605,21776,4800,16976,3.812,17.293,19131,5195,13936,4.125,15.192,2645,2.100,30.385,498,514,2971
2013,6111,18798,21528,939229,924903,1207,5.651,870,4.073,81288,18609,62679,2.012,8.789,52522,14009,38513,1.515,5.679,28766,3.110,11.357,594,633,10097
2013,6112,469,987,80470,82560,29,2.934,32,3.237,5172,808,4364,0.979,6.265,9385,813,8572,0.985,11.368,-4213,-5.103,12.529,17,18,357
2013,6113,2314,4510,1829289,1830092,177,3.949,121,2.700,72967,5635,67332,0.308,3.987,74076,2383,71693,0.130,4.048,-1109,-0.061,7.974,56,56,861
2013,6114,6713,7111,61614,61368,831,11.622,909,12.713,10243,3033,7210,4.942,16.691,9695,3895,5800,6.347,15.798,548,0.893,31.597,595,603,2771
2013,6115,6067,7763,116498,118064,697,8.991,676,8.720,15718,5112,10606,4.330,13.313,18867,4719,14148,3.997,15.980,-3149,-2.667,26.626,407,438,2665
2013,6116,37423,40147,383612,377684,5253,13.321,3828,9.707,79608,24197,55411,6.407,21.078,67738,22278,45460,5.899,17.935,11870,3.143,35.870,2753,2799,16251
2013,6117,5262,6168,97095,92435,1024,16.924,789,13.040,22211,7004,15207,7.577,24.029,12552,5190,7362,5.615,13.579,9659,10.450,27.159,562,562,3623
2013,6211,167187,203853,2245099,2224623,15111,7.401,15775,7.726,305538,102786,202752,4.620,13.734,265416,94674,170742,4.256,11.931,40122,1.804,23.862,10831,11068,58192
2013,6212,119332,127646,878578,876354,6548,5.141,5999,4.710,100506,33023,67483,3.768,11.469,96299,29883,66416,3.410,10.989,4207,0.480,21.977,4844,4886,24341
2013,6213,114755,130543,774706,760970,12166,9.414,9558,7.396,136684,44454,92230,5.842,17.962,108914,36756,72158,4.830,14.313,27770,3.649,28.625,6461,6538,21204
2013,6214,15334,35429,816160,796526,2647,7.551,1901,5.423,114059,38645,75414,4.852,14.320,75838,20951,54887,2.630,9.521,38221,4.798,19.042,854,888,9451
2013,6215,7118,12699,248443,247182,1058,8.285,1201,9.404,28579,7402,21177,2.995,11.562,26092,10444,15648,4.225,10.556,2487,1.006,21.112,586,615,4864
2013,6216,19684,28058,1282822,1267031,3334,12.049,2560,9.252,187037,41657,145380,3.288,14.762,154622,43599,111023,3.441,12.203,32415,2.558,24.407,1756,1795,26431
2013,6219,6164,9713,295962,293016,880,9.151,687,7.144,41111,13274,27837,4.530,14.030,35205,11827,23378,4.036,12.015,5906,2.016,24.029,423,428,5823
2013,6221,2762,5055,5169891,5190881,111,2.203,77,1.528,182471,19251,163220,0.371,3.515,225949,38214,187735,0.736,4.353,-43478,-0.838,7.030,37,39,17309
2013,6222,414,603,229401,226991,22,3.679,12,2.007,14659,714,13945,0.315,6.458,10138,1807,8331,0.796,4.466,4521,1.992,8.933,6,6,1306
2013,6223,391,949,273884,271799,65,7.035,15,1.623,17757,4935,12822,1.816,6.533,13717,2295,11422,0.844,5.047,4040,1.486,10.093,3,3,429
2013,6231,8241,16093,1677755,1673262,921,5.761,711,4.447,123872,53838,70034,3.218,7.403,114835,38548,76287,2.304,6.863,9037,0.540,13.726,403,439,24590
2013,6232,9368,36228,703447,699616,1982,5.496,1657,4.594,96634,22731,73903,3.249,13.812,89274,24003,65271,3.431,12.760,7360,1.052,25.521,331,397,7190
2013,6233,15546,21793,842564,835338,1783,8.241,1469,6.790,83289,26708,56581,3.197,9.971,68878,26391,42487,3.159,8.246,14411,1.725,16.491,1002,1047,17787
2013,6239,2927,5108,137365,133321,488,9.664,371,7.347,23457,10672,12785,8.005,17.594,14611,4603,10008,3.453,10.959,8846,6.635,21.919,164,173,2167
2013,6241,47978,64100,1483013,1469273,7778,12.407,4957,7.907,213277,53420,159857,3.636,14.516,184983,50214,134769,3.418,12.590,28294,1.926,25.180,2763,2831,27613
2013,6242,9917,13912,174919,176740,658,4.705,806,5.763,20846,4133,16713,2.338,11.795,24181,8502,15679,4.810,13.682,-3335,-1.887,23.589,419,424,5547
2013,6243,3981,7500,331161,329733,379,5.021,477,6.319,39204,4199,35005,1.273,11.890,36466,8090,28376,2.454,11.059,2738,0.830,22.119,163,172,2281
2013,6244,55201,70296,865672,864868,6554,9.319,6619,9.412,114672,41998,72674,4.856,13.259,113188,42548,70640,4.920,13.087,1484,0.172,26.175,4723,4775,27460
2013,7111,6947,7080,119202,118166,820,11.637,753,10.686,18971,5009,13962,4.239,16.055,16821,5164,11657,4.370,14.235,2150,1.819,28.470,486,486,3390
2013,7112,3208,3377,124588,122831,423,12.456,461,13.575,15104,3149,11955,2.564,12.297,11566,2366,9200,1.926,9.416,3538,2.880,18.832,368,369,1992
2013,7113,5661,5984,148388,144303,682,11.553,520,8.809,25882,6940,18942,4.809,17.936,17482,4817,12665,3.338,12.115,8400,5.821,24.230,375,375,1725
2013,7114,2895,3006,17944,17628,406,13.617,357,11.974,2969,1292,1677,7.329,16.843,2294,1061,1233,6.019,13.013,675,3.829,26.027,242,242,709
2013,7115,14150,14187,42475,42367,2592,18.457,2305,16.413,10390,5437,4953,12.833,24.524,10162,4899,5263,11.563,23.986,228,0.538,47.972,1319,1319,2932
2013,7121,6510,6967,139705,138257,375,5.420,278,4.018,10727,1970,8757,1.425,7.759,7781,967,6814,0.699,5.628,2946,2.131,11.256,170,170,634
2013,7131,2390,2729,172208,167796,348,12.740,353,12.923,19346,4491,14855,2.676,11.529,10801,2564,8237,1.528,6.437,8545,5.092,12.874,282,283,2135
2013,7132,1864,2805,163246,159004,245,8.788,211,7.568,21856,10211,11645,6.422,13.746,13267,3523,9744,2.216,8.344,8589,5.402,16.688,156,156,2933
2013,7139,48884,56105,1186369,1181636,6199,11.115,5535,9.924,153395,59442,93953,5.030,12.982,143595,44245,99350,3.744,12.152,9800,0.829,24.304,4002,4025,29926
2013,7211,39245,50097,1901476,1896884,4143,8.283,3990,7.977,199778,79166,120612,4.173,10.532,190053,85822,104231,4.524,10.019,9725,0.513,20.038,2396,2457,37012
2013,7212,5310,5886,41244,41212,438,7.443,436,7.409,6119,1263,4856,3.065,14.848,5980,1482,4498,3.596,14.510,139,0.337,29.021,263,268,884
2013,7213,1860,2001,11427,11626,108,5.376,124,6.172,1741,751,990,6.460,14.976,2139,462,1677,3.974,18.399,-398,-3.424,29.951,77,78,223
2013,7223,12831,37490,701541,688520,7249,20.106,4378,12.143,152526,84201,68325,12.229,22.153,126254,57989,68265,8.422,18.337,26272,3.816,36.674,1487,1530,9036
2013,7224,37435,38305,352532,350762,3873,10.050,4336,11.252,64772,30373,34399,8.659,18.466,61175,26402,34773,7.527,17.441,3597,1.025,34.881,3549,3558,22316
2013,7225,349362,479052,9372428,9195718,52338,11.017,44327,9.331,1508634,679552,829082,7.390,16.406,1150403,439547,710856,4.780,12.510,358231,3.896,25.020,34377,35287,306644
2013,8111,133806,146534,823717,818683,12385,8.460,12111,8.273,119300,44696,74604,5.460,14.572,109605,40473,69132,4.944,13.388,9695,1.184,26.776,8810,8918,29930
2013,8112,9742,10991,97662,98877,1184,10.698,1337,12.080,12505,4291,8214,4.340,12.647,14718,6222,8496,6.293,14.885,-2213,-2.238,25.294,919,926,3062
2013,8113,17948,19704,198106,194685,1897,9.690,1642,8.388,35576,14058,21518,7.221,18.274,27876,10466,17410,5.376,14.319,7700,3.955,28.637,1081,1089,4532
2013,8114,16936,17590,65551,65322,2009,11.440,1951,11.110,10881,4667,6214,7.145,16.658,10330,4538,5792,6.947,15.814,551,0.844,31.628,1426,1428,3180
2013,8121,91407,107858,655035,647719,13360,12.498,11435,10.697,117428,54403,63025,8.399,18.129,102651,41455,61196,6.400,15.848,14777,2.281,31.696,8796,8937,32103
2013,8122,14245,19573,135100,137841,634,3.198,1134,5.721,11762,2327,9435,1.688,8.533,16995,5955,11040,4.320,12.329,-5233,-3.796,17.066,473,491,1998
2013,8123,28245,33461,292551,292475,2487,7.390,2869,8.525,39645,11067,28578,3.784,13.555,39056,16458,22598,5.627,13.354,589,0.201,26.707,2058,2134,10064
2013,8129,24727,34222,260146,256077,5691,16.901,4592,13.637,54316,23208,31108,9.063,21.211,45683,21701,23982,8.474,17.840,8633,3.371,35.679,2022,2042,7457
2013,8131,177293,177622,1683236,1684345,7925,4.471,7185,4.054,139709,22434,117275,1.332,8.295,142403,26050,116353,1.547,8.455,-2694,-0.160,16.589,4509,4509,11958
2013,8132,16026,18028,177065,176389,1272,7.075,1173,6.524,18549,4394,14155,2.491,10.516,16890,4219,12671,2.392,9.575,1659,0.941,19.151,739,743,2539
2013,8133,13647,16029,153902,152562,1201,7.523,1070,6.703,20925,5809,15116,3.808,13.716,18211,5099,13112,3.342,11.937,2714,1.779,23.874,671,671,2838
2013,8134,22802,24623,230555,230145,1207,4.893,1301,5.274,26286,5572,20714,2.421,11.422,25546,5078,20468,2.206,11.100,740,0.322,22.200,859,861,3125
2013,8139,54583,56760,489503,493014,2451,4.301,2910,5.106,44473,8596,35877,1.744,9.021,51336,10520,40816,2.134,10.413,-6863,-1.392,18.041,2013,2016,6947
2014,1131,362,410,3016,3040,30,7.371,24,5.897,477,72,405,2.368,15.691,515,99,416,3.257,16.941,-38,-1.250,31.382,14,14,21
2014,1132,124,140,1460,1523,18,13.433,6,4.478,166,42,124,2.758,10.900,279,8,271,0.525,18.319,-113,-7.420,21.799,D,D,D
2014,1133,7040,7129,49699,49558,700,9.818,702,9.846,7053,2005,5048,4.046,14.232,6790,2237,4553,4.514,13.701,263,0.531,27.403,505,506,1544
2014,1141,1207,1218,5973,5961,207,17.037,201,16.543,901,371,530,6.224,15.115,879,296,583,4.966,14.746,22,0.369,29.492,120,120,171
2014,1142,273,273,1456,1423,41,15.739,16,6.142,206,88,118,6.186,14.482,143,31,112,2.179,10.053,63,4.429,20.105,13,13,27
2014,1151,3531,3858,63938,62942,372,9.637,376,9.741,10133,2711,7422,4.307,16.099,8018,3213,4805,5.105,12.739,2115,3.360,25.477,263,263,2824
2014,1152,3702,3803,19178,18758,477,12.624,428,11.327,3250,1714,1536,9.137,17.326,2432,971,1461,5.176,12.965,818,4.361,25.930,322,322,783
2014,1153,1246,1318,10480,10396,148,11.285,135,10.294,1770,452,1318,4.348,17.026,1650,677,973,6.512,15.871,120,1.154,31.743,68,68,437
2014,2111,5845,7398,135797,133104,684,9.288,616,8.365,24422,8805,15617,6.615,18.348,18896,6578,12318,4.942,14.196,5526,4.152,28.393,375,388,2725
2014,2121,465,849,73852,79214,72,8.154,140,15.855,9186,3305,5881,4.172,11.597,19509,9260,10249,11.690,24.628,-10323,-13.032,23.193,54,54,890
2014,2122,253,322,42410,41861,42,12.844,52,15.902,4183,1089,3094,2.601,9.993,3091,574,2517,1.371,7.384,1092,2.609,14.768,45,45,560
2014,2123,2711,4792,78334,77783,259,5.387,290,6.032,8514,1764,6750,2.268,10.946,7389,2151,5238,2.765,9.500,1125,1.446,18.999,143,143,1359
2014,2131,10817,13456,423000,410445,1792,13.585,1262,9.567,81260,25342,55918,6.174,19.798,56338,18870,37468,4.597,13.726,24922,6.072,27.452,863,881,9434
2014,2211,1708,10375,506963,509012,480,4.623,495,4.768,32338,5889,26449,1.157,6.353,36082,8161,27921,1.603,7.089,-3744,-0.736,12.706,66,76,654
2014,2212,429,2495,85209,83994,158,6.385,117,4.728,9209,3545,5664,4.221,10.964,6780,1929,4851,2.297,8.072,2429,2.892,16.144,21,21,213
2014,2213,3479,4612,42434,42243,229,4.980,202,4.393,3238,903,2335,2.138,7.665,2888,869,2019,2.057,6.837,350,0.829,13.673,103,104,374
2014,2361,125714,126969,596218,574370,23640,18.934,19406,15.543,154465,63213,91252,11.006,26.893,110459,50492,59967,8.791,19.231,44006,7.662,38.463,12335,12339,33511
2014,2362,35334,36685,577065,569917,3611,9.815,3821,10.386,100851,21363,79488,3.748,17.696,86369,20415,65954,3.582,15.155,14482,2.541,30.309,2604,2606,12911
2014,2371,16070,17576,534848,526318,1592,9.075,1524,8.688,102513,27125,75388,5.154,19.477,84811,17158,67653,3.260,16.114,17702,3.363,32.228,904,906,6861
2014,2372,4459,4526,24318,24184,413,8.982,557,12.114,4037,1288,2749,5.326,16.693,3743,1815,1928,7.505,15.477,294,1.216,30.954,419,419,1315
2014,2373,7987,8771,260399,256647,621,7.036,731,8.282,41843,9277,32566,3.615,16.304,34811,7128,27683,2.777,13.564,7032,2.740,27.128,452,481,4197
2014,2379,3504,3641,80450,80827,402,11.113,355,9.813,12189,2575,9614,3.186,15.080,12850,3031,9819,3.750,15.898,-661,-0.818,30.161,227,227,1651
2014,2381,69579,70319,709413,692405,9380,13.386,8892,12.689,155025,38484,116541,5.558,22.389,121185,35646,85539,5.148,17.502,33840,4.887,35.004,5265,5275,23804
2014,2382,151964,156157,1736392,1702930,15089,9.728,12983,8.371,283084,61349,221735,3.603,16.623,216162,54374,161788,3.193,12.694,66922,3.930,25.387,8917,8934,35944
2014,2383,87943,88960,663278,647854,12037,13.633,10706,12.125,140322,37811,102511,5.836,21.660,108882,35563,73319,5.489,16.807,31440,4.853,33.613,6918,6923,23007
2014,2389,51918,52622,514978,498076,6807,13.040,5963,11.423,107928,28711,79217,5.764,21.669,74403,24942,49461,5.008,14.938,33525,6.731,29.876,3549,3549,14228
2014,3111,1042,1635,46992,46586,79,4.824,84,5.130,4852,1592,3260,3.417,10.415,4047,1503,2544,3.226,8.687,805,1.728,17.375,51,52,464
2014,3112,474,822,56891,56100,55,6.748,41,5.031,4370,583,3787,1.039,7.790,2723,694,2029,1.237,4.854,1647,2.936,9.708,28,28,253
2014,3113,1630,1800,75626,74852,136,7.564,132,7.341,7413,974,6439,1.301,9.904,5705,870,4835,1.162,7.622,1708,2.282,15.243,103,103,655
2014,3114,1351,1713,157542,157377,167,9.926,106,6.300,12095,2949,9146,1.874,7.685,11766,3186,8580,2.024,7.476,329,0.209,14.953,78,78,887
2014,3115,1095,1587,136792,136000,132,8.424,92,5.871,10594,1432,9162,1.053,7.790,9050,3341,5709,2.457,6.654,1544,1.135,13.309,51,51,715
2014,3116,2803,3393,467431,472562,153,4.485,189,5.541,27206,6026,21180,1.275,5.757,36825,7771,29054,1.644,7.793,-9619,-2.036,11.514,131,131,2107
2014,3117,470,561,32295,32018,48,8.688,31,5.611,3372,626,2746,1.955,10.532,2719,620,2099,1.936,8.492,653,2.039,16.984,17,17,159
2014,3118,9456,10162,280343,276214,1004,9.940,882,8.732,32459,9050,23409,3.276,11.751,24099,7097,17002,2.569,8.725,8360,3.027,17.450,711,713,4581
2014,3119,2790,3239,183747,180186,373,11.823,205,6.498,20181,7689,12492,4.267,11.200,13316,2353,10963,1.306,7.390,6865,3.810,14.780,156,156,1179
2014,3121,4977,5589,154682,150935,956,18.087,349,6.603,18915,5520,13395,3.657,12.532,11292,2651,8641,1.756,7.481,7623,5.051,14.963,260,260,1503
2014,3122,103,126,14620,14536,24,20.168,10,8.403,1087,231,856,1.589,7.478,890,74,816,0.509,6.123,197,1.355,12.245,9,9,58
2014,3131,240,304,25042,25027,19,6.230,21,6.885,1371,166,1205,0.663,5.478,1382,164,1218,0.655,5.522,-11,-0.044,10.956,14,14,32
2014,3132,809,888,49757,50065,42,4.706,51,5.714,3577,689,2888,1.376,7.145,4088,1099,2989,2.195,8.165,-511,-1.021,14.290,31,31,162
2014,3133,906,953,28554,28791,44,4.492,97,9.903,2260,259,2001,0.900,7.850,2673,986,1687,3.425,9.284,-413,-1.434,15.699,69,69,735
2014,3141,1634,1743,53725,53436,78,4.398,139,7.838,4635,787,3848,1.473,8.674,4103,1378,2725,2.579,7.678,532,0.996,15.357,108,109,571
2014,3149,3842,3939,59122,59413,326,8.233,367,9.269,6145,1530,4615,2.575,10.343,6674,2321,4353,3.907,11.233,-529,-0.890,20.686,292,292,1818
2014,3151,220,231,12127,12168,14,5.833,32,13.333,1078,112,966,0.920,8.860,1132,303,829,2.490,9.303,-54,-0.444,17.719,25,27,276
2014,3152,4927,4973,86030,88550,880,17.852,793,16.087,14364,6750,7614,7.623,16.221,19384,7029,12355,7.938,21.891,-5020,-5.669,32.443,684,685,6003
2014,3159,511,517,8580,8591,72,14.008,66,12.840,917,269,648,3.131,10.675,938,358,580,4.167,10.919,-21,-0.244,21.349,53,53,186
2014,3161,169,179,3351,3463,6,3.306,11,6.061,141,12,129,0.347,4.072,356,55,301,1.588,10.280,-215,-6.208,8.143,4,4,11
2014,3162,202,219,11448,11543,40,19.231,18,8.654,1084,297,787,2.573,9.391,1246,238,1008,2.062,10.794,-162,-1.403,18.782,13,13,131
2014,3169,652,656,10603,10568,70,10.703,66,10.092,1208,529,679,5.006,11.431,1074,317,757,3.000,10.163,134,1.268,20.326,58,58,264
2014,3211,2578,2975,80062,78477,211,7.069,231,7.739,9332,3301,6031,4.206,11.891,6165,2047,4118,2.608,7.856,3167,4.036,15.712,180,180,1444
2014,3212,1067,1361,68412,66326,88,6.497,75,5.537,8616,2423,6193,3.653,12.990,4377,1186,3191,1.788,6.599,4239,6.391,13.198,53,54,480
2014,3219,7522,8481,217052,214622,687,8.137,611,7.237,26679,6107,20572,2.845,12.431,21651,5868,15783,2.734,10.088,5028,2.343,20.176,432,435,3407
2014,3221,221,437,106913,107321,18,4.128,16,3.670,4504,1063,3441,0.990,4.197,5314,619,4695,0.577,4.952,-810,-0.755,8.394,5,5,182
2014,3222,2464,3738,244573,244372,132,3.496,208,5.508,17664,4108,13556,1.681,7.228,17391,7287,10104,2.982,7.117,273,0.112,14.233,114,118,1916
2014,3231,23685,24923,458253,460683,1356,5.381,1906,7.564,38437,10229,28208,2.220,8.343,43236,16706,26530,3.626,9.385,-4799,-1.042,16.687,1543,1554,10357
2014,3241,923,2093,101909,99958,133,6.361,129,6.169,8671,1427,7244,1.428,8.675,4828,964,3864,0.964,4.830,3843,3.845,9.660,40,42,150
2014,3251,1290,2366,158905,158546,96,4.041,115,4.841,13144,1406,11738,0.887,8.290,12237,2063,10174,1.301,7.718,907,0.572,15.437,69,70,976
2014,3252,1053,1390,95731,93616,55,3.965,49,3.533,9308,2558,6750,2.732,9.943,5217,1365,3852,1.458,5.573,4091,4.370,11.146,27,27,292
2014,3253,623,867,28563,28205,62,7.155,61,7.040,2983,817,2166,2.897,10.576,2208,625,1583,2.216,7.828,775,2.748,15.657,34,34,314
2014,3254,1603,2052,234212,233095,166,8.147,137,6.724,20086,3361,16725,1.442,8.617,18197,5496,12701,2.358,7.807,1889,0.810,15.613,91,91,1758
2014,3255,1263,1592,56505,55984,71,4.453,76,4.766,5893,1346,4547,2.404,10.526,4870,1610,3260,2.876,8.699,1023,1.827,17.398,43,43,531
2014,3256,1860,2050,94843,94638,113,5.487,132,6.409,7526,1066,6460,1.126,7.952,7045,2695,4350,2.848,7.444,481,0.508,14.888,91,91,794
2014,3259,1703,2178,77806,78629,108,4.925,138,6.293,6275,1489,4786,1.894,7.981,7945,1847,6098,2.349,10.104,-1670,-2.124,15.961,92,95,1182
2014,3261,7961,10201,594388,587174,391,3.812,504,4.913,54511,10292,44219,1.753,9.284,40053,12652,27401,2.155,6.821,14458,2.462,13.643,309,313,4932
2014,3262,1433,1854,129614,128803,83,4.472,87,4.688,8787,1403,7384,1.089,6.822,7023,1306,5717,1.014,5.453,1764,1.370,10.905,58,58,563
2014,3271,894,1071,33054,32818,66,6.105,86,7.956,3339,311,3028,0.948,10.174,2844,1091,1753,3.324,8.666,495,1.508,17.332,63,63,531
2014,3272,1373,1636,85686,85510,118,7.206,121,7.389,6993,1845,5148,2.158,8.178,6589,1442,5147,1.686,7.706,404,0.472,15.411,80,82,725
2014,3273,3941,8162,154778,152559,407,4.951,524,6.374,21187,4487,16700,2.941,13.888,16899,5072,11827,3.325,11.077,4288,2.811,22.154,192,203,2322
2014,3274,155,283,13258,12727,7,2.414,21,7.241,1493,287,1206,2.255,11.731,455,152,303,1.194,3.575,1038,8.156,7.150,10,10,55
2014,3279,2500,2954,72208,71284,148,4.970,196,6.582,7479,1777,5702,2.493,10.492,5702,1516,4186,2.127,7.999,1777,2.493,15.998,118,118,679
2014,3311,321,475,101424,101130,42,8.927,33,7.014,4760,754,4006,0.746,4.707,4404,825,3579,0.816,4.355,356,0.352,8.710,21,21,172
2014,3312,504,629,48858,48609,30,4.754,34,5.388,3822,570,3252,1.173,7.863,3414,869,2545,1.788,7.023,408,0.839,14.047,19,20,238
2014,3313,399,525,55238,55948,14,2.639,25,4.713,3104,413,2691,0.738,5.548,4645,620,4025,1.108,8.302,-1541,-2.754,11.096,11,11,143
2014,3314,759,954,60694,61021,29,3.022,40,4.169,3786,775,3011,1.270,6.204,4440,958,3482,1.570,7.276,-654,-1.072,12.409,29,29,572
2014,3315,1521,1725,124737,124506,57,3.276,87,5.000,8558,2063,6495,1.657,6.874,8025,1329,6696,1.067,6.445,533,0.428,12.891,67,67,763
2014,3321,2193,2422,112908,112913,70,2.871,102,4.184,8461,845,7616,0.748,7.493,8366,1992,6374,1.764,7.409,95,0.084,14.818,73,73,961
2014,3322,1052,1129,35041,35382,51,4.495,62,5.465,2183,409,1774,1.156,6.170,2884,1086,1798,3.069,8.151,-701,-1.981,12.340,34,34,200
2014,3323,10754,11686,332201,330129,587,5.001,690,5.879,33763,5432,28331,1.645,10.227,29613,8952,20661,2.712,8.970,4150,1.257,17.940,486,489,6195
2014,3324,1199,1508,91487,90892,65,4.325,55,3.659,7598,1234,6364,1.358,8.359,6276,1449,4827,1.594,6.905,1322,1.454,13.810,32,32,713
2014,3325,518,567,25854,25560,32,5.634,34,5.986,2463,206,2257,0.806,9.636,1825,794,1031,3.106,7.140,638,2.496,14.280,23,23,182
2014,3326,1063,1199,38842,38805,45,3.724,64,5.296,3399,616,2783,1.587,8.759,3387,1069,2318,2.755,8.728,12,0.031,17.457,45,46,644
2014,3327,21666,22185,390815,389077,950,4.258,1201,5.383,35738,8054,27684,2.070,9.185,32281,7491,24790,1.925,8.297,3457,0.889,16.594,911,912,5107
2014,3328,4997,5536,128130,126927,236,4.257,251,4.528,13399,2712,10687,2.137,10.557,10872,2654,8218,2.091,8.566,2527,1.991,17.131,195,195,1447
2014,3329,5654,6193,265126,262950,443,7.206,352,5.726,24301,5066,19235,1.927,9.242,20023,4865,15158,1.850,7.615,4278,1.627,15.230,254,255,2850
2014,3331,2550,2951,216342,215516,168,5.731,129,4.400,18465,4169,14296,1.934,8.568,17335,3256,14079,1.511,8.044,1130,0.524,16.087,92,96,1020
2014,3332,2942,3098,101002,100266,147,4.721,178,5.717,8833,1198,7635,1.195,8.810,7317,2247,5070,2.241,7.298,1516,1.512,14.595,131,131,1281
2014,3333,1805,1926,75823,75622,111,5.754,117,6.065,6183,1190,4993,1.574,8.176,5947,1471,4476,1.945,7.864,236,0.312,15.728,82,85,672
2014,3334,1452,1719,127182,127318,77,4.446,103,5.947,10398,1734,8664,1.362,8.167,10787,3343,7444,2.626,8.472,-389,-0.306,16.334,71,71,1229
2014,3335,6131,6354,146916,146747,207,3.234,299,4.672,12078,2724,9354,1.856,8.230,11803,4868,6935,3.317,8.043,275,0.187,16.086,234,234,2509
2014,3336,827,1036,101697,101270,52,5.017,53,5.113,9072,2932,6140,2.895,8.958,8259,2680,5579,2.646,8.155,813,0.803,16.311,40,41,468
2014,3339,5164,5822,290675,288164,205,3.512,234,4.009,24497,4150,20347,1.440,8.501,19532,4334,15198,1.504,6.778,4965,1.723,13.556,154,154,1346
2014,3341,955,986,43155,52259,87,8.846,82,8.338,4017,1764,2253,3.376,7.687,21758,5251,16507,10.048,41.635,-17741,-33.949,15.374,52,52,603
2014,3342,1180,1305,97607,99395,81,6.118,119,8.988,7196,3189,4007,3.208,7.240,11107,2234,8873,2.248,11.175,-3911,-3.935,14.480,83,84,1333
2014,3343,427,437,9338,9035,38,8.817,26,6.032,1316,328,988,3.630,14.566,738,85,653,0.941,8.168,578,6.397,16.336,21,21,71
2014,3344,3424,3870,270041,271353,194,4.969,262,6.711,25315,4266,21049,1.572,9.329,27416,8181,19235,3.015,10.103,-2101,-0.774,18.658,195,196,2496
2014,3345,4356,5021,386648,385460,261,5.181,294,5.836,31123,6647,24476,1.724,8.074,28369,7162,21207,1.858,7.360,2754,0.714,14.720,189,189,2168
2014,3346,466,475,11757,12769,52,10.744,70,14.463,706,386,320,3.023,5.529,2661,1159,1502,9.077,20.840,-1955,-15.311,11.058,50,50,319
2014,3351,968,1032,41820,42377,80,7.715,90,8.679,3751,856,2895,2.020,8.851,4811,1892,2919,4.465,11.353,-1060,-2.501,17.703,62,63,445
2014,3352,224,266,47317,45668,23,8.679,21,7.925,4643,634,4009,1.388,10.167,1385,209,1176,0.458,3.033,3258,7.134,6.066,19,19,207
2014,3353,1784,2063,117118,116250,86,4.146,109,5.254,8321,1639,6682,1.410,7.158,6589,1683,4906,1.448,5.668,1732,1.490,11.336,72,72,795
2014,3359,1759,2033,130270,130423,101,4.952,114,5.590,11237,2493,8744,1.911,8.616,11695,3338,8357,2.559,8.967,-458,-0.351,17.232,73,73,828
2014,3361,261,315,170360,166101,26,8.241,27,8.558,12662,107,12555,0.064,7.623,4368,303,4065,0.182,2.630,8294,4.993,5.259,24,24,208
2014,3362,1544,1810,128664,124536,110,6.071,114,6.291,17585,2568,15017,2.062,14.120,9316,3854,5462,3.095,7.481,8269,6.640,14.961,84,84,1306
2014,3363,3991,4889,511517,500377,225,4.603,224,4.582,54329,8482,45847,1.695,10.858,31319,7999,23320,1.599,6.259,23010,4.599,12.518,154,155,3395
2014,3364,1275,1685,369806,366491,92,5.473,84,4.997,33322,6346,26976,1.732,9.092,25825,3360,22465,0.917,7.047,7497,2.046,14.093,58,58,397
2014,3365,157,237,30658,30796,15,6.452,6,2.581,3148,442,2706,1.435,10.222,3437,48,3389,0.156,11.161,-289,-0.938,20.445,4,4,24
2014,3366,1293,1412,138746,136639,128,9.133,107,7.635,13907,2333,11574,1.707,10.178,10146,4395,5751,3.217,7.425,3761,2.753,14.851,66,66,697
2014,3369,792,820,32418,32302,81,9.920,74,9.063,3320,509,2811,1.576,10.278,2981,461,2520,1.427,9.229,339,1.049,18.457,62,62,241
2014,3371,10103,10373,215460,211102,771,7.379,922,8.824,29188,5520,23668,2.615,13.826,20275,9748,10527,4.618,9.604,8913,4.222,19.209,681,683,6635
2014,3372,3328,3496,108248,106595,182,5.152,255,7.219,13133,2407,10726,2.258,12.320,9849,3109,6740,2.917,9.240,3284,3.081,18.479,189,189,2293
2014,3379,642,731,31235,31314,25,3.367,48,6.465,2930,403,2527,1.287,9.357,3097,1147,1950,3.663,9.890,-167,-0.533,18.714,36,36,459
2014,3391,9506,10430,281674,283078,617,5.863,803,7.631,23560,4139,19421,1.462,8.323,26133,7444,18689,2.630,9.232,-2573,-0.909,16.646,631,632,2850
2014,3399,14316,14704,260120,258027,1477,10.141,1199,8.232,28006,8503,19503,3.295,10.854,23718,7521,16197,2.915,9.192,4288,1.662,18.384,925,927,5600
2014,4231,15795,23408,379178,374536,1443,6.161,1471,6.280,42128,11388,30740,3.041,11.248,32554,9206,23348,2.458,8.692,9574,2.556,17.384,988,1029,6193
2014,4232,9858,11651,148147,145858,834,7.140,894,7.653,17635,3135,14500,2.149,12.091,13142,4394,8748,3.013,9.010,4493,3.080,18.020,592,601,2912
2014,4233,9487,15994,204819,199711,1212,7.640,951,5.995,27947,8711,19236,4.362,13.994,17401,6154,11247,3.081,8.713,10546,5.281,17.426,571,611,3716
2014,4234,21624,33340,653935,660027,3573,10.726,3516,10.555,79863,20527,59336,3.110,12.100,93021,43621,49400,6.609,14.094,-13158,-1.994,24.200,1600,1630,9862
2014,4235,7192,9865,153295,152409,414,4.153,623,6.249,15345,2469,12876,1.620,10.068,13551,5186,8365,3.403,8.891,1794,1.177,17.782,352,363,1938
2014,4236,18354,28102,522366,517424,1911,6.799,1921,6.835,69955,14513,55442,2.805,13.520,60027,17383,42644,3.360,11.601,9928,1.919,23.202,1074,1122,6155
2014,4237,10093,18824,229180,228204,850,4.512,882,4.682,22955,4895,18060,2.145,10.059,20866,8501,12365,3.725,9.144,2089,0.915,18.287,401,426,2303
2014,4238,38762,56019,758185,747138,2904,5.174,3129,5.574,84824,23149,61675,3.098,11.353,62716,21966,40750,2.940,8.394,22108,2.959,16.788,1740,1795,9646
2014,4239,27968,31353,335934,336960,2953,9.398,3090,9.834,40503,12523,27980,3.716,12.020,42310,15030,27280,4.460,12.556,-1807,-0.536,24.040,2204,2285,9353
2014,4241,7452,9629,147147,147293,423,4.339,663,6.801,13051,3374,9677,2.291,8.861,13286,5684,7602,3.859,9.020,-235,-0.160,17.721,425,439,1994
2014,4242,6074,9340,299481,296869,827,8.914,702,7.567,31793,7717,24076,2.599,10.709,26466,7311,19155,2.463,8.915,5327,1.794,17.830,439,448,3561
2014,4243,13509,14673,201458,199254,1673,11.481,1472,10.101,27529,7744,19785,3.887,13.816,22972,5956,17016,2.989,11.529,4557,2.287,23.058,1114,1140,4370
2014,4244,24676,31449,777443,773253,2693,8.572,2624,8.353,92108,24037,68071,3.109,11.912,82072,37976,44096,4.911,10.614,10036,1.298,21.228,1685,1704,12597
2014,4245,3221,6026,62153,61478,305,5.080,261,4.347,6600,1486,5114,2.417,10.736,5264,1107,4157,1.801,8.562,1336,2.173,17.125,144,150,599
2014,4246,8049,12344,155932,154732,660,5.313,816,6.569,21314,4657,16657,3.010,13.775,18921,5610,13311,3.626,12.228,2393,1.547,24.457,348,353,1706
2014,4247,4175,6443,101922,102170,351,5.462,318,4.948,12136,2805,9331,2.745,11.878,12966,2763,10203,2.704,12.691,-830,-0.812,23.757,198,203,1591
2014,4248,3246,4188,193413,190701,321,7.706,276,6.626,16258,2705,13553,1.418,8.525,10742,3106,7636,1.629,5.633,5516,2.892,11.266,207,209,2082
2014,4249,20229,26659,332445,330065,2221,8.349,2110,7.931,39706,9966,29740,3.019,12.030,35176,12541,22635,3.800,10.657,4530,1.372,21.315,1475,1523,8171
2014,4251,35003,37353,287834,286060,4108,10.889,4854,12.866,48257,15952,32305,5.576,16.870,44893,17702,27191,6.188,15.694,3364,1.176,31.387,3756,3781,11973
2014,4411,37459,42996,1189862,1164554,3693,8.630,3291,7.690,128796,41103,87693,3.530,11.060,78081,29517,48564,2.535,6.705,50715,4.355,13.410,2537,2562,22649
2014,4412,11326,12902,133567,130250,894,6.914,949,7.340,18476,5636,12840,4.327,14.185,11873,4836,7037,3.713,9.116,6603,5.069,18.231,693,702,3581
2014,4413,26831,55496,507706,500401,2971,5.375,2524,4.566,50773,16715,34058,3.340,10.146,36246,10310,25936,2.060,7.243,14527,2.903,14.487,1674,1725,6212
2014,4421,13211,22290,197255,195817,1843,8.273,1819,8.165,24723,8766,15957,4.477,12.626,21898,8449,13449,4.315,11.183,2825,1.443,22.366,1113,1183,4732
2014,4422,17874,25619,230241,229408,1593,6.172,1978,7.663,24099,7380,16719,3.217,10.505,22343,7244,15099,3.158,9.739,1756,0.765,19.479,1215,1232,3400
2014,4431,22395,42165,398963,401923,3337,7.684,5868,13.511,47007,14769,32238,3.675,11.696,54360,25355,29005,6.308,13.525,-7353,-1.829,23.391,2734,3073,11339
2014,4441,35132,57297,1117976,1103322,2536,4.422,2638,4.600,88651,17836,70815,1.617,8.035,58986,12575,46411,1.140,5.346,29665,2.689,10.692,1822,1859,7282
2014,4442,12539,16190,142610,143722,914,5.613,1099,6.750,16134,4651,11483,3.236,11.226,18638,4320,14318,3.006,12.968,-2504,-1.742,22.452,762,780,3005
2014,4451,59848,86292,2743228,2671204,8261,9.607,7647,8.893,296722,138902,157820,5.200,11.108,158374,57144,101230,2.139,5.929,138348,5.179,11.858,5786,5874,28576
2014,4452,16256,19956,150275,148667,2226,11.192,2094,10.528,26705,10880,15825,7.318,17.963,23617,9098,14519,6.120,15.886,3088,2.077,31.772,1618,1637,7164
2014,4453,27206,31075,157124,156760,2672,8.673,2137,6.937,21884,8590,13294,5.480,13.960,21129,6593,14536,4.206,13.479,755,0.482,26.957,1678,1699,5286
2014,4461,39744,88263,1014439,1010692,5565,6.328,4914,5.588,98256,31445,66811,3.111,9.722,91514,25896,65618,2.562,9.055,6742,0.667,18.109,3111,3403,15766
2014,4471,61423,107093,901515,892950,7120,6.625,7872,7.325,119448,42092,77356,4.714,13.377,102088,38222,63866,4.280,11.433,17360,1.944,22.865,4952,5195,22162
2014,4481,32226,92713,1386394,1384946,7891,8.550,7041,7.629,178374,70051,108323,5.058,12.879,178684,43228,135456,3.121,12.902,-310,-0.022,25.759,3614,4066,13703
2014,4482,5284,24419,223601,215590,1488,6.125,1235,5.084,38236,12606,25630,5.847,17.736,23194,6431,16763,2.983,10.758,15042,6.977,21.517,473,505,1831
2014,4483,15376,22247,130169,130896,1372,6.119,1720,7.671,16096,5177,10919,3.955,12.297,17533,6430,11103,4.912,13.395,-1437,-1.098,24.594,1120,1145,3922
2014,4511,24553,35127,457666,451217,2851,8.090,3079,8.737,57767,21492,36275,4.763,12.802,45812,12777,33035,2.832,10.153,11955,2.650,20.306,2138,2218,7870
2014,4512,3472,7551,98738,94784,373,4.845,669,8.689,17044,2339,14705,2.468,17.982,9078,2909,6169,3.069,9.578,7966,8.404,19.155,356,356,1202
2014,4522,20,4927,570422,572317,26,0.522,136,2.730,23708,1966,21742,0.344,4.142,26251,7339,18912,1.282,4.587,-2543,-0.444,8.285,12,12,29
2014,4523,7099,44968,2268535,2245218,2933,6.638,1364,3.087,120472,24822,95650,1.106,5.366,70265,7854,62411,0.350,3.130,50207,2.236,6.259,947,981,2907
2014,4531,12146,12685,60537,61145,835,6.473,1266,9.814,8408,2370,6038,3.876,13.751,9570,3494,6076,5.714,15.651,-1162,-1.900,27.502,1030,1035,2884
2014,4532,17897,27752,237812,239996,2095,7.409,3145,11.122,29887,10671,19216,4.446,12.453,34688,10890,23798,4.538,14.454,-4801,-2.000,24.906,2000,2036,6559
2014,4533,12880,18688,193263,188780,1709,9.192,1517,8.159,27844,9418,18426,4.989,14.749,18759,5144,13615,2.725,9.937,9085,4.812,19.874,1169,1190,3195
2014,4539,29474,39220,254723,248313,5097,13.282,3408,8.881,41250,18541,22709,7.467,16.612,28206,10581,17625,4.261,11.359,13044,5.253,22.718,2582,2638,8196
2014,4541,26713,27861,413976,402059,4838,17.899,3175,11.746,72504,21061,51443,5.238,18.033,47881,18132,29749,4.510,11.909,24623,6.124,23.818,2482,2502,9850
2014,4542,3099,3529,39385,39755,325,9.078,427,11.927,5393,1142,4251,2.873,13.566,6122,2957,3165,7.438,15.399,-729,-1.834,27.131,324,342,2097
2014,4543,20710,25984,174277,172338,2868,11.059,2768,10.673,27855,9466,18389,5.493,16.163,23907,10104,13803,5.863,13.872,3948,2.291,27.744,1610,1642,5540
2014,4811,413,2449,392449,387173,145,5.950,121,4.965,25976,3170,22806,0.819,6.709,15485,2593,12892,0.670,4.000,10491,2.710,7.999,40,41,1382
2014,4812,1865,2058,35686,36472,215,10.349,254,12.226,4719,1817,2902,4.982,12.939,6065,1895,4170,5.196,16.629,-1346,-3.691,25.877,173,175,1318
2014,4831,626,953,47150,46300,142,15.376,83,8.988,6512,1722,4790,3.719,14.065,4761,733,4028,1.583,10.283,1751,3.782,20.566,48,48,286
2014,4832,417,479,21904,21572,47,9.701,58,11.971,2067,565,1502,2.619,9.582,1459,453,1006,2.100,6.763,608,2.818,13.527,36,36,156
2014,4841,49207,58899,923517,914901,9079,15.605,7641,13.133,110311,33054,77257,3.613,12.057,93414,37857,55557,4.138,10.210,16897,1.847,20.421,5561,5595,22144
2014,4842,37322,41108,478550,469786,4918,11.981,4798,11.689,79355,25478,53877,5.423,16.892,61731,22583,39148,4.807,13.140,17624,3.751,26.280,3245,3269,13435
2014,4851,495,772,51510,51461,72,9.243,86,11.040,5477,933,4544,1.813,10.643,5310,3709,1601,7.207,10.319,167,0.325,20.637,55,57,426
2014,4852,286,483,13993,14756,55,11.715,28,5.964,1303,476,827,3.226,8.830,2939,367,2572,2.487,19.917,-1636,-11.087,17.661,15,15,155
2014,4853,6788,6946,76373,74993,1150,16.915,855,12.576,11955,4724,7231,6.299,15.942,9275,4231,5044,5.642,12.368,2680,3.574,24.736,683,683,3072
2014,4854,2542,4039,220148,217808,268,6.613,295,7.279,40300,15795,24505,7.252,18.503,35630,7585,28045,3.482,16.358,4670,2.144,32.717,192,194,2893
2014,4855,1160,1278,33113,33254,116,9.080,115,9.002,3970,1069,2901,3.215,11.938,4257,1163,3094,3.497,12.801,-287,-0.863,23.877,89,90,670
2014,4859,3509,3962,84472,82893,568,14.433,515,13.086,13256,3912,9344,4.719,15.992,10047,4497,5550,5.425,12.120,3209,3.871,24.241,389,393,2751
2014,4861,65,751,12276,11960,98,13.288,71,9.627,2201,913,1288,7.634,18.404,1609,282,1327,2.358,13.454,592,4.950,26.907,5,5,14
2014,4862,115,2558,34151,32881,481,19.806,222,9.141,7204,4771,2433,14.510,21.910,4600,1644,2956,5.000,13.990,2604,7.920,27.980,9,9,15
2014,4869,65,677,7008,6879,81,12.519,21,3.246,1168,609,559,8.853,16.979,917,183,734,2.660,13.330,251,3.649,26.661,5,6,36
2014,4871,497,543,10358,10039,91,17.450,48,9.204,1525,312,1213,3.108,15.192,894,348,546,3.467,8.906,631,6.286,17.811,33,34,255
2014,4872,1188,1230,12688,12557,159,12.980,149,12.163,1658,334,1324,2.660,13.204,1391,344,1047,2.740,11.078,267,2.126,22.156,96,96,236
2014,4879,166,187,2270,2180,25,13.812,13,7.182,315,96,219,4.404,14.450,147,39,108,1.789,6.743,168,7.706,13.486,8,8,33
2014,4881,3749,5512,176125,175474,466,8.467,449,8.158,20460,5202,15258,2.965,11.660,19005,6586,12419,3.753,10.831,1455,0.829,21.661,260,270,1954
2014,4882,491,1395,36790,35890,136,9.956,78,5.710,4883,1747,3136,4.868,13.606,3162,683,2479,1.903,8.810,1721,4.795,17.621,26,26,280
2014,4883,1782,2325,98737,98314,186,8.036,165,7.129,9861,1203,8658,1.224,10.030,8917,996,7921,1.013,9.070,944,0.960,18.140,82,84,309
2014,4884,8830,10188,91364,87934,1314,13.030,1107,10.977,18624,6114,12510,6.953,21.180,11705,4830,6875,5.493,13.311,6919,7.868,26.622,804,805,2892
2014,4885,13575,18994,237627,234370,1675,8.862,1487,7.868,34271,12431,21840,5.304,14.623,28034,8045,19989,3.433,11.961,6237,2.661,23.923,895,952,4404
2014,4889,1265,1389,15883,15738,196,14.281,163,11.876,3288,913,2375,5.801,20.892,2984,1103,1881,7.009,18.960,304,1.932,37.921,122,123,657
2014,4921,4082,8790,504267,496813,952,10.993,692,7.991,42568,13014,29554,2.619,8.568,27954,9450,18504,1.902,5.627,14614,2.942,11.253,425,427,1870
2014,4922,3681,4076,36342,35095,466,11.351,525,12.788,8211,2792,5419,7.956,23.397,5878,3183,2695,9.070,16.749,2333,6.648,33.498,422,422,2717
2014,4931,6977,14151,751025,737276,1143,8.139,929,6.615,93147,24797,68350,3.363,12.634,64762,19744,45018,2.678,8.784,28385,3.850,17.568,317,350,3270
2014,5111,11794,16808,429147,433177,1027,6.052,1352,7.967,45350,19070,26280,4.402,10.469,53888,14878,39010,3.435,12.440,-8538,-1.971,20.938,789,802,4912
2014,5112,5884,8739,446810,437285,1122,13.184,664,7.803,58837,17953,40884,4.106,13.455,39334,10908,28426,2.494,8.995,19503,4.460,17.990,348,355,4605
2014,5121,13538,16762,340814,326478,2363,14.231,2049,12.340,65701,14714,50987,4.507,20.124,37585,10189,27396,3.121,11.512,28116,8.612,23.025,1289,1307,6629
2014,5122,2751,2958,27953,25298,348,11.652,405,13.561,8307,940,7367,3.716,32.837,3254,1678,1576,6.633,12.863,5053,19.974,25.726,231,239,1044
2014,5151,4000,8590,211705,216520,420,4.860,525,6.075,22056,7775,14281,3.591,10.187,32005,9576,22429,4.423,14.782,-9949,-4.595,20.373,223,251,2440
2014,5152,386,749,53406,54739,60,8.086,46,6.199,5677,1024,4653,1.871,10.371,8519,1226,7293,2.240,15.563,-2842,-5.192,20.742,19,19,111
2014,5173,4246,46081,986948,998737,8848,20.014,5106,11.549,134607,72461,62146,7.255,13.478,158127,58873,99254,5.895,15.833,-23520,-2.355,26.955,325,349,2417
2014,5174,348,437,8298,8312,56,12.713,63,14.302,1509,444,1065,5.342,18.156,1476,790,686,9.505,17.759,33,0.397,35.517,39,39,214
2014,5179,3350,3949,55401,55140,653,16.601,622,15.813,12040,3819,8221,6.926,21.836,11459,4380,7079,7.943,20.782,581,1.054,41.564,447,449,2363
2014,5182,8735,13002,534461,521040,1553,11.692,2115,15.923,120327,36010,84317,6.911,23.094,91017,32539,58478,6.245,17.468,29310,5.625,34.937,708,721,6015
2014,5191,8083,10188,247140,233552,1633,16.323,1265,12.645,57918,14005,43913,5.997,24.799,29750,6819,22931,2.920,12.738,28168,12.061,25.476,934,941,4042
2014,5211,12,58,18786,18644,D,D,0,0.000,523,D,453,D,2.805,211,0,211,0.000,1.132,312,1.674,2.264,0,0,0
2014,5221,12237,119560,1965281,1989459,3743,3.096,6388,5.284,153953,31618,122335,1.589,7.738,203753,51615,152138,2.594,10.242,-49800,-2.503,15.477,371,516,4322
2014,5222,13468,40737,563207,567076,5630,14.079,4136,10.343,99534,41589,57945,7.334,17.552,107575,35676,71899,6.291,18.970,-8041,-1.418,35.104,1118,1228,8916
2014,5223,11588,27170,257852,254041,2537,9.353,2449,9.028,42504,14751,27753,5.807,16.731,35006,9892,25114,3.894,13.780,7498,2.951,27.559,1204,1260,3774
2014,5231,11318,41202,397625,400713,4265,10.333,4411,10.687,51715,28586,23129,7.134,12.906,57460,14299,43161,3.568,14.339,-5745,-1.434,25.811,776,803,2751
2014,5232,13,32,6194,5967,D,D,D,D,669,D,63,D,11.212,270,D,269,D,4.525,399,6.687,9.050,D,D,D
2014,5239,41099,47598,477971,470815,6616,14.215,4502,9.673,76113,33205,42908,7.053,16.166,61879,25201,36678,5.353,13.143,14234,3.023,26.286,3160,3184,10908
2014,5241,4597,31099,1438367,1441940,4115,13.455,3085,10.087,194675,73922,120753,5.127,13.501,202930,66132,136798,4.586,14.073,-8255,-0.572,27.002,333,337,2428
2014,5242,118387,132877,929420,919677,11040,8.336,10170,7.679,127457,46694,80763,5.077,13.859,108664,37567,71097,4.085,11.815,18793,2.043,23.631,7026,7106,20596
2014,5259,647,670,6839,6320,163,24.604,148,22.340,2198,1765,433,27.927,34.778,1098,833,265,13.180,17.373,1100,17.405,34.747,127,127,724
2014,5311,86816,113455,562967,552281,11153,9.934,8782,7.822,92054,41827,50227,7.574,16.668,70598,29686,40912,5.375,12.783,21456,3.885,25.566,6347,6451,19599
2014,5312,62847,73556,272678,265642,11895,16.552,8510,11.842,54594,24887,29707,9.369,20.552,40339,18540,21799,6.979,15.186,14255,5.366,30.371,4702,4747,9661
2014,5313,63472,78190,648561,641035,9701,12.558,7814,10.116,95303,38901,56402,6.068,14.867,80481,35014,45467,5.462,12.555,14822,2.312,25.110,4605,4725,20050
2014,5321,3473,14461,146838,144940,2547,18.320,1430,10.286,35799,20443,15356,14.105,24.699,32380,14998,17382,10.348,22.340,3419,2.359,44.681,331,337,1279
2014,5322,7191,18554,144294,146308,1073,5.630,2082,10.924,22715,4871,17844,3.329,15.525,25619,13390,12229,9.152,17.510,-2904,-1.985,31.051,833,913,3923
2014,5323,2240,2696,17946,17606,164,6.039,203,7.476,2769,730,2039,4.146,15.728,2045,781,1264,4.436,11.616,724,4.112,23.231,139,144,516
2014,5324,7233,13439,180909,175643,1225,9.192,1001,7.511,34227,8794,25433,5.007,19.487,22711,7841,14870,4.464,12.930,11516,6.556,25.860,539,559,3094
2014,5331,2033,2212,33018,34096,221,9.950,239,10.761,4351,950,3401,2.786,12.761,6595,2952,3643,8.658,19.342,-2244,-6.581,25.522,165,165,896
2014,5411,159095,170322,1147494,1153853,13436,7.879,13843,8.118,113343,36670,76673,3.178,9.823,126451,39006,87445,3.381,10.959,-13108,-1.136,19.646,9756,9828,28109
2014,5412,99206,118542,1281968,1248978,13796,11.836,9833,8.436,214978,62937,152041,5.039,17.212,150057,49424,100633,3.957,12.014,64921,5.198,24.029,6352,6577,30468
2014,5413,79980,97574,1427215,1420989,10514,10.914,8043,8.349,188165,53111,135054,3.738,13.242,174795,41880,132915,2.947,12.301,13370,0.941,24.602,4872,4946,18926
2014,5414,24772,25055,107611,105400,3507,14.101,3139,12.621,19631,7834,11797,7.433,18.625,15304,6799,8505,6.451,14.520,4327,4.105,29.040,2160,2161,4939
2014,5415,94918,113129,1619594,1595030,17254,15.341,15935,14.168,333065,120766,212299,7.571,20.881,280771,95701,185070,6.000,17.603,52294,3.279,35.206,10115,10172,37857
2014,5416,117482,127405,1140388,1107342,23212,18.553,18623,14.885,238486,99836,138650,9.016,21.537,172021,76878,95143,6.943,15.535,66465,6.002,31.069,13141,13192,41491
2014,5417,12355,15929,662181,645292,2199,13.969,1824,11.587,94863,32702,62161,5.068,14.701,62180,17844,44336,2.765,9.636,32683,5.065,19.272,1102,1109,5799
2014,5418,29365,32819,465818,461268,3588,10.940,3544,10.806,72472,24110,48362,5.227,15.711,63646,18742,44904,4.063,13.798,8826,1.913,27.596,2564,2625,13312
2014,5419,52078,58410,584939,579888,6208,10.458,8115,13.670,87021,32797,54224,5.656,15.007,77970,32400,45570,5.587,13.446,9051,1.561,26.891,3491,3546,17826
2014,5511,26213,52292,3240066,3235443,4226,8.094,4071,7.797,444205,134049,310156,4.143,13.729,429449,140717,288732,4.349,13.273,14756,0.456,26.547,689,717,10571
2014,5611,25143,27361,425513,413568,3316,12.187,3011,11.066,82531,29018,53513,7.017,19.956,58747,26847,31900,6.492,14.205,23784,5.751,28.410,2115,2143,18139
2014,5612,1804,5646,249001,249065,1158,21.546,615,11.443,37560,12234,25326,4.912,15.080,37009,15977,21032,6.415,14.859,551,0.221,29.718,84,85,1269
2014,5613,24078,44692,5204007,5079849,5204,11.673,4984,11.179,1183527,282103,901424,5.553,23.298,949525,340865,608660,6.710,18.692,234002,4.606,37.384,2146,2276,101418
2014,5614,23468,29935,763983,757272,2942,9.770,3296,10.946,115808,34326,81482,4.533,15.293,101538,35743,65795,4.720,13.408,14270,1.884,26.817,2362,2417,16741
2014,5615,12766,23421,230655,223432,4470,20.155,1985,8.950,36535,14696,21839,6.577,16.352,22840,8637,14203,3.866,10.222,13695,6.129,20.445,904,913,3098
2014,5616,17514,23402,892471,883468,2142,9.003,2923,12.285,141080,29183,111897,3.303,15.969,121146,47446,73700,5.370,13.713,19934,2.256,27.425,1452,1485,15138
2014,5617,141096,148073,1759378,1732344,20031,13.627,17872,12.158,282929,87498,195431,5.051,16.332,228045,79810,148235,4.607,13.164,54884,3.168,26.328,11628,11657,45712
2014,5619,15358,17171,266689,265782,1638,9.547,1610,9.384,38714,9814,28900,3.693,14.566,36300,10833,25467,4.076,13.658,2414,0.908,27.316,1055,1059,6235
2014,5621,7254,10483,196819,195364,762,7.270,758,7.232,21195,5337,15858,2.732,10.849,18113,5919,12194,3.030,9.271,3082,1.578,18.543,492,495,3346
2014,5622,1228,2499,52680,52626,197,7.974,140,5.667,4494,1103,3391,2.096,8.540,4477,745,3732,1.416,8.507,17,0.032,17.015,84,84,406
2014,5629,8046,9449,129284,128462,846,9.007,733,7.804,19880,5067,14813,3.944,15.475,18231,4390,13841,3.417,14.192,1649,1.284,28.383,479,486,2424
2014,6111,18774,21604,970886,958238,985,4.559,986,4.564,80636,17143,63493,1.789,8.415,54998,15451,39547,1.612,5.739,25638,2.676,11.479,690,702,11359
2014,6112,472,1060,82991,84712,26,2.434,42,3.933,5148,304,4844,0.359,6.077,8406,948,7458,1.119,9.923,-3258,-3.846,12.154,14,17,223
2014,6113,2352,4575,1842263,1835403,270,5.911,255,5.583,109029,18397,90632,1.002,5.940,94762,8747,86015,0.477,5.163,14267,0.777,10.326,61,62,3187
2014,6114,6562,6934,59428,59096,709,10.140,825,11.799,8853,2923,5930,4.946,14.981,8135,2943,5192,4.980,13.766,718,1.215,27.531,531,531,2002
2014,6115,6009,7661,111874,111816,648,8.465,637,8.321,13420,4282,9138,3.830,12.002,13339,4366,8973,3.905,11.929,81,0.072,23.859,431,464,2886
2014,6116,38679,41476,387469,384332,5400,13.230,4079,9.994,69299,24892,44407,6.477,18.031,63186,23619,39567,6.145,16.440,6113,1.591,32.881,2891,2912,14910
2014,6117,5531,6366,105358,98853,1005,16.056,792,12.653,29195,18524,10671,18.739,29.534,15389,4670,10719,4.724,15.568,13806,13.966,31.135,526,527,2441
2014,6211,164201,203841,2302417,2274731,15809,7.757,15725,7.716,307743,117143,190600,5.150,13.529,251337,93931,157406,4.129,11.049,56406,2.480,22.098,11225,11592,59262
2014,6212,119566,128359,894862,886929,6691,5.226,6021,4.703,102774,33301,69473,3.755,11.588,86660,27707,58953,3.124,9.771,16114,1.817,19.542,4824,4883,22759
2014,6213,116002,132452,806833,792339,11405,8.671,9573,7.278,124804,41566,83238,5.246,15.751,95038,29477,65561,3.720,11.995,29766,3.757,23.989,6630,6721,19843
2014,6214,15631,36921,852620,831954,3491,9.647,2024,5.593,113585,45811,67774,5.506,13.653,71934,20439,51495,2.457,8.646,41651,5.006,17.293,923,1002,9857
2014,6215,7043,12759,250619,249705,1175,9.234,1107,8.699,29093,8333,20760,3.337,11.651,27437,8729,18708,3.496,10.988,1656,0.663,21.976,626,644,4321
2014,6216,19645,28170,1298261,1283344,3198,11.407,2927,10.441,190514,46907,143607,3.655,14.845,159751,49062,110689,3.823,12.448,30763,2.397,24.896,1910,1940,24755
2014,6219,6140,9513,291217,289990,769,8.030,897,9.366,38478,12195,26283,4.205,13.269,35972,11823,24149,4.077,12.405,2506,0.864,24.809,448,506,5990
2014,6221,2706,5058,5121916,5134406,130,2.579,95,1.885,169177,37636,131541,0.733,3.295,193526,30222,163304,0.589,3.769,-24349,-0.474,6.590,49,51,10374
2014,6222,434,636,230266,229619,46,7.449,9,1.457,5629,1655,3974,0.721,2.451,4347,1210,3137,0.527,1.893,1282,0.558,3.786,7,7,661
2014,6223,413,973,282318,280562,69,7.161,50,5.189,16142,3692,12450,1.316,5.753,12544,4447,8097,1.585,4.471,3598,1.282,8.942,18,18,1670
2014,6231,8274,16179,1672428,1674936,902,5.598,768,4.767,126179,51625,74554,3.082,7.533,130528,50598,79930,3.021,7.793,-4349,-0.260,15.067,452,473,32896
2014,6232,9457,39117,744392,723967,4275,11.339,1445,3.833,118199,45326,72873,6.261,16.327,77006,14388,62618,1.987,10.637,41193,5.690,21.273,344,448,5986
2014,6233,15813,22326,871464,857373,1936,8.764,1465,6.632,92655,31843,60812,3.714,10.807,65188,24371,40817,2.843,7.603,27467,3.204,15.206,1045,1063,15541
2014,6239,2945,4942,131171,133828,356,7.096,506,10.086,15029,4398,10631,3.286,11.230,20846,10135,10711,7.573,15.577,-5817,-4.347,22.460,181,198,2159
2014,6241,52788,69596,1550427,1518648,10097,15.052,5069,7.556,212720,64983,147737,4.279,14.007,149102,37850,111252,2.492,9.818,63618,4.189,19.636,3267,3372,20887
2014,6242,9952,13949,180735,177415,616,4.421,586,4.206,21196,5082,16114,2.864,11.947,14514,3663,10851,2.065,8.181,6682,3.766,16.362,279,309,1602
2014,6243,3968,7513,330756,330898,399,5.313,394,5.246,35122,7883,27239,2.382,10.614,35352,7868,27484,2.378,10.684,-230,-0.070,21.228,145,158,2368
2014,6244,54908,69880,871392,868172,6156,8.791,6441,9.198,107675,39263,68412,4.522,12.402,101119,37335,63784,4.300,11.647,6556,0.755,23.295,4594,4744,27510
2014,7111,6968,7108,121186,120059,820,11.564,786,11.084,19764,5508,14256,4.588,16.462,17560,4470,13090,3.723,14.626,2204,1.836,29.252,531,531,3298
2014,7112,3207,3378,127010,125622,425,12.563,435,12.858,14524,3338,11186,2.657,11.562,11697,2844,8853,2.264,9.311,2827,2.250,18.623,328,329,2318
2014,7113,5842,6203,158546,153939,771,12.616,588,9.621,23969,5344,18625,3.472,15.570,14740,5546,9194,3.603,9.575,9229,5.995,19.150,415,418,2615
2014,7114,2925,3035,19912,18959,443,14.715,394,13.088,4874,2032,2842,10.718,25.709,3035,1199,1836,6.324,16.009,1839,9.700,32.017,283,285,884
2014,7115,14659,14698,45927,44114,2786,19.298,2263,15.676,12983,6676,6307,15.134,29.431,9316,4713,4603,10.684,21.118,3667,8.313,42.236,1369,1369,2947
2014,7121,6526,6983,142620,141060,307,4.403,285,4.088,11074,1248,9826,0.885,7.851,8010,1271,6739,0.901,5.678,3064,2.172,11.357,179,179,739
2014,7131,2325,2671,183276,177598,336,12.454,390,14.455,25902,5240,20662,2.950,14.585,14024,3918,10106,2.206,7.897,11878,6.688,15.793,324,327,3198
2014,7132,1751,2746,155573,153041,228,8.228,278,10.032,19213,9333,9880,6.098,12.554,14075,7068,7007,4.618,9.197,5138,3.357,18.394,214,219,5906
2014,7139,49686,57373,1213550,1199115,6506,11.465,5252,9.255,159402,64112,95290,5.347,13.293,129626,42449,87177,3.540,10.810,29776,2.483,21.620,3898,3967,30694
2014,7211,39807,50642,1943112,1930842,4368,8.666,3893,7.724,208394,84850,123544,4.394,10.793,181659,74963,106696,3.882,9.408,26735,1.385,18.817,2570,2656,41825
2014,7212,5262,5847,41921,41600,393,6.697,435,7.413,5804,1376,4428,3.308,13.952,5167,1417,3750,3.406,12.421,637,1.531,24.841,262,262,821
2014,7213,1837,1985,13247,12359,103,5.155,129,6.456,3423,1917,1506,15.511,27.696,1520,639,881,5.170,12.299,1903,15.398,24.597,83,84,197
2014,7223,13410,37007,721688,711645,4443,11.926,4937,13.252,132304,41485,90819,5.829,18.591,111249,44637,66612,6.272,15.633,21055,2.959,31.265,1558,1574,9264
2014,7224,36836,37733,358811,356396,3567,9.371,4227,11.105,63457,28968,34489,8.128,17.805,58886,24669,34217,6.922,16.523,4571,1.283,33.045,3542,3545,20645
2014,7225,353963,486757,9698986,9537393,52246,10.819,44531,9.222,1478612,708062,770550,7.424,15.503,1156261,431704,724557,4.526,12.123,322351,3.380,24.247,35780,36792,325906
2014,8111,133721,146905,847815,836805,12035,8.200,11759,8.012,126729,47622,79107,5.691,15.144,104724,40711,64013,4.865,12.515,22005,2.630,25.029,8689,8797,30554
2014,8112,9618,10898,97615,97675,1084,9.897,1193,10.892,12502,3465,9037,3.547,12.800,12752,4359,8393,4.463,13.056,-250,-0.256,25.599,895,899,2590
2014,8113,17995,19967,207917,206290,1747,8.791,1560,7.850,28380,10802,17578,5.236,13.757,25217,6839,18378,3.315,12.224,3163,1.533,24.448,1096,1105,4327
2014,8114,17049,17783,67941,66745,2052,11.604,1852,10.473,12006,5310,6696,7.956,17.988,9639,4560,5079,6.832,14.442,2367,3.546,28.883,1342,1342,3374
2014,8121,93114,110063,657635,655885,13901,12.759,11683,10.723,112788,57676,55112,8.794,17.196,109130,41666,67464,6.353,16.639,3658,0.558,33.277,9117,9216,32472
2014,8122,14209,20027,138718,136953,1038,5.240,602,3.039,13591,5465,8126,3.990,9.924,10051,2350,7701,1.716,7.339,3540,2.585,14.678,404,406,1635
2014,8123,27900,33222,287986,289933,2553,7.658,2786,8.357,33060,15116,17944,5.214,11.403,36784,13228,23556,4.562,12.687,-3724,-1.284,22.805,2147,2188,9084
2014,8129,26074,35391,277538,269371,5679,16.312,4527,13.003,64148,32815,31333,12.182,23.814,47137,24600,22537,9.132,17.499,17011,6.315,34.998,2236,2330,8604
2014,8131,177817,178146,1677887,1680039,7978,4.484,7494,4.212,136133,22744,113389,1.354,8.103,139977,20634,119343,1.228,8.332,-3844,-0.229,16.206,4837,4837,14098
2014,8132,16222,18225,181713,179574,1247,6.883,1033,5.702,18966,3686,15280,2.053,10.562,14651,3761,10890,2.094,8.159,4315,2.403,16.318,725,733,2013
2014,8133,13776,16254,160206,157151,1197,7.404,1024,6.334,20995,4978,16017,3.168,13.360,14878,3663,11215,2.331,9.467,6117,3.892,18.935,662,664,2292
2014,8134,22645,24523,231583,230994,1231,5.014,1285,5.234,23491,4396,19095,1.903,10.170,22322,5130,17192,2.221,9.663,1169,0.506,19.327,888,896,3638
2014,8139,54431,56601,490057,488700,2657,4.694,2666,4.710,46034,9481,36553,1.940,9.420,43245,10078,33167,2.062,8.849,2789,0.571,17.698,1822,1826,7230
2015,1131,372,416,3713,3360,39,9.466,31,7.524,1211,213,998,6.339,36.042,558,184,374,5.476,16.607,653,19.435,33.214,19,19,36
2015,1132,129,145,1331,1376,22,15.827,10,7.194,165,51,114,3.706,11.991,270,24,246,1.744,19.622,-105,-7.631,23.983,6,6,16
2015,1133,7128,7214,51084,50296,740,10.352,609,8.519,7986,2270,5716,4.513,15.878,6439,1759,4680,3.497,12.802,1547,3.076,25.604,433,433,1339
2015,1141,1241,1253,5975,5952,229,18.595,186,15.104,949,406,543,6.822,15.946,896,388,508,6.519,15.055,53,0.891,30.110,102,102,225
2015,1142,283,286,1561,1508,34,12.121,23,8.200,274,165,109,10.945,18.176,169,79,90,5.240,11.211,105,6.965,22.421,15,15,59
2015,1151,3593,3918,63984,63789,432,11.180,324,8.385,9562,2915,6647,4.570,14.990,9059,2978,6081,4.669,14.202,503,0.789,28.403,222,224,2580
2015,1152,3769,3866,19414,19209,525,13.796,404,10.616,3172,1414,1758,7.361,16.514,2720,1164,1556,6.060,14.160,452,2.353,28.321,284,284,922
2015,1153,1262,1336,11528,10950,163,12.330,135,10.212,2542,792,1750,7.233,23.215,1447,397,1050,3.626,13.215,1095,10.000,26.429,85,85,271
2015,2111,5696,7164,134458,134336,553,7.600,777,10.679,21781,8029,13752,5.977,16.214,21864,9515,12349,7.083,16.276,-83,-0.062,32.428,454,457,3962
2015,2121,439,825,68701,71840,67,7.986,95,11.323,9389,3374,6015,4.697,13.069,15666,5972,9694,8.313,21.807,-6277,-8.737,26.139,45,45,1319
2015,2122,213,284,40264,41375,20,6.579,60,19.737,2187,597,1590,1.443,5.286,4491,1099,3392,2.656,10.854,-2304,-5.569,10.572,50,50,1011
2015,2123,2683,4815,81039,79855,340,7.076,320,6.660,11104,3509,7595,4.394,13.905,8948,2289,6659,2.866,11.205,2156,2.700,22.411,167,167,832
2015,2131,10915,13748,416873,421962,1831,13.450,1561,11.467,64213,24773,39440,5.871,15.218,74472,17679,56793,4.190,17.649,-10259,-2.431,30.435,1086,1101,7893
2015,2211,1695,10459,511554,509840,664,6.373,584,5.605,36611,7961,28650,1.561,7.181,33313,6207,27106,1.217,6.534,3298,0.647,13.068,85,86,487
2015,2212,420,2493,86530,86132,111,4.444,120,4.805,8483,2895,5588,3.361,9.849,7681,2191,5490,2.544,8.918,802,0.931,17.835,24,24,118
2015,2213,3484,4574,42708,42458,182,3.963,220,4.790,3528,990,2538,2.332,8.309,2969,1118,1851,2.633,6.993,559,1.317,13.986,117,117,407
2015,2361,130593,131958,641090,617468,23927,18.513,18496,14.311,157893,64114,93779,10.383,25.571,110370,50686,59684,8.209,17.875,47523,7.696,35.749,11903,11912,33986
2015,2362,35553,36977,602741,590422,3612,9.781,3517,9.524,106496,21774,84722,3.688,18.037,81932,18571,63361,3.145,13.877,24564,4.160,27.754,2425,2429,12837
2015,2371,16116,17709,558545,547853,1504,8.506,1451,8.206,111448,29171,82277,5.325,20.343,91416,14970,76446,2.732,16.686,20032,3.656,33.372,933,934,6819
2015,2372,4380,4460,24845,24342,459,10.250,495,11.054,4521,1509,3012,6.199,18.573,3475,1625,1850,6.676,14.276,1046,4.297,28.551,378,378,1170
2015,2373,7940,8742,262170,260922,615,7.025,641,7.322,37439,6602,30837,2.530,14.349,34489,5346,29143,2.049,13.218,2950,1.131,26.436,411,412,3186
2015,2379,3593,3722,85286,82924,420,11.408,339,9.208,15403,2719,12684,3.279,18.575,11008,3246,7762,3.914,13.275,4395,5.300,26.550,206,206,1971
2015,2381,71614,72433,757791,734300,10013,14.019,7991,11.188,166118,41785,124333,5.690,22.623,118878,34180,84698,4.655,16.189,47240,6.433,32.379,4964,4969,23313
2015,2382,154380,158806,1824977,1780829,15525,9.858,12896,8.188,301959,68101,233858,3.824,16.956,214180,57381,156799,3.222,12.027,87779,4.929,24.054,8864,8884,37251
2015,2383,90499,91591,706497,685778,12660,14.001,10318,11.411,146980,42152,104828,6.147,21.433,105504,33057,72447,4.820,15.385,41476,6.048,30.769,6771,6775,22903
2015,2389,53521,54251,545965,529840,7086,13.276,5336,9.997,104495,25953,78542,4.898,19.722,72140,20734,51406,3.913,13.615,32355,6.107,27.231,3288,3291,12769
2015,3111,1091,1697,54817,50795,120,7.196,61,3.658,12004,8017,3987,15.783,23.632,4350,939,3411,1.849,8.564,7654,15.069,17.128,44,45,423
2015,3112,470,817,57516,56843,42,5.141,42,5.141,4052,391,3661,0.688,7.128,2665,465,2200,0.818,4.688,1387,2.440,9.377,28,28,180
2015,3113,1645,1821,76148,75050,143,7.907,118,6.525,7958,1170,6788,1.559,10.604,5731,1415,4316,1.885,7.636,2227,2.967,15.272,86,87,493
2015,3114,1367,1727,156062,156868,139,8.114,111,6.480,12769,1862,10907,1.187,8.140,14329,4663,9666,2.973,9.134,-1560,-0.994,16.280,73,76,1776
2015,3115,1082,1578,141439,139586,111,7.048,105,6.667,12526,2303,10223,1.650,8.974,8592,2440,6152,1.748,6.155,3934,2.818,12.311,66,66,353
2015,3116,2771,3379,484696,477105,180,5.318,192,5.672,39602,4863,34739,1.019,8.300,24019,4420,19599,0.926,5.034,15583,3.266,10.069,139,139,1859
2015,3117,434,526,30808,31295,39,7.310,54,10.122,2006,582,1424,1.860,6.410,2889,972,1917,3.106,9.232,-883,-2.822,12.820,38,38,468
2015,3118,9419,10164,286105,283321,920,9.069,881,8.685,29093,8258,20835,2.915,10.269,23424,7485,15939,2.642,8.268,5669,2.001,16.535,708,712,4686
2015,3119,2910,3366,191932,186933,382,11.625,222,6.756,21597,3670,17927,1.963,11.553,11345,3276,8069,1.753,6.069,10252,5.484,12.138,154,155,1339
2015,3121,5832,6452,167798,161254,1140,18.821,350,5.778,23477,6342,17135,3.933,14.559,10314,3445,6869,2.136,6.396,13163,8.163,12.792,257,261,2605
2015,3122,128,150,14103,14391,35,25.090,14,10.036,680,207,473,1.438,4.725,1233,157,1076,1.091,8.568,-553,-3.843,9.451,10,10,119
2015,3131,245,306,25052,24922,22,7.225,19,6.240,1475,644,831,2.584,5.919,1225,356,869,1.428,4.915,250,1.003,9.831,11,11,75
2015,3132,794,877,50114,50389,40,4.517,57,6.437,3724,737,2987,1.463,7.391,4341,1117,3224,2.217,8.615,-617,-1.224,14.781,46,46,359
2015,3133,860,906,28399,28586,44,4.754,83,8.968,2090,387,1703,1.354,7.311,2426,504,1922,1.763,8.487,-336,-1.175,14.623,67,67,345
2015,3141,1586,1701,54033,53892,95,5.530,129,7.509,5139,2697,2442,5.004,9.536,4804,917,3887,1.702,8.914,335,0.622,17.828,104,104,485
2015,3149,3825,3931,59908,59670,315,8.010,318,8.086,6131,1473,4658,2.469,10.275,5614,1611,4003,2.700,9.408,517,0.866,18.817,238,238,968
2015,3151,218,228,12476,12179,20,8.811,18,7.930,1239,322,917,2.644,10.174,647,110,537,0.903,5.313,592,4.861,10.625,15,15,35
2015,3152,4953,4998,83258,84306,913,18.389,847,17.059,14357,7609,6748,9.025,17.030,16413,8650,7763,10.260,19.468,-2056,-2.439,34.059,744,745,7713
2015,3159,535,540,7825,8027,70,13.245,47,8.893,711,211,500,2.629,8.858,1092,261,831,3.252,13.605,-381,-4.747,17.716,37,37,246
2015,3161,165,175,3663,3508,11,6.250,13,7.386,480,136,344,3.877,13.685,178,26,152,0.741,5.075,302,8.610,10.150,12,12,25
2015,3162,187,204,11817,11628,24,11.538,32,15.385,1364,436,928,3.750,11.730,1006,454,552,3.904,8.652,358,3.079,17.303,25,26,435
2015,3169,682,687,10785,10515,87,12.966,55,8.197,1664,697,967,6.629,15.825,1110,428,682,4.070,10.556,554,5.269,21.113,50,50,419
2015,3211,2602,3022,84477,82677,215,7.163,174,5.797,8922,2285,6637,2.764,10.791,5287,1606,3681,1.942,6.395,3635,4.397,12.790,125,126,995
2015,3212,1046,1360,70302,69415,65,4.765,73,5.352,7430,1493,5937,2.151,10.704,5713,1865,3848,2.687,8.230,1717,2.474,16.461,47,47,768
2015,3219,7740,8713,225262,220595,772,8.955,588,6.821,27169,6145,21024,2.786,12.316,17805,6077,11728,2.755,8.071,9364,4.245,16.143,431,434,3941
2015,3221,221,439,105518,106451,17,3.859,20,4.540,4756,855,3901,0.803,4.468,6707,1360,5347,1.278,6.301,-1951,-1.833,8.936,13,13,383
2015,3222,2416,3686,245039,244636,116,3.123,172,4.631,17712,4430,13282,1.811,7.240,16967,5404,11563,2.209,6.936,745,0.305,13.871,102,105,2893
2015,3231,23109,24369,448416,453769,1302,5.276,1924,7.796,38046,8682,29364,1.913,8.384,48434,18311,30123,4.035,10.674,-10388,-2.289,16.769,1522,1526,9273
2015,3241,914,2062,102317,102011,111,5.347,139,6.696,5979,1517,4462,1.487,5.861,5410,1187,4223,1.164,5.303,569,0.558,10.607,39,40,355
2015,3251,1278,2360,158512,157995,79,3.339,91,3.846,10283,1979,8304,1.253,6.508,9158,1595,7563,1.010,5.796,1125,0.712,11.593,49,50,658
2015,3252,1042,1370,94607,95244,37,2.683,55,3.988,6282,716,5566,0.752,6.596,7548,1318,6230,1.384,7.925,-1266,-1.329,13.191,32,32,388
2015,3253,642,892,28753,28649,73,8.305,47,5.347,2884,738,2146,2.576,10.067,2614,487,2127,1.700,9.124,270,0.942,18.248,22,25,273
2015,3254,1629,2139,237137,235422,217,10.346,134,6.389,28563,12088,16475,5.135,12.133,25281,6790,18491,2.884,10.739,3282,1.394,21.477,89,91,1684
2015,3255,1288,1636,58849,58106,97,5.977,71,4.375,6369,1167,5202,2.008,10.961,4744,1745,2999,3.003,8.164,1625,2.797,16.329,38,38,292
2015,3256,1843,2038,96130,95866,138,6.753,149,7.291,7980,1556,6424,1.623,8.324,7562,2952,4610,3.079,7.888,418,0.436,15.776,105,105,811
2015,3259,1693,2172,78448,78375,144,6.622,149,6.852,7429,2362,5067,3.014,9.479,7220,2736,4484,3.491,9.212,209,0.267,18.424,95,96,918
2015,3261,7869,10157,608829,599637,407,3.997,457,4.488,56857,9778,47079,1.631,9.482,38295,10210,28085,1.703,6.386,18562,3.096,12.773,325,328,5231
2015,3262,1393,1810,131127,129776,53,2.904,83,4.548,8581,775,7806,0.597,6.612,5847,1143,4704,0.881,4.505,2734,2.107,9.011,55,55,420
2015,3271,882,1058,34026,33573,64,5.995,83,7.775,3100,852,2248,2.538,9.234,2243,605,1638,1.802,6.681,857,2.553,13.362,57,58,425
2015,3272,1360,1612,86545,85716,115,7.083,138,8.500,7228,1450,5778,1.692,8.432,5556,2124,3432,2.478,6.482,1672,1.951,12.964,91,92,675
2015,3273,3912,8262,161707,158351,502,6.109,413,5.026,22668,5249,17419,3.315,14.315,16055,4538,11517,2.866,10.139,6613,4.176,20.278,188,190,2317
2015,3274,158,287,13119,13028,15,5.282,9,3.169,902,132,770,1.013,6.924,726,61,665,0.468,5.573,176,1.351,11.146,8,8,60
2015,3279,2517,2970,74897,73676,197,6.632,198,6.666,8160,1340,6820,1.819,11.076,5726,1622,4104,2.202,7.772,2434,3.304,15.544,122,122,821
2015,3311,309,468,102659,101904,28,5.951,33,7.014,5405,848,4557,0.832,5.304,3968,550,3418,0.540,3.894,1437,1.410,7.788,18,18,183
2015,3312,511,632,48984,48952,33,5.226,32,5.067,4482,346,4136,0.707,9.156,4397,800,3597,1.634,8.982,85,0.174,17.965,19,19,332
2015,3313,378,507,57842,56535,16,3.113,30,5.837,5052,386,4666,0.683,8.936,2575,1057,1518,1.870,4.555,2477,4.381,9.109,22,22,391
2015,3314,751,941,60832,61159,42,4.435,54,5.702,3490,243,3247,0.397,5.706,4130,1389,2741,2.271,6.753,-640,-1.046,11.413,37,37,262
2015,3315,1511,1721,126622,125687,72,4.179,76,4.411,9989,1767,8222,1.406,7.948,8201,2156,6045,1.715,6.525,1788,1.423,13.050,56,56,1314
2015,3321,2144,2391,115948,114955,62,2.577,91,3.783,10111,2139,7972,1.861,8.796,8050,1297,6753,1.128,7.003,2061,1.793,14.005,64,64,816
2015,3322,1053,1127,35712,35449,61,5.420,58,5.153,2653,402,2251,1.134,7.484,2095,838,1257,2.364,5.910,558,1.574,11.820,41,42,466
2015,3323,10729,11681,342229,336966,614,5.244,671,5.730,37878,7327,30551,2.174,11.241,27251,7364,19887,2.185,8.087,10627,3.154,16.174,483,485,3928
2015,3324,1206,1533,92923,91919,89,5.851,65,4.274,8516,1341,7175,1.459,9.265,6510,2210,4300,2.404,7.082,2006,2.182,14.165,42,42,514
2015,3325,512,558,27747,26978,34,6.055,41,7.302,3205,862,2343,3.195,11.880,1663,545,1118,2.020,6.164,1542,5.716,12.329,24,24,157
2015,3326,1017,1154,38853,38770,28,2.388,65,5.544,3032,643,2389,1.658,7.820,2838,767,2071,1.978,7.320,194,0.500,14.640,50,50,243
2015,3327,21477,22019,390760,390065,975,4.403,1222,5.519,34594,7157,27437,1.835,8.869,33173,10607,22566,2.719,8.504,1421,0.364,17.009,962,963,7571
2015,3328,4948,5511,130082,129368,253,4.574,294,5.315,12513,3186,9327,2.463,9.672,11157,3124,8033,2.415,8.624,1356,1.048,17.248,219,219,1928
2015,3329,5661,6204,269269,267293,403,6.516,365,5.901,23660,4365,19295,1.633,8.852,19684,4087,15597,1.529,7.364,3976,1.488,14.728,272,272,2656
2015,3331,2560,2978,215602,216354,154,5.174,151,5.073,19088,3812,15276,1.762,8.823,20428,2873,17555,1.328,9.442,-1340,-0.619,17.645,109,109,1675
2015,3332,2941,3101,105610,103766,165,5.305,183,5.884,11113,2280,8833,2.197,10.710,7514,2271,5243,2.189,7.241,3599,3.468,14.483,135,135,1292
2015,3333,1788,1915,76917,76287,112,5.823,129,6.707,6611,1310,5301,1.717,8.666,5374,977,4397,1.281,7.044,1237,1.622,14.089,99,99,514
2015,3334,1426,1701,128882,128052,74,4.311,105,6.117,10169,1406,8763,1.098,7.941,8412,1988,6424,1.553,6.569,1757,1.372,13.138,78,78,1310
2015,3335,6041,6271,148445,146996,206,3.265,282,4.470,12440,2173,10267,1.478,8.463,9510,2847,6663,1.937,6.470,2930,1.993,12.939,223,223,1510
2015,3336,807,1026,103085,103018,33,3.193,48,4.644,8367,988,7379,0.959,8.122,8466,1364,7102,1.324,8.218,-99,-0.096,16.244,37,37,543
2015,3339,5187,5854,299371,296781,230,3.927,236,4.029,23780,3226,20554,1.087,8.013,18430,3033,15397,1.022,6.210,5350,1.803,12.420,166,166,1334
2015,3341,943,982,42143,42599,95,9.694,91,9.286,4265,805,3460,1.890,10.012,5244,2654,2590,6.230,12.310,-979,-2.298,20.024,65,65,884
2015,3342,1164,1281,91651,91375,75,5.798,100,7.731,7571,896,6675,0.981,8.286,7181,2839,4342,3.107,7.859,390,0.427,15.718,73,74,1186
2015,3343,426,437,9001,8941,43,9.795,47,10.706,1163,280,883,3.132,13.008,1032,575,457,6.431,11.543,131,1.465,23.086,36,36,221
2015,3344,3353,3792,257875,259682,187,4.886,258,6.741,20741,2675,18066,1.030,7.987,25089,12128,12961,4.670,9.661,-4348,-1.674,15.974,181,184,2918
2015,3345,4311,4974,383502,386163,273,5.471,304,6.093,28510,7486,21024,1.939,7.383,33825,7410,26415,1.919,8.759,-5315,-1.376,14.766,198,198,2722
2015,3346,439,448,9778,10760,35,7.659,53,11.597,868,300,568,2.788,8.067,2741,422,2319,3.922,25.474,-1873,-17.407,16.134,43,43,367
2015,3351,973,1035,42975,42522,80,7.718,83,8.008,4522,909,3613,2.138,10.634,3532,1687,1845,3.967,8.306,990,2.328,16.613,56,56,577
2015,3352,239,282,47499,47285,30,10.909,16,5.818,3970,875,3095,1.850,8.396,3485,264,3221,0.558,7.370,485,1.026,14.740,11,11,48
2015,3353,1767,2038,120633,119827,93,4.526,127,6.180,9672,1007,8665,0.840,8.072,8098,2360,5738,1.970,6.758,1574,1.314,13.516,92,93,1199
2015,3359,1779,2050,134235,132130,127,6.210,117,5.721,11908,1744,10164,1.320,9.012,7635,2070,5565,1.567,5.778,4273,3.234,11.557,81,81,785
2015,3361,271,324,185040,178162,28,8.682,25,7.752,17884,587,17297,0.329,10.038,4462,310,4152,0.174,2.504,13422,7.534,5.009,21,21,80
2015,3362,1553,1832,137604,132588,136,7.485,106,5.834,17612,3408,14204,2.570,13.283,7554,2333,5221,1.760,5.697,10058,7.586,11.395,78,79,1266
2015,3363,3995,4937,540954,527136,265,5.387,229,4.655,61462,11182,50280,2.121,11.660,33859,8324,25535,1.579,6.423,27603,5.236,12.846,155,156,2964
2015,3364,1289,1726,367173,371110,117,6.822,95,5.539,26503,2966,23537,0.799,7.142,33190,9139,24051,2.463,8.943,-6687,-1.802,14.283,52,52,635
2015,3365,155,236,32902,31612,8,3.383,9,3.805,4097,220,3877,0.696,12.960,1426,134,1292,0.424,4.511,2671,8.449,9.022,5,5,41
2015,3366,1288,1416,143393,141568,112,7.952,97,6.887,14047,2221,11826,1.569,9.922,10313,1257,9056,0.888,7.285,3734,2.638,14.570,77,77,591
2015,3369,780,804,31302,31330,74,9.125,88,10.851,2617,243,2374,0.776,8.353,2602,642,1960,2.049,8.305,15,0.048,16.610,63,63,241
2015,3371,9865,10132,218794,217427,700,6.838,909,8.880,22226,4432,17794,2.038,10.222,19755,6292,13463,2.894,9.086,2471,1.136,18.172,671,674,3984
2015,3372,3293,3453,110237,109442,165,4.742,218,6.265,10246,1797,8449,1.642,9.362,8716,2584,6132,2.361,7.964,1530,1.398,15.928,157,158,1492
2015,3379,635,726,31152,31428,45,6.148,57,7.787,3470,880,2590,2.800,11.041,4003,1581,2422,5.031,12.737,-533,-1.696,22.083,43,48,1262
2015,3391,9227,10184,276810,277150,647,6.288,858,8.339,27031,7936,19095,2.863,9.753,28277,7296,20981,2.633,10.203,-1246,-0.450,19.506,665,671,3071
2015,3399,14771,15144,262733,260363,1591,10.649,1184,7.925,29468,9293,20175,3.569,11.318,24533,6963,17570,2.674,9.423,4935,1.895,18.845,911,918,4929
2015,4231,15484,23123,392082,385649,1438,6.186,1683,7.240,46595,11074,35521,2.872,12.082,33600,13553,20047,3.514,8.713,12995,3.370,17.425,1116,1158,7279
2015,4232,9793,11599,151429,149827,882,7.590,925,7.960,17398,4346,13052,2.901,11.612,14044,5270,8774,3.517,9.373,3354,2.239,18.747,658,679,3730
2015,4233,9432,16008,214099,210112,1034,6.453,1066,6.653,28922,6966,21956,3.315,13.765,21056,8226,12830,3.915,10.021,7866,3.744,20.043,569,596,3576
2015,4234,21340,32041,640855,644580,2626,8.029,3957,12.099,72752,23457,49295,3.639,11.287,78630,33668,44962,5.223,12.199,-5878,-0.912,22.573,1500,1535,9927
2015,4235,7042,9688,156982,155373,424,4.336,604,6.177,16472,3159,13313,2.033,10.602,13287,4364,8923,2.809,8.552,3185,2.050,17.103,378,389,2016
2015,4236,18161,27970,546688,536985,2097,7.506,2031,7.270,79722,19401,60321,3.613,14.846,58857,18762,40095,3.494,10.961,20865,3.886,21.921,1195,1232,7177
2015,4237,10008,18766,235270,232282,774,4.118,837,4.453,23479,4628,18851,1.992,10.108,17655,5107,12548,2.199,7.601,5824,2.507,15.201,432,446,2128
2015,4238,38496,56120,771043,762571,2978,5.305,3008,5.359,81670,19647,62023,2.576,10.710,64938,19408,45530,2.545,8.516,16732,2.194,17.031,1869,1935,9514
2015,4239,27702,31068,332387,335246,2780,8.906,3072,9.842,38315,10887,27428,3.247,11.429,44067,15035,29032,4.485,13.145,-5752,-1.716,22.858,2295,2335,10300
2015,4241,7246,9567,146684,147304,593,6.180,649,6.764,13726,5265,8461,3.574,9.318,14740,3592,11148,2.438,10.007,-1014,-0.688,18.636,444,455,2253
2015,4242,6167,9520,301293,299120,880,9.318,729,7.719,40628,10206,30422,3.412,13.583,36679,7147,29532,2.389,12.262,3949,1.320,24.525,498,499,3353
2015,4243,13442,14605,200751,200526,1450,9.898,1540,10.512,25010,6743,18267,3.363,12.472,24701,9186,15515,4.581,12.318,309,0.154,24.636,1248,1254,6773
2015,4244,24787,32414,807579,792784,3386,10.593,2490,7.790,86811,30420,56391,3.837,10.950,58256,18619,39637,2.349,7.348,28555,3.602,14.697,1815,1837,11615
2015,4245,3274,6124,64034,63205,351,5.757,296,4.855,7269,2069,5200,3.274,11.501,5641,1470,4171,2.326,8.925,1628,2.576,17.850,149,153,769
2015,4246,7869,12163,157398,157145,620,5.053,835,6.805,17553,4939,12614,3.143,11.170,17326,6394,10932,4.069,11.026,227,0.144,22.051,433,462,2465
2015,4247,4063,6341,101464,101578,305,4.770,410,6.413,12786,3197,9589,3.147,12.587,12947,5249,7698,5.167,12.746,-161,-0.158,25.175,202,213,1533
2015,4248,3230,4177,198711,196021,306,7.321,312,7.464,16380,4227,12153,2.156,8.356,10946,3463,7483,1.767,5.584,5434,2.772,11.168,242,247,2312
2015,4249,20294,26878,339304,336213,2326,8.677,2182,8.140,42205,12407,29798,3.690,12.553,35872,12657,23215,3.765,10.669,6333,1.884,21.339,1558,1616,7239
2015,4251,34659,37060,293175,288823,3984,10.725,4155,11.186,44745,17656,27089,6.113,15.492,35668,13958,21710,4.833,12.349,9077,3.143,24.699,3138,3163,8302
2015,4411,37536,43382,1243249,1216725,3641,8.430,3255,7.537,138671,46116,92555,3.790,11.397,85439,30855,54584,2.536,7.022,53232,4.375,14.044,2564,2594,24256
2015,4412,11227,12866,138524,136051,849,6.594,869,6.749,17175,4962,12213,3.647,12.624,12193,4564,7629,3.355,8.962,4982,3.662,17.924,637,655,3644
2015,4413,26550,55615,522344,514821,2991,5.385,2855,5.140,54244,19154,35090,3.721,10.536,39235,13885,25350,2.697,7.621,15009,2.915,15.242,1609,1651,6180
2015,4421,13027,22395,202067,199337,1835,8.206,1767,7.902,26773,9593,17180,4.812,13.431,21503,8115,13388,4.071,10.787,5270,2.644,21.575,1083,1338,5634
2015,4422,17559,25343,243927,237005,1517,5.956,1767,6.938,35644,9862,25782,4.161,15.039,21240,7023,14217,2.963,8.962,14404,6.078,17.924,1171,1195,3522
2015,4431,21878,41245,392065,395086,3305,7.936,4102,9.850,41539,14559,26980,3.685,10.514,48418,18688,29730,4.730,12.255,-6879,-1.741,21.028,2543,2845,11732
2015,4441,34534,56966,1128212,1122583,2334,4.089,2562,4.488,74017,13978,60039,1.245,6.593,62129,11881,50248,1.058,5.534,11888,1.059,11.069,1782,1838,7946
2015,4442,12528,16371,147641,145206,1000,6.124,916,5.610,18253,5326,12927,3.668,12.570,13269,3288,9981,2.264,9.138,4984,3.432,18.276,653,664,2238
2015,4451,59894,86648,2807356,2762586,8709,10.092,8007,9.278,308113,124108,184005,4.492,11.153,221200,100174,121026,3.626,8.007,86913,3.146,16.014,5827,5941,29747
2015,4452,16385,20263,158335,154665,2407,11.974,2084,10.367,30565,13031,17534,8.425,19.762,23329,9092,14237,5.879,15.084,7236,4.679,30.167,1567,1609,7043
2015,4453,27434,31356,162126,159646,2484,7.958,2196,7.036,24023,8362,15661,5.238,15.048,18941,6570,12371,4.115,11.864,5082,3.183,23.729,1757,1795,5442
2015,4461,39705,88702,1035694,1024089,5414,6.123,4846,5.481,98046,29122,68924,2.844,9.574,74587,24985,49602,2.440,7.283,23459,2.291,14.567,3115,3227,15039
2015,4471,61259,107144,919915,910198,7165,6.681,7379,6.880,120922,45136,75786,4.959,13.285,101691,36631,65060,4.025,11.172,19231,2.113,22.345,5109,5344,24622
2015,4481,31975,92900,1355788,1366599,8325,8.970,8144,8.775,197710,85288,112422,6.241,14.467,222876,60149,162727,4.401,16.309,-25166,-1.842,28.935,3738,4955,26883
2015,4482,5124,24412,234073,228931,1306,5.349,1315,5.386,34485,9311,25174,4.067,15.064,24004,7492,16512,3.273,10.485,10481,4.578,20.971,476,503,1832
2015,4483,14934,21931,128587,129345,1282,5.802,1608,7.278,15480,4921,10559,3.805,11.968,17004,4918,12086,3.802,13.146,-1524,-1.178,23.936,1126,1144,3131
2015,4511,24528,35341,479089,468415,2894,8.207,2738,7.765,64848,21868,42980,4.669,13.844,42651,11410,31241,2.436,9.105,22197,4.739,18.211,1996,2060,7470
2015,4512,3377,7467,97134,97969,434,5.781,516,6.873,9772,1711,8061,1.746,9.975,11235,2719,8516,2.775,11.468,-1463,-1.493,19.949,315,326,1181
2015,4522,24,4926,560095,565315,35,0.710,37,0.751,18303,3771,14532,0.667,3.238,28692,2413,26279,0.427,5.075,-10389,-1.838,6.475,D,D,D
2015,4523,7164,46366,2334222,2301937,2944,6.441,1625,3.555,144094,76986,67108,3.344,6.260,77272,8759,68513,0.381,3.357,66822,2.903,6.714,867,896,2823
2015,4531,11816,12368,59533,60020,905,7.222,1232,9.831,8415,2584,5831,4.305,14.020,9403,3384,6019,5.638,15.666,-988,-1.646,28.041,975,977,2712
2015,4532,17068,26559,228984,233293,1796,6.615,2976,10.962,27872,7917,19955,3.394,11.947,35971,12575,23396,5.390,15.419,-8099,-3.472,23.894,1945,2039,6616
2015,4533,12829,18901,198126,195956,1737,9.228,1583,8.409,28072,10848,17224,5.536,14.326,23836,6109,17727,3.118,12.164,4236,2.162,24.328,1239,1253,3869
2015,4539,31072,41251,266608,260602,5585,13.873,3599,8.940,43810,21537,22273,8.264,16.811,31809,11109,20700,4.263,12.206,12001,4.605,24.412,2620,2684,8388
2015,4541,28342,29748,452956,432480,5603,19.487,3613,12.566,102568,50384,52184,11.650,23.716,61122,24468,36654,5.658,14.133,41446,9.583,28.266,2838,2849,12237
2015,4542,3037,3445,39480,39420,312,8.949,395,11.329,3943,1107,2836,2.808,10.003,3762,1736,2026,4.404,9.544,181,0.459,19.087,294,295,870
2015,4543,20636,25724,175011,174295,2554,9.906,2670,10.356,25170,9867,15303,5.661,14.441,23379,10247,13132,5.879,13.413,1791,1.028,26.827,1814,1843,6165
2015,4811,408,2187,416574,404251,153,6.589,423,18.217,61183,4222,56961,1.044,15.135,36051,16551,19500,4.094,8.918,25132,6.217,17.836,37,71,269
2015,4812,1868,2059,36291,35991,219,10.652,213,10.360,4759,1117,3642,3.104,13.223,4110,2018,2092,5.607,11.420,649,1.803,22.839,150,155,627
2015,4831,636,970,44738,45412,100,10.384,86,8.930,3596,737,2859,1.623,7.919,5022,672,4350,1.480,11.059,-1426,-3.140,15.837,44,46,377
2015,4832,417,478,22659,22399,57,11.912,58,12.121,1565,369,1196,1.647,6.987,1068,395,673,1.764,4.768,497,2.219,9.536,44,44,153
2015,4841,52392,62749,961300,942786,11121,18.297,7187,11.824,137089,46950,90139,4.980,14.541,99437,33305,66132,3.533,10.547,37652,3.994,21.094,5251,5293,21197
2015,4842,38077,41956,491711,484690,5198,12.499,4458,10.720,81877,27074,54803,5.586,16.893,67743,21770,45973,4.492,13.977,14134,2.916,27.953,3185,3197,13305
2015,4851,464,751,53056,52218,70,9.217,87,11.455,6053,2451,3602,4.694,11.592,4578,2131,2447,4.081,8.767,1475,2.825,17.534,52,52,636
2015,4852,281,481,12660,13314,30,6.243,29,6.035,1010,119,891,0.894,7.586,2402,469,1933,3.523,18.041,-1392,-10.455,15.172,19,20,146
2015,4853,6880,7033,77505,76881,1156,16.551,1059,15.162,11799,3800,7999,4.943,15.347,10650,4880,5770,6.348,13.853,1149,1.495,27.705,846,856,3938
2015,4854,2512,4139,228608,224694,417,10.191,323,7.893,31278,14366,16912,6.394,13.920,23138,10625,12513,4.729,10.298,8140,3.623,20.595,165,166,2232
2015,4855,1132,1259,33850,33517,99,7.777,127,9.976,4552,1017,3535,3.034,13.581,3951,898,3053,2.679,11.788,601,1.793,23.576,106,108,766
2015,4859,3676,4150,87362,85889,659,16.240,475,11.705,14638,4722,9916,5.498,17.043,11880,5129,6751,5.972,13.832,2758,3.211,27.664,370,372,3468
2015,4861,72,769,14055,13192,80,10.589,53,7.015,3102,1383,1719,10.484,23.515,1331,298,1033,2.259,10.090,1771,13.425,20.180,6,6,30
2015,4862,116,2131,29099,31537,82,3.502,503,21.482,2373,758,1615,2.404,7.524,7450,6157,1293,19.523,23.623,-5077,-16.099,15.049,7,7,31
2015,4869,65,698,7902,7692,29,4.149,31,4.435,1004,245,759,3.185,13.053,574,109,465,1.417,7.463,430,5.591,14.926,D,D,D
2015,4871,526,574,11292,10859,92,16.341,70,12.433,1809,460,1349,4.236,16.659,961,323,638,2.974,8.850,848,7.809,17.700,52,52,269
2015,4872,1207,1251,13017,12932,167,13.441,150,12.072,1774,504,1270,3.897,13.718,1613,461,1152,3.565,12.473,161,1.245,24.946,101,102,340
2015,4879,157,180,2345,2308,23,12.500,31,16.848,301,78,223,3.380,13.042,220,116,104,5.026,9.532,81,3.510,19.064,18,18,74
2015,4881,3717,5436,175540,175549,413,7.533,506,9.229,25777,6565,19212,3.740,14.684,26190,10895,15295,6.206,14.919,-413,-0.235,29.367,281,284,2096
2015,4882,493,1383,39487,38095,100,7.225,102,7.370,5769,1519,4250,3.987,15.144,2979,1113,1866,2.922,7.820,2790,7.324,15.640,25,25,194
2015,4883,1807,2360,97686,98666,199,8.497,163,6.960,12608,1619,10989,1.641,12.778,14105,7227,6878,7.325,14.296,-1497,-1.517,25.557,106,108,399
2015,4884,9019,10396,94503,92902,1308,12.711,1097,10.660,16194,5201,10993,5.598,17.431,13188,5395,7793,5.807,14.196,3006,3.236,28.391,749,751,3354
2015,4885,13567,19621,253632,245707,2190,11.342,1564,8.100,39439,17763,21676,7.229,16.051,24071,9700,14371,3.948,9.797,15368,6.255,19.593,911,933,4324
2015,4889,1317,1447,16728,16369,210,14.815,151,10.653,2752,1134,1618,6.928,16.812,2024,732,1292,4.472,12.365,728,4.447,24.730,117,117,505
2015,4921,4015,9716,553618,529196,1696,18.339,760,8.218,68495,23324,45171,4.407,12.943,19440,5607,13833,1.060,3.674,49055,9.270,7.347,425,443,1851
2015,4922,3673,4065,39171,37883,477,11.651,535,13.068,7962,3541,4421,9.347,21.017,5549,2734,2815,7.217,14.648,2413,6.370,29.295,412,412,1817
2015,4931,7174,14744,786168,770177,1450,10.004,951,6.561,103946,38188,65758,4.958,13.496,71785,20599,51186,2.675,9.321,32161,4.176,18.641,332,349,3794
2015,5111,11522,16218,403243,414907,906,5.488,1489,9.019,35231,7929,27302,1.911,8.491,59453,16815,42638,4.053,14.329,-24222,-5.838,16.983,842,905,6459
2015,5112,6314,9204,487884,478032,1294,14.340,934,10.350,69059,15739,53320,3.292,14.447,48949,15720,33229,3.288,10.240,20110,4.207,20.479,467,469,5135
2015,5121,13681,16938,360215,350548,2333,13.842,2166,12.851,52064,18303,33761,5.221,14.852,33612,11141,22471,3.178,9.588,18452,5.264,19.177,1402,1420,5972
2015,5122,2740,2951,28717,28396,397,13.471,389,13.200,3668,2281,1387,8.033,12.917,3045,1142,1903,4.022,10.723,623,2.194,21.447,267,267,773
2015,5151,3958,7710,213684,213164,482,5.906,1385,16.970,31744,11981,19763,5.621,14.892,30826,11615,19211,5.449,14.461,918,0.431,28.922,213,261,2879
2015,5152,380,724,52663,53227,62,8.540,66,9.091,5301,1258,4043,2.363,9.959,6476,1073,5403,2.016,12.167,-1175,-2.208,19.919,27,28,236
2015,5173,4490,47484,973689,981832,4529,9.653,3393,7.232,109835,37243,72592,3.793,11.187,124271,28934,95337,2.947,12.657,-14436,-1.470,22.373,302,318,3345
2015,5174,345,427,8471,8403,51,11.888,55,12.821,1076,189,887,2.249,12.806,913,288,625,3.428,10.866,163,1.940,21.732,38,38,215
2015,5179,3383,4025,57242,55671,673,16.941,568,14.298,12254,5906,6348,10.609,22.012,9198,4830,4368,8.676,16.522,3056,5.489,33.044,428,428,2043
2015,5182,8812,13126,542360,529594,1649,12.661,1445,11.095,99483,22654,76829,4.278,18.785,73009,28046,44963,5.296,13.786,26474,4.999,27.572,784,912,14983
2015,5191,8297,10419,258344,252017,1579,15.323,1350,13.101,50471,12057,38414,4.784,20.027,36580,17467,19113,6.931,14.515,13891,5.512,29.030,926,935,4795
2015,5211,12,58,19188,18987,0,0.000,0,0.000,653,0,653,0.000,3.439,270,0,270,0.000,1.422,383,2.017,2.844,0,0,0
2015,5221,11834,118692,1908633,1936227,4476,3.758,5286,4.438,184558,45149,139409,2.332,9.532,235795,43696,192099,2.257,12.178,-51237,-2.646,19.064,332,488,4887
2015,5222,13421,41249,580428,569102,5191,12.661,4691,11.442,105565,27608,77957,4.851,18.549,84102,30733,53369,5.400,14.778,21463,3.771,29.556,1027,1247,6595
2015,5223,11572,27223,273194,270056,2529,9.291,2523,9.269,46580,13386,33194,4.957,17.248,40216,13192,27024,4.885,14.892,6364,2.357,29.783,1149,1248,5361
2015,5231,11114,39688,401149,399653,3290,8.137,4779,11.820,60951,16035,44916,4.012,15.251,57651,18520,39131,4.634,14.425,3300,0.826,28.851,757,764,2896
2015,5232,13,31,5997,6108,0,0.000,D,D,512,0,512,0.000,8.382,760,D,666,D,12.443,-248,-4.060,16.765,0,0,0
2015,5239,42473,48500,483680,480956,6365,13.232,5568,11.576,71941,25535,46406,5.309,14.958,66555,27155,39400,5.646,13.838,5386,1.120,27.676,3248,3269,11805
2015,5241,4624,31329,1489000,1465472,5164,16.529,4989,15.969,200430,65397,135033,4.463,13.677,152698,47814,104884,3.263,10.420,47732,3.257,20.839,303,309,1926
2015,5242,118878,134054,927578,915543,11725,8.788,10456,7.837,127577,47595,79982,5.199,13.935,103899,41589,62310,4.543,11.348,23678,2.586,22.697,7171,7280,23480
2015,5259,683,709,10256,8543,189,27.774,132,19.398,5377,4977,400,58.258,62.940,2269,1646,623,19.267,26.560,3108,36.381,53.120,113,114,1565
2015,5311,86854,114597,573592,569470,11191,9.824,9828,8.627,90987,41715,49272,7.325,15.977,82264,35982,46282,6.319,14.446,8723,1.532,28.891,6912,7155,22904
2015,5312,67171,78142,280366,276024,13323,17.555,8829,11.633,54092,26751,27341,9.692,19.597,45497,23470,22027,8.503,16.483,8595,3.114,32.966,4746,4800,10231
2015,5313,64728,80264,659693,655459,9345,11.785,7403,9.336,95493,36908,58585,5.631,14.569,87018,38948,48070,5.942,13.276,8475,1.293,26.552,4750,4798,20239
2015,5321,3522,15064,164511,155507,1490,10.098,874,5.923,29620,10773,18847,6.928,19.047,12062,3970,8092,2.553,7.757,17558,11.291,15.513,327,397,2191
2015,5322,7163,18253,142077,143229,1239,6.729,1557,8.456,16057,5014,11043,3.501,11.211,18539,7938,10601,5.542,12.944,-2482,-1.733,22.422,690,725,3346
2015,5323,2215,2655,18559,18133,188,7.106,169,6.388,2720,761,1959,4.197,15.000,1877,543,1334,2.995,10.351,843,4.649,20.703,120,126,395
2015,5324,7288,13646,182926,182016,1343,9.880,1236,9.093,31844,10015,21829,5.502,17.495,30202,10209,19993,5.609,16.593,1642,0.902,33.186,513,522,3985
2015,5331,2031,2207,34037,33412,242,10.990,232,10.536,4307,987,3320,2.954,12.891,2997,927,2070,2.774,8.970,1310,3.921,17.940,173,173,609
2015,5411,157860,169261,1139113,1143528,13001,7.656,14088,8.297,112683,36287,76396,3.173,9.854,121705,36690,85015,3.208,10.643,-9022,-0.789,19.708,10086,10158,26194
2015,5412,99229,119274,1344769,1311511,10249,8.620,9488,7.980,221908,62417,159491,4.759,16.920,155600,48506,107094,3.698,11.864,66308,5.056,23.728,6345,6521,35760
2015,5413,80499,100525,1452391,1436341,11599,11.709,8662,8.745,246955,109585,137370,7.629,17.193,213609,53078,160531,3.695,14.872,33346,2.322,29.744,4922,4997,17752
2015,5414,25371,25687,113027,110344,3771,14.851,3180,12.524,20542,8527,12015,7.728,18.616,15182,7231,7951,6.553,13.759,5360,4.858,27.518,2177,2180,5187
2015,5415,96703,116466,1686308,1654913,20248,17.632,16995,14.799,338594,127885,210709,7.728,20.460,274584,110597,163987,6.683,16.592,64010,3.868,33.184,10241,10277,39340
2015,5416,120841,130786,1184142,1158990,23046,17.868,19428,15.063,250248,92967,157281,8.021,21.592,199405,85857,113548,7.408,17.205,50843,4.387,34.410,13746,13784,48102
2015,5417,12554,16144,658861,650493,1970,12.266,1803,11.226,84322,23200,61122,3.567,12.963,66812,19846,46966,3.051,10.271,17510,2.692,20.542,1058,1067,7808
2015,5418,29229,32823,462953,464581,3603,10.962,3692,11.233,66923,21776,45147,4.687,14.405,70002,24340,45662,5.239,15.068,-3079,-0.663,28.810,2673,2719,15203
2015,5419,53202,59500,608766,597853,6546,11.106,5429,9.211,93830,36250,57580,6.063,15.694,71289,28888,42401,4.832,11.924,22541,3.770,23.848,3551,3581,17392
2015,5511,26653,52869,3348111,3306622,4527,8.611,3938,7.490,504673,159539,345134,4.825,15.262,421162,94862,326300,2.869,12.737,83511,2.526,25.474,681,717,10559
2015,5611,25186,27340,431987,426185,3271,11.990,3152,11.554,77036,28111,48925,6.596,18.076,65542,26457,39085,6.208,15.379,11494,2.697,30.758,2235,2246,16915
2015,5612,1818,6278,253369,249203,1593,26.637,998,16.688,40726,18995,21731,7.622,16.342,32866,13817,19049,5.544,13.188,7860,3.154,26.377,111,119,1511
2015,5613,24170,47142,5590831,5429666,7654,16.680,5147,11.216,1033421,227706,805715,4.194,19.033,706956,187187,519769,3.447,13.020,326465,6.013,26.040,2130,2211,102569
2015,5614,23056,29602,785774,776462,2791,9.376,3125,10.497,117462,30642,86820,3.946,15.128,98143,30263,67880,3.898,12.640,19319,2.488,25.280,2266,2322,16842
2015,5615,12743,21637,230564,230754,2021,8.978,3767,16.735,45474,24451,21023,10.596,19.707,47426,29146,18280,12.631,20.553,-1952,-0.846,39.413,852,859,3694
2015,5616,17620,23497,909966,900900,2309,9.844,2225,9.486,118669,21798,96871,2.420,13.172,99423,32389,67034,3.595,11.036,19246,2.136,22.072,1403,1411,15471
2015,5617,143947,151005,1799250,1780892,20358,13.614,17426,11.653,277817,85481,192336,4.800,15.600,240823,84910,155913,4.768,13.523,36994,2.077,27.045,11524,11574,55118
2015,5619,15517,17367,270518,268025,1833,10.607,1662,9.617,44632,12110,32522,4.518,16.652,39512,18938,20574,7.066,14.742,5120,1.910,29.484,1124,1127,9048
2015,5621,7144,10468,200241,198527,640,6.104,675,6.437,20620,5577,15043,2.809,10.386,16664,4884,11780,2.460,8.394,3956,1.993,16.788,482,487,2771
2015,5622,1229,2497,50285,50274,133,5.334,126,5.053,4756,1145,3611,2.278,9.460,4820,1881,2939,3.742,9.588,-64,-0.127,18.921,59,60,600
2015,5629,8170,9621,131266,129872,869,9.109,707,7.411,22932,5707,17225,4.394,17.657,20365,4725,15640,3.638,15.681,2567,1.977,31.362,447,460,2858
2015,6111,19018,21857,1006973,990021,1233,5.664,1059,4.864,84324,18669,65655,1.886,8.517,50786,15245,35541,1.540,5.130,33538,3.388,10.260,611,635,10387
2015,6112,462,1020,78775,81325,24,2.301,70,6.711,3384,582,2802,0.716,4.161,8557,1500,7057,1.844,10.522,-5173,-6.361,8.322,21,34,658
2015,6113,2380,4577,1871951,1854269,325,7.093,335,7.311,97314,2448,94866,0.132,5.248,61581,9161,52420,0.494,3.321,35733,1.927,6.642,57,57,1018
2015,6114,6484,6913,59397,58616,799,11.544,816,11.789,10084,3435,6649,5.860,17.204,8519,3400,5119,5.801,14.534,1565,2.670,29.067,561,575,2651
2015,6115,5992,7705,109937,110081,688,8.961,633,8.245,15114,5865,9249,5.328,13.730,15512,4012,11500,3.645,14.091,-398,-0.362,27.460,416,440,2280
2015,6116,40098,43100,402098,394410,5747,13.586,4148,9.806,72468,27027,45441,6.853,18.374,57260,17740,39520,4.498,14.518,15208,3.856,29.036,3026,3157,13422
2015,6117,5880,6822,107826,108031,1093,16.486,709,10.694,20962,5458,15504,5.052,19.404,21633,3970,17663,3.675,20.025,-671,-0.621,38.808,532,532,2444
2015,6211,160947,206288,2400466,2351243,19136,9.336,16496,8.048,367600,158737,208863,6.751,15.634,265727,104474,161253,4.443,11.302,101873,4.333,22.603,11344,11688,56043
2015,6212,119221,128620,906004,900539,6701,5.214,6495,5.054,106717,33863,72854,3.760,11.850,96347,34340,62007,3.813,10.699,10370,1.152,21.398,5355,5409,26802
2015,6213,117273,135242,821821,815080,12810,9.568,10101,7.544,132667,47185,85482,5.789,16.277,120876,40254,80622,4.939,14.830,11791,1.447,29.660,6931,7009,23021
2015,6214,15930,39699,916626,886659,4485,11.684,1856,4.835,138062,66428,71634,7.492,15.571,78672,18096,60576,2.041,8.873,59390,6.698,17.746,903,955,7229
2015,6215,7039,16230,279578,267058,4586,31.621,1132,7.805,68991,43688,25303,16.359,25.834,42682,11015,31667,4.125,15.982,26309,9.851,31.965,594,637,5387
2015,6216,19833,28993,1370204,1334380,3606,12.634,2702,9.467,258811,83830,174981,6.282,19.396,186521,61788,124733,4.630,13.978,72290,5.417,27.956,1706,1752,24633
2015,6219,6156,9686,294375,291928,888,9.258,700,7.298,45422,15740,29682,5.392,15.559,40534,15001,25533,5.139,13.885,4888,1.674,27.770,435,451,5350
2015,6221,2565,5050,5104812,5119196,129,2.566,85,1.691,204968,44892,160076,0.877,4.004,235139,25773,209366,0.503,4.593,-30171,-0.589,8.008,47,48,5995
2015,6222,407,616,224909,227124,17,2.780,8,1.308,7049,1779,5270,0.783,3.104,11082,208,10874,0.092,4.879,-4033,-1.776,6.207,6,6,151
2015,6223,351,941,285324,283954,42,4.473,38,4.047,15161,3494,11667,1.230,5.339,12498,2722,9776,0.959,4.401,2663,0.938,8.803,20,20,1625
2015,6231,8401,16303,1675841,1676146,1039,6.393,938,5.771,155505,71318,84187,4.255,9.278,156458,63547,92911,3.791,9.334,-953,-0.057,18.555,517,541,39414
2015,6232,9624,39956,753189,748775,2810,7.098,2070,5.229,107604,29282,78322,3.911,14.371,97709,24180,73529,3.229,13.049,9895,1.321,26.098,375,460,4875
2015,6233,16127,22765,902751,886886,1972,8.749,1524,6.761,109724,34937,74787,3.939,12.372,77051,23327,53724,2.630,8.688,32673,3.684,17.376,1058,1075,15944
2015,6239,2969,4894,131059,130669,360,7.333,390,7.945,15795,4036,11759,3.089,12.088,15084,4913,10171,3.760,11.544,711,0.544,23.087,149,169,1584
2015,6241,55980,73162,1630916,1591778,9384,13.132,5974,8.360,231431,66478,164953,4.176,14.539,153813,41744,112069,2.622,9.663,77618,4.876,19.326,4001,4060,25860
2015,6242,9999,14104,188191,184036,627,4.465,504,3.589,22941,3446,19495,1.872,12.466,14929,2990,11939,1.625,8.112,8012,4.354,16.224,297,313,1835
2015,6243,3963,7494,325813,328485,396,5.278,414,5.518,37725,4549,33176,1.385,11.485,43754,7116,36638,2.166,13.320,-6029,-1.835,22.969,140,149,3189
2015,6244,54977,70107,893101,882390,6434,9.192,6207,8.868,117411,40446,76965,4.584,13.306,95952,37222,58730,4.218,10.874,21459,2.432,21.748,4437,4511,25796
2015,7111,7135,7278,123063,122526,840,11.661,691,9.593,17546,5039,12507,4.113,14.320,16601,4647,11954,3.793,13.549,945,0.771,27.098,451,452,3669
2015,7112,3214,3388,128501,127100,402,11.879,394,11.643,17112,4278,12834,3.366,13.463,14253,3147,11106,2.476,11.214,2859,2.249,22.428,303,304,2620
2015,7113,6060,6480,163474,161191,830,13.046,594,9.337,23066,6042,17024,3.748,14.310,18301,3759,14542,2.332,11.354,4765,2.956,22.707,380,383,1959
2015,7114,2970,3096,20009,19967,423,13.812,356,11.624,3069,1203,1866,6.025,15.371,2974,1391,1583,6.967,14.895,95,0.476,29.790,255,256,1175
2015,7115,15149,15183,46746,45939,2866,19.194,2363,15.826,12487,6380,6107,13.888,27.182,10872,5113,5759,11.130,23.666,1615,3.516,47.333,1404,1404,3137
2015,7121,6583,7053,145791,144352,338,4.814,273,3.889,10709,1870,8839,1.295,7.419,7759,1062,6697,0.736,5.375,2950,2.044,10.750,158,158,767
2015,7131,2291,2647,198465,190884,319,11.995,344,12.935,24633,5044,19589,2.642,12.905,9616,4215,5401,2.208,5.038,15017,7.867,10.075,274,277,2097
2015,7132,1761,2844,157387,156408,296,10.577,205,7.325,12594,4687,7907,2.997,8.052,10512,4231,6281,2.705,6.721,2082,1.331,13.442,162,163,2947
2015,7139,50882,58789,1248773,1227808,6986,12.023,5614,9.662,170735,65294,105441,5.318,13.906,128376,48301,80075,3.934,10.456,42359,3.450,20.911,4106,4162,35037
2015,7211,40301,51372,1970652,1956865,4704,9.219,4005,7.849,218832,97850,120982,5.000,11.183,191821,80912,110909,4.135,9.802,27011,1.380,19.605,2795,2835,50179
2015,7212,5327,5916,43194,42554,454,7.694,424,7.185,6439,1513,4926,3.556,15.132,5290,1486,3804,3.492,12.431,1149,2.700,24.863,255,255,835
2015,7213,1714,1908,11190,11493,138,7.095,212,10.900,1624,697,927,6.065,14.130,2258,1124,1134,9.780,19.647,-634,-5.516,28.261,151,151,820
2015,7223,14022,33771,711518,717920,4114,11.624,7356,20.784,150272,43028,107244,5.993,20.932,160377,94568,65809,13.173,22.339,-10105,-1.408,41.863,1536,1569,9043
2015,7224,36412,37349,362887,361802,3610,9.586,4228,11.227,64020,28503,35517,7.878,17.695,61922,26079,35843,7.208,17.115,2098,0.580,34.230,3489,3500,21830
2015,7225,358934,496396,10096688,9894257,53076,10.798,43362,8.822,1621474,787637,833837,7.961,16.388,1222148,460761,761387,4.657,12.352,399326,4.036,24.704,34442,35624,353811
2015,8111,134015,147708,865270,856934,12418,8.427,11726,7.957,124075,46388,77687,5.413,14.479,106913,44800,62113,5.228,12.476,17162,2.003,24.952,8617,8725,30369
2015,8112,9677,10968,98632,98712,1251,11.410,1243,11.337,14959,5999,8960,6.077,15.154,15371,6089,9282,6.168,15.572,-412,-0.417,30.309,844,851,2753
2015,8113,18146,20054,209634,209477,1652,8.247,1609,8.032,29242,7150,22092,3.413,13.960,29148,8637,20511,4.123,13.915,94,0.045,27.829,1100,1104,4871
2015,8114,17258,17995,69746,68669,2121,11.868,1875,10.491,11583,5050,6533,7.354,16.868,9441,4106,5335,5.979,13.749,2142,3.119,27.497,1373,1374,3082
2015,8121,95469,112250,670235,663935,14020,12.612,11856,10.665,114913,55681,59232,8.387,17.308,103063,43451,59612,6.544,15.523,11850,1.785,31.046,8918,9131,31523
2015,8122,14167,20112,138894,138837,728,3.627,644,3.209,12685,3160,9525,2.276,9.137,12385,2212,10173,1.593,8.921,300,0.216,17.841,410,436,1569
2015,8123,27464,32679,294518,291279,2359,7.159,2901,8.804,38245,11375,26870,3.905,13.130,32033,14282,17751,4.903,10.997,6212,2.133,21.995,2151,2246,8804
2015,8129,27670,37708,294020,285414,6773,18.531,4455,12.189,63541,29674,33867,10.397,22.263,46756,25553,21203,8.953,16.382,16785,5.881,32.764,2406,2433,9929
2015,8131,177947,178287,1681276,1680818,8044,4.520,7397,4.156,132029,23128,108901,1.376,7.855,131141,20635,110506,1.228,7.802,888,0.053,15.604,4686,4686,13102
2015,8132,16466,18409,185581,182921,1309,7.150,1104,6.031,19594,3918,15676,2.142,10.712,14109,3825,10284,2.091,7.713,5485,2.999,15.426,755,778,2132
2015,8133,13956,16479,171541,166194,1161,7.079,1004,6.122,25999,10905,15094,6.562,15.644,14987,3322,11665,1.999,9.018,11012,6.626,18.036,632,633,2132
2015,8134,22517,24424,238286,238257,1254,5.121,1384,5.652,23530,4655,18875,1.954,9.876,23448,5891,17557,2.473,9.841,82,0.034,19.683,892,898,3490
2015,8139,53621,55770,486989,488247,2282,4.065,3022,5.383,43302,8381,34921,1.717,8.869,45665,12578,33087,2.576,9.353,-2363,-0.484,17.738,2100,2105,7753
2016,1131,379,424,4253,3943,38,9.048,30,7.143,840,123,717,3.119,21.304,231,63,168,1.598,5.858,609,15.445,11.717,22,22,48
2016,1132,123,139,1265,1291,18,12.811,21,14.947,183,50,133,3.874,14.181,249,115,134,8.911,19.295,-66,-5.114,28.361,14,14,62
2016,1133,7259,7370,50348,50792,789,10.794,668,9.139,7368,2803,4565,5.519,14.506,8294,2115,6179,4.164,16.329,-926,-1.823,29.012,472,472,1624
2016,1141,1292,1311,5461,5705,248,19.375,186,14.531,949,550,399,9.641,16.635,1460,843,617,14.777,25.592,-511,-8.957,33.269,96,96,178
2016,1142,291,294,1646,1600,31,10.690,23,7.931,284,69,215,4.314,17.756,197,50,147,3.126,12.316,87,5.439,24.633,18,18,37
2016,1151,3680,4030,65143,64541,470,11.791,382,9.584,10085,3919,6166,6.072,15.626,8994,2745,6249,4.253,13.935,1091,1.690,27.871,263,263,2206
2016,1152,3848,3943,19976,19695,527,13.520,437,11.211,3161,1419,1742,7.205,16.050,2624,1224,1400,6.215,13.324,537,2.727,26.647,340,340,926
2016,1153,1307,1380,11643,11681,160,11.675,141,10.288,1720,518,1202,4.435,14.725,1792,492,1300,4.212,15.342,-72,-0.616,29.451,97,97,369
2016,2111,5117,6649,119303,126563,486,7.093,892,13.018,13980,7919,6061,6.257,11.046,28339,8589,19750,6.786,22.391,-14359,-11.345,22.092,579,579,2345
2016,2121,390,746,54317,61814,42,5.320,129,16.339,4094,2179,1915,3.525,6.623,18936,6219,12717,10.061,30.634,-14842,-24.011,13.246,56,73,3803
2016,2122,209,279,38183,39262,26,9.204,33,11.681,2531,377,2154,0.960,6.446,4568,669,3899,1.704,11.635,-2037,-5.188,12.893,21,21,347
2016,2123,2650,4779,79882,80335,245,5.112,272,5.676,8226,2013,6213,2.506,10.240,8976,1838,7138,2.288,11.173,-750,-0.934,20.479,157,158,761
2016,2131,9839,12516,292285,354719,1161,8.806,2496,18.933,24835,13578,11257,3.828,7.001,149621,24285,125336,6.846,42.180,-124786,-35.179,14.003,1582,1592,11615
2016,2211,1701,10668,509930,509512,669,6.354,390,3.704,32728,8989,23739,1.764,6.423,31729,7622,24107,1.496,6.227,999,0.196,12.455,86,91,950
2016,2212,410,2505,87364,87500,123,4.918,115,4.598,5859,2103,3756,2.403,6.696,6058,1660,4398,1.897,6.923,-199,-0.227,13.392,22,23,110
2016,2213,3484,4577,43257,43073,282,6.156,290,6.330,5500,2176,3324,5.052,12.769,5211,2163,3048,5.022,12.098,289,0.671,24.196,139,139,405
2016,2361,133310,134649,661770,641753,24209,18.388,18224,13.842,155003,65418,89585,10.194,24.153,114767,49209,65558,7.668,17.883,40236,6.270,35.767,12081,12085,33720
2016,2362,36601,38082,637685,622581,3786,10.004,3308,8.741,109469,21844,87625,3.509,17.583,79810,17739,62071,2.849,12.819,29659,4.764,25.638,2286,2287,11121
2016,2371,16280,17928,562560,561062,1550,8.671,1444,8.078,93685,20656,73029,3.682,16.698,90231,19598,70633,3.493,16.082,3454,0.616,32.164,965,968,8791
2016,2372,4255,4340,25140,24903,395,9.007,486,11.082,4113,1260,2853,5.060,16.516,3690,1844,1846,7.405,14.817,423,1.699,29.635,368,368,1438
2016,2373,7940,8772,276278,268903,622,7.100,600,6.849,44737,6401,38336,2.380,16.637,29731,5130,24601,1.908,11.056,15006,5.580,22.113,394,396,3502
2016,2379,3610,3732,88007,86761,378,10.176,343,9.234,13816,2220,11596,2.559,15.924,11423,3151,8272,3.632,13.166,2393,2.758,26.332,211,212,1994
2016,2381,75309,76209,815710,789217,10646,14.239,7763,10.383,172543,44324,128219,5.616,21.863,119601,34128,85473,4.324,15.154,52942,6.708,30.309,5009,5016,24219
2016,2382,157931,162519,1918588,1872830,15791,9.822,12307,7.655,307522,68216,239306,3.642,16.420,216124,59561,156563,3.180,11.540,91398,4.880,23.080,8524,8548,38183
2016,2383,95061,96187,754937,733937,13781,14.598,10208,10.814,151467,41785,109682,5.693,20.638,109209,33805,75404,4.606,14.880,42258,5.758,29.760,6765,6782,24412
2016,2389,55292,56070,575154,558932,7529,13.703,5281,9.611,114977,27307,87670,4.886,20.571,82584,21970,60614,3.931,14.775,32393,5.796,29.551,3376,3376,13713
2016,3111,1090,1714,52809,53848,93,5.455,75,4.399,5791,1092,4699,2.028,10.754,7556,1031,6525,1.915,14.032,-1765,-3.278,21.509,53,53,415
2016,3112,473,817,55419,55635,33,4.039,33,4.039,2897,281,2616,0.505,5.207,3274,995,2279,1.788,5.885,-377,-0.678,10.414,20,21,138
2016,3113,1658,1831,79742,77843,154,8.448,138,7.570,9360,2350,7010,3.019,12.024,5559,1221,4338,1.569,7.141,3801,4.883,14.283,101,102,580
2016,3114,1398,1750,155307,155288,159,9.164,129,7.435,13907,1972,11935,1.270,8.956,13955,4734,9221,3.049,8.987,-48,-0.031,17.911,91,91,1686
2016,3115,1062,1560,144779,142916,99,6.371,87,5.598,10637,1115,9522,0.780,7.443,6688,983,5705,0.688,4.680,3949,2.763,9.359,65,65,385
2016,3116,2749,3360,494507,489285,165,4.904,174,5.172,28727,2745,25982,0.561,5.871,18760,2695,16065,0.551,3.834,9967,2.037,7.668,127,127,1132
2016,3117,426,516,30942,30859,36,6.990,34,6.602,3657,387,3270,1.254,11.851,3512,421,3091,1.364,11.381,145,0.470,22.762,23,23,121
2016,3118,9615,10393,290389,288107,1001,9.691,874,8.461,33668,10367,23301,3.598,11.686,28496,8180,20316,2.839,9.891,5172,1.795,19.782,723,725,5397
2016,3119,2943,3405,195892,193960,351,10.434,269,7.996,21121,4694,16427,2.420,10.889,17137,4829,12308,2.490,8.835,3984,2.054,17.671,208,208,2037
2016,3121,6520,7163,182633,175011,1191,17.600,399,5.896,25569,7571,17998,4.326,14.610,10296,2409,7887,1.376,5.883,15273,8.727,11.766,303,303,1395
2016,3122,125,151,13559,13890,21,14.047,18,12.040,611,304,307,2.189,4.399,1228,119,1109,0.857,8.841,-617,-4.442,8.798,16,16,57
2016,3131,251,311,25007,25019,24,7.754,21,6.785,1540,102,1438,0.408,6.155,1466,289,1177,1.155,5.860,74,0.296,11.719,18,18,73
2016,3132,756,842,48439,48212,36,4.203,65,7.589,3706,579,3127,1.201,7.687,3242,995,2247,2.064,6.724,464,0.962,13.449,54,54,785
2016,3133,815,860,28231,28041,36,4.117,65,7.433,2327,271,2056,0.966,8.299,1892,384,1508,1.369,6.747,435,1.551,13.495,53,53,290
2016,3141,1527,1636,53713,53805,81,4.862,141,8.463,3650,391,3259,0.727,6.784,3809,1416,2393,2.632,7.079,-159,-0.296,13.568,104,104,671
2016,3149,3802,3904,58680,58986,327,8.373,330,8.450,5618,1457,4161,2.470,9.524,6255,2031,4224,3.443,10.604,-637,-1.080,19.049,256,256,1271
2016,3151,212,221,11850,12149,16,7.111,24,10.667,596,97,499,0.798,4.906,1225,228,997,1.877,10.083,-629,-5.177,9.812,19,19,164
2016,3152,4604,4650,76253,79101,670,14.116,863,18.182,14141,6302,7839,7.967,17.877,19938,7911,12027,10.001,25.206,-5797,-7.329,35.754,775,775,7121
2016,3159,494,500,8076,7873,45,8.789,69,13.477,1152,170,982,2.159,14.633,752,328,424,4.166,9.552,400,5.081,19.104,54,54,222
2016,3161,163,172,3409,3519,13,7.536,14,8.116,268,46,222,1.307,7.617,481,219,262,6.224,13.671,-213,-6.054,15.234,8,8,16
2016,3162,183,201,11435,11559,23,11.414,24,11.911,351,106,245,0.917,3.037,582,92,490,0.796,5.035,-231,-1.999,6.073,19,19,84
2016,3169,686,691,10853,10862,60,8.664,63,9.097,1069,220,849,2.025,9.842,1080,255,825,2.348,9.943,-11,-0.101,19.683,52,52,218
2016,3211,2610,3052,85133,85301,194,6.362,189,6.198,7090,1659,5431,1.945,8.312,7435,1547,5888,1.814,8.716,-345,-0.404,16.624,139,139,947
2016,3212,1039,1370,75233,73444,78,5.716,67,4.910,7999,1778,6221,2.421,10.891,4477,1200,3277,1.634,6.096,3522,4.795,12.192,47,47,657
2016,3219,7853,8871,232554,228499,830,9.457,642,7.315,27403,7138,20265,3.124,11.993,19089,6290,12799,2.753,8.354,8314,3.639,16.708,491,491,4532
2016,3221,207,424,102728,104047,8,1.865,18,4.196,3428,151,3277,0.145,3.295,5820,1581,4239,1.520,5.594,-2392,-2.299,6.589,12,12,105
2016,3222,2343,3605,245912,245708,119,3.271,184,5.058,16700,3308,13392,1.346,6.797,16328,5573,10755,2.268,6.645,372,0.151,13.291,115,117,2154
2016,3231,22720,24125,448030,447558,1533,6.311,1863,7.670,45844,15520,30324,3.468,10.243,44978,18115,26863,4.048,10.050,866,0.193,20.099,1490,1497,9997
2016,3241,905,2090,104499,103550,130,6.245,113,5.429,8307,2034,6273,1.964,8.022,6482,1929,4553,1.863,6.260,1825,1.762,12.520,44,44,673
2016,3251,1243,2452,155997,157571,191,7.950,92,3.829,13063,4067,8996,2.581,8.290,16086,3358,12728,2.131,10.209,-3023,-1.919,16.580,60,63,2277
2016,3252,1034,1364,95905,96065,59,4.313,67,4.898,7034,1420,5614,1.478,7.322,7314,1180,6134,1.228,7.614,-280,-0.291,14.644,43,44,397
2016,3253,661,916,29744,29376,68,7.522,44,4.867,2607,383,2224,1.304,8.875,1846,542,1304,1.845,6.284,761,2.591,12.568,29,29,256
2016,3254,1697,2203,244133,242261,181,8.316,128,5.881,22443,5753,16690,2.375,9.264,19018,5294,13724,2.185,7.850,3425,1.414,15.700,82,82,1442
2016,3255,1298,1656,60339,59969,87,5.252,88,5.312,5496,1815,3681,3.027,9.165,4826,1499,3327,2.500,8.047,670,1.117,16.095,54,54,559
2016,3256,1867,2067,96967,97218,143,6.928,137,6.638,7515,1696,5819,1.745,7.730,7978,2592,5386,2.666,8.206,-463,-0.476,15.460,91,91,681
2016,3259,1689,2178,79637,79805,139,6.385,137,6.293,6791,1204,5587,1.509,8.510,7066,1499,5567,1.878,8.854,-275,-0.345,17.019,99,100,710
2016,3261,7773,10075,618550,612278,372,3.678,452,4.469,53660,7455,46205,1.218,8.764,40811,8831,31980,1.442,6.665,12849,2.099,13.331,312,318,4780
2016,3262,1379,1786,132994,131770,63,3.507,84,4.676,9113,729,8384,0.553,6.916,6556,1399,5157,1.062,4.975,2557,1.941,9.951,54,55,886
2016,3271,876,1054,33483,33647,72,6.825,74,7.014,2830,725,2105,2.155,8.411,3123,596,2527,1.771,9.282,-293,-0.871,16.822,61,62,462
2016,3272,1339,1590,90678,88375,97,6.064,116,7.252,9192,1091,8101,1.235,10.401,4428,1766,2662,1.998,5.010,4764,5.391,10.021,75,75,520
2016,3273,3941,8486,169755,165638,508,6.052,325,3.872,23971,5784,18187,3.492,14.472,15793,3800,11993,2.294,9.535,8178,4.937,19.069,151,158,1536
2016,3274,169,303,13512,13458,19,6.355,11,3.679,741,147,594,1.092,5.506,625,39,586,0.290,4.644,116,0.862,9.288,8,8,36
2016,3279,2590,3042,75938,75775,187,6.176,159,5.251,7503,1261,6242,1.664,9.902,7161,1532,5629,2.022,9.450,342,0.451,18.901,112,112,949
2016,3311,301,456,92076,96908,20,4.348,28,6.087,2049,160,1889,0.165,2.114,11308,543,10765,0.560,11.669,-9259,-9.554,4.229,19,19,85
2016,3312,498,626,46466,48344,32,5.059,45,7.115,3351,1115,2236,2.306,6.932,7174,1357,5817,2.807,14.840,-3823,-7.908,13.863,35,35,849
2016,3313,379,509,57813,58067,15,2.938,18,3.526,4301,325,3976,0.560,7.407,4716,139,4577,0.239,8.122,-415,-0.715,14.814,15,15,134
2016,3314,732,920,59588,60015,24,2.579,45,4.836,3026,470,2556,0.783,5.042,3815,1122,2693,1.870,6.357,-789,-1.315,10.084,30,31,302
2016,3315,1499,1697,119166,122752,57,3.332,84,4.911,6004,969,5035,0.789,4.891,13096,2433,10663,1.982,10.669,-7092,-5.778,9.782,53,56,1104
2016,3321,2126,2382,109940,112130,74,3.094,93,3.889,6511,747,5764,0.666,5.807,10902,1539,9363,1.373,9.723,-4391,-3.916,11.613,65,65,885
2016,3322,1027,1103,35041,35211,65,5.840,85,7.637,2919,797,2122,2.263,8.290,3278,1155,2123,3.280,9.310,-359,-1.020,16.580,63,63,403
2016,3323,10961,11927,346933,344439,759,6.400,624,5.262,35720,7719,28001,2.241,10.371,30760,7444,23316,2.161,8.930,4960,1.440,17.861,457,459,4509
2016,3324,1193,1506,84796,88991,49,3.224,77,5.066,4447,830,3617,0.933,4.997,12726,1930,10796,2.169,14.300,-8279,-9.303,9.994,49,49,925
2016,3325,515,558,27676,27443,37,6.679,29,5.235,1949,343,1606,1.250,7.102,1471,366,1105,1.334,5.360,478,1.742,10.721,20,20,158
2016,3326,993,1136,38186,38601,29,2.535,45,3.934,2317,333,1984,0.863,6.003,3129,635,2494,1.645,8.106,-812,-2.104,12.005,35,36,552
2016,3327,21190,21768,371731,381254,1062,4.840,1410,6.426,30349,9284,21065,2.435,7.960,49315,10302,39013,2.702,12.935,-18966,-4.975,15.921,1057,1066,6850
2016,3328,4910,5467,126934,128257,259,4.712,318,5.785,11314,2702,8612,2.107,8.821,13911,3493,10418,2.723,10.846,-2597,-2.025,17.643,242,242,2267
2016,3329,5613,6147,261654,265756,349,5.653,403,6.527,18261,3317,14944,1.248,6.871,26800,4993,21807,1.879,10.084,-8539,-3.213,13.743,283,286,1787
2016,3331,2493,2911,188917,203611,114,3.853,209,7.064,8048,1646,6402,0.808,3.953,37539,4797,32742,2.356,18.437,-29491,-14.484,7.905,146,147,1911
2016,3332,2895,3060,105303,105814,147,4.769,192,6.229,7972,1350,6622,1.276,7.534,9114,2287,6827,2.161,8.613,-1142,-1.079,15.068,143,143,957
2016,3333,1747,1869,73021,74070,101,5.364,129,6.851,5038,1080,3958,1.458,6.802,7025,1797,5228,2.426,9.484,-1987,-2.683,13.603,86,86,741
2016,3334,1411,1681,126701,127787,77,4.560,92,5.449,8607,1602,7005,1.254,6.735,10760,4363,6397,3.414,8.420,-2153,-1.685,13.471,62,62,925
2016,3335,5979,6228,146318,147326,250,3.996,306,4.891,10578,2441,8137,1.657,7.180,12520,2831,9689,1.922,8.498,-1942,-1.318,14.360,236,236,1731
2016,3336,794,1003,96354,98760,34,3.366,48,4.752,4851,291,4560,0.295,4.912,9974,1344,8630,1.361,10.099,-5123,-5.187,9.824,27,27,799
2016,3339,5129,5801,293804,296544,252,4.326,301,5.167,20079,4610,15469,1.555,6.771,25601,5093,20508,1.717,8.633,-5522,-1.862,13.542,204,204,1891
2016,3341,916,953,42275,41958,66,6.864,83,8.632,4721,936,3785,2.231,11.252,4090,1205,2885,2.872,9.748,631,1.504,19.496,60,61,885
2016,3342,1159,1276,86737,87689,91,7.132,91,7.132,6896,1281,5615,1.461,7.864,8915,2295,6620,2.617,10.167,-2019,-2.302,15.728,67,68,1131
2016,3343,444,455,9723,9699,49,10.925,36,8.027,827,145,682,1.495,8.527,769,226,543,2.330,7.929,58,0.598,15.858,27,27,160
2016,3344,3335,3770,263122,264985,179,4.726,214,5.650,18543,2832,15711,1.069,6.998,22152,5953,16199,2.247,8.360,-3609,-1.362,13.996,151,152,2391
2016,3345,4225,4883,374954,376037,252,5.117,336,6.822,24518,2997,21521,0.797,6.520,26422,7028,19394,1.869,7.026,-1904,-0.506,13.040,226,228,1838
2016,3346,418,428,9642,9624,40,9.206,53,12.198,1028,334,694,3.470,10.682,1029,581,448,6.037,10.692,-1,-0.010,21.363,41,41,465
2016,3351,976,1036,43435,43209,71,6.837,76,7.318,3672,748,2924,1.731,8.498,3197,865,2332,2.002,7.399,475,1.099,14.798,54,54,545
2016,3352,243,287,48927,48166,23,8.000,24,8.348,3912,569,3343,1.181,8.122,2443,451,1992,0.936,5.072,1469,3.050,10.144,20,20,434
2016,3353,1716,1986,116056,117845,75,3.731,123,6.119,5628,1103,4525,0.936,4.776,9348,1755,7593,1.489,7.932,-3720,-3.157,9.552,82,82,538
2016,3359,1760,2036,135642,135739,100,4.886,121,5.913,10366,1512,8854,1.114,7.637,10549,2279,8270,1.679,7.772,-183,-0.135,15.273,89,89,855
2016,3361,265,319,198170,191637,20,6.250,22,6.875,19533,270,19263,0.141,10.193,6452,298,6154,0.156,3.367,13081,6.826,6.734,13,13,159
2016,3362,1530,1817,144994,141750,110,6.034,122,6.692,15164,2065,13099,1.457,10.698,8864,2172,6692,1.532,6.253,6300,4.444,12.507,88,88,894
2016,3363,3906,4859,561623,552853,212,4.341,262,5.364,50092,5706,44386,1.032,9.061,32554,7609,24945,1.376,5.888,17538,3.172,11.777,170,180,3415
2016,3364,1306,1749,367333,367282,102,5.850,91,5.219,23932,3884,20048,1.057,6.516,23896,8883,15013,2.419,6.506,36,0.010,13.012,53,53,543
2016,3365,150,230,29217,31086,6,2.570,13,5.567,1584,53,1531,0.170,5.096,5347,1669,3678,5.369,17.201,-3763,-12.105,10.191,4,4,43
2016,3366,1275,1408,140146,141563,107,7.597,108,7.668,10667,2154,8513,1.522,7.535,13714,2468,11246,1.743,9.688,-3047,-2.152,15.070,72,72,1482
2016,3369,785,817,31923,31492,90,11.111,76,9.383,3998,887,3111,2.817,12.695,3041,1170,1871,3.715,9.656,957,3.039,19.313,63,63,386
2016,3371,9801,10069,225157,221795,659,6.510,768,7.586,24681,5412,19269,2.440,11.128,17950,6536,11414,2.947,8.093,6731,3.035,16.186,565,569,3995
2016,3372,3259,3426,113932,112068,193,5.594,241,6.986,11252,1861,9391,1.661,10.040,7557,2524,5033,2.252,6.743,3695,3.297,13.487,185,186,1702
2016,3379,612,709,31649,31548,33,4.593,52,7.237,2353,343,2010,1.087,7.459,2168,502,1666,1.591,6.872,185,0.586,13.744,42,42,303
2016,3391,8926,9871,279215,277766,555,5.542,843,8.417,27447,5057,22390,1.821,9.881,24392,7797,16595,2.807,8.782,3055,1.100,17.563,642,644,3514
2016,3399,15130,15527,263615,263298,1496,9.752,1124,7.327,26557,7754,18803,2.945,10.086,25854,8352,17502,3.172,9.819,703,0.267,19.639,849,849,5393
2016,4231,15234,22981,400500,396545,1489,6.471,1545,6.715,41041,11868,29173,2.993,10.350,32802,10194,22608,2.571,8.272,8239,2.078,16.544,1018,1036,5801
2016,4232,9856,11762,154698,153002,979,8.357,885,7.554,17985,4909,13076,3.208,11.755,14643,5215,9428,3.408,9.570,3342,2.184,19.141,639,644,3450
2016,4233,9436,16336,229932,221984,1319,8.163,964,5.966,35799,13368,22431,6.022,16.127,20183,7194,12989,3.241,9.092,15616,7.035,18.184,557,578,3844
2016,4234,21301,32473,648666,648968,2921,9.025,2703,8.352,76800,21036,55764,3.241,11.834,76394,28550,47844,4.399,11.772,406,0.063,23.543,1450,1479,8377
2016,4235,6860,9544,151836,154673,399,4.131,628,6.502,11757,2701,9056,1.746,7.601,17480,4202,13278,2.717,11.301,-5723,-3.700,15.202,393,405,2523
2016,4236,17987,27918,556418,553160,1838,6.575,1909,6.829,73312,20810,52502,3.762,13.253,66876,23770,43106,4.297,12.090,6436,1.163,24.180,1172,1211,7448
2016,4237,9928,18800,241986,238253,1019,5.427,971,5.171,28108,8980,19128,3.769,11.798,20775,9195,11580,3.859,8.720,7333,3.078,17.439,490,500,3010
2016,4238,38139,56074,762777,765851,2965,5.280,3132,5.577,70687,20200,50487,2.638,9.230,77145,20829,56316,2.720,10.073,-6458,-0.843,18.460,1875,1967,10733
2016,4239,27059,30448,322396,328522,2729,8.883,3274,10.657,36026,12226,23800,3.722,10.966,48196,16336,31860,4.973,14.671,-12170,-3.704,21.932,2456,2490,10634
2016,4241,6996,9438,152169,150484,681,7.152,848,8.906,21436,10734,10702,7.133,14.245,18869,9236,9633,6.138,12.539,2567,1.706,25.078,462,583,5327
2016,4242,6259,9673,316186,315078,877,9.100,805,8.353,35715,9786,25929,3.106,11.335,33055,9198,23857,2.919,10.491,2660,0.844,20.982,510,514,3989
2016,4243,13204,14325,200085,200353,1359,9.410,1593,11.030,23627,5895,17732,2.942,11.793,24081,9246,14835,4.615,12.019,-454,-0.227,23.585,1264,1276,6251
2016,4244,24803,32626,812251,809379,2721,8.369,2491,7.662,76752,19779,56973,2.444,9.483,70363,25978,44385,3.210,8.693,6389,0.789,17.387,1829,1854,12390
2016,4245,3211,6103,64313,64174,280,4.578,306,5.003,6512,1575,4937,2.454,10.147,6317,1529,4788,2.383,9.844,195,0.304,19.687,160,165,885
2016,4246,7753,12272,159445,158144,757,6.197,644,5.272,17008,5711,11297,3.611,10.755,14530,3405,11125,2.153,9.188,2478,1.567,18.376,419,437,2152
2016,4247,3968,6291,98009,99838,342,5.409,406,6.421,12217,4243,7974,4.250,12.237,15946,3874,12072,3.880,15.972,-3729,-3.735,24.474,195,246,1801
2016,4248,3230,4248,201346,200012,377,8.960,296,7.035,19184,5306,13878,2.653,9.591,16502,4088,12414,2.044,8.251,2682,1.341,16.501,228,229,2148
2016,4249,20189,26622,350583,348031,2064,7.702,2414,9.008,38103,9656,28447,2.774,10.948,33482,10920,22562,3.138,9.620,4621,1.328,19.241,1519,1532,6190
2016,4251,34015,36398,293474,292155,3643,9.933,4195,11.439,40890,9817,31073,3.360,13.996,38198,14621,23577,5.005,13.075,2692,0.921,26.149,3200,3235,10250
2016,4411,37570,43718,1296688,1272025,3736,8.585,3331,7.655,138867,46215,92652,3.633,10.917,89800,32118,57682,2.525,7.060,49067,3.857,14.119,2574,2624,25221
2016,4412,11172,12868,144598,141648,883,6.861,885,6.877,18501,5708,12793,4.030,13.061,12682,5054,7628,3.568,8.953,5819,4.108,17.906,642,651,3633
2016,4413,26228,55882,528553,526156,2695,4.831,2507,4.494,45168,14142,31026,2.688,8.585,40472,11312,29160,2.150,7.692,4696,0.893,15.384,1693,1740,6976
2016,4421,12880,22326,209280,205751,1397,6.247,1473,6.586,25684,7193,18491,3.496,12.483,18462,5976,12486,2.904,8.973,7222,3.510,17.946,985,1073,4112
2016,4422,17485,25569,247260,246430,1742,6.789,1926,7.506,27830,11626,16204,4.718,11.293,25796,9800,15996,3.977,10.468,2034,0.825,20.936,1171,1194,3683
2016,4431,20260,38668,375583,382770,2232,5.623,4280,10.783,34252,8889,25363,2.322,8.948,48690,20867,27823,5.452,12.720,-14438,-3.772,17.897,2481,2814,13315
2016,4441,34135,56423,1172294,1148571,2442,4.325,2508,4.442,97621,16906,80715,1.472,8.499,50667,13009,37658,1.133,4.411,46954,4.088,8.823,1752,1817,8223
2016,4442,12466,16500,153912,150771,988,6.005,893,5.428,19771,4705,15066,3.121,13.113,13526,3359,10167,2.228,8.971,6245,4.142,17.942,674,687,2374
2016,4451,59980,86555,2836145,2821159,8209,9.508,7768,8.998,265230,104074,161156,3.689,9.401,234668,83177,151491,2.948,8.318,30562,1.083,16.636,5639,5694,27294
2016,4452,16479,20302,166681,162506,2497,12.343,2352,11.627,33243,14200,19043,8.738,20.456,24781,10123,14658,6.229,15.249,8462,5.207,30.499,1549,1590,7685
2016,4453,27721,31733,166459,164121,2610,8.282,2176,6.904,24131,9297,14834,5.665,14.703,19420,6903,12517,4.206,11.833,4711,2.870,23.665,1726,1746,5560
2016,4461,39738,92760,1044255,1039790,10040,11.082,5720,6.313,167172,64004,103168,6.155,16.077,157830,48056,109774,4.622,15.179,9342,0.898,30.358,3148,3328,17012
2016,4471,61836,107501,947328,937224,7154,6.658,7044,6.556,126042,46636,79406,4.976,13.448,105999,36463,69536,3.891,11.310,20043,2.139,22.620,4599,4893,23284
2016,4481,32048,91858,1376304,1366202,6792,7.352,7854,8.501,178942,58684,120258,4.295,13.098,161600,48174,113426,3.526,11.828,17342,1.269,23.657,3449,4930,22071
2016,4482,4976,24343,239693,236891,1117,4.581,1200,4.921,31717,8838,22879,3.731,13.389,25681,7640,18041,3.225,10.841,6036,2.548,21.682,436,492,2445
2016,4483,14549,21472,126010,127938,1182,5.450,1618,7.460,11559,4131,7428,3.229,9.035,15448,5335,10113,4.170,12.075,-3889,-3.040,18.070,1058,1079,2721
2016,4511,24534,35578,475100,476387,2851,8.030,2704,7.616,50077,18958,31119,3.980,10.512,53886,12236,41650,2.568,11.311,-3809,-0.800,21.024,2054,2100,7659
2016,4512,3281,7119,88770,91587,409,5.661,621,8.595,7884,2164,5720,2.363,8.608,13621,4165,9456,4.548,14.872,-5737,-6.264,17.216,304,306,975
2016,4522,24,4877,526845,543658,15,0.306,63,1.285,23672,1382,22290,0.254,4.354,58896,3316,55580,0.610,10.833,-35224,-6.479,8.708,D,D,D
2016,4523,7090,47175,2392473,2364203,2227,4.763,1383,2.958,156447,36750,119697,1.554,6.617,98514,12222,86292,0.517,4.167,57933,2.450,8.334,870,1055,5448
2016,4531,11577,12125,59025,59064,935,7.638,1168,9.541,8392,2728,5664,4.619,14.208,8538,3157,5381,5.345,14.456,-146,-0.247,28.417,926,934,2609
2016,4532,16707,26404,225439,227141,2367,8.909,2698,10.155,32764,13434,19330,5.914,14.425,36183,17602,18581,7.749,15.930,-3419,-1.505,28.849,1680,1782,6071
2016,4533,12884,19131,208486,203829,1707,8.961,1543,8.100,30503,9583,20920,4.701,14.965,20828,6495,14333,3.186,10.218,9675,4.747,20.437,1215,1221,4349
2016,4539,32537,43325,283483,274523,5643,13.334,3634,8.587,48563,20946,27617,7.630,17.690,30811,11773,19038,4.289,11.223,17752,6.466,22.447,2853,2913,9102
2016,4541,30417,31761,456777,453193,5879,19.144,3777,12.299,73289,29204,44085,6.444,16.172,65980,29075,36905,6.416,14.559,7309,1.613,29.118,2842,2854,13043
2016,4542,2977,3388,39834,39655,304,8.898,361,10.566,3826,1034,2792,2.607,9.648,3473,1363,2110,3.437,8.758,353,0.890,17.516,292,298,985
2016,4543,20923,26128,173284,171629,2821,10.907,2293,8.866,24927,10378,14549,6.047,14.524,21313,7992,13321,4.657,12.418,3614,2.106,24.836,1695,1715,5452
2016,4811,412,2156,428156,422469,148,6.827,172,7.934,60284,2450,57834,0.580,14.269,49316,35837,13479,8.483,11.673,10968,2.596,23.347,33,115,34535
2016,4812,1807,2015,37571,36986,184,9.051,220,10.821,4758,1041,3717,2.815,12.865,3633,1018,2615,2.752,9.823,1125,3.042,19.646,166,167,514
2016,4831,617,955,42370,43378,93,9.774,86,9.038,3937,1262,2675,2.909,9.076,6012,1470,4542,3.389,13.860,-2075,-4.784,18.152,57,58,312
2016,4832,402,470,22557,22816,42,8.842,52,10.947,1623,305,1318,1.337,7.114,2155,232,1923,1.017,9.445,-532,-2.332,14.227,38,38,177
2016,4841,54038,64897,983430,968098,11021,17.323,8465,13.306,126437,53131,73306,5.488,13.060,96915,34608,62307,3.575,10.011,29522,3.049,20.022,6086,6121,20951
2016,4842,38696,42626,484900,489435,5282,12.442,4934,11.623,71468,22914,48554,4.682,14.602,80574,27123,53451,5.542,16.463,-9106,-1.861,29.204,3450,3463,16563
2016,4851,461,737,53211,53179,48,6.460,60,8.075,3693,511,3182,0.961,6.945,3642,1008,2634,1.896,6.849,51,0.096,13.697,34,34,363
2016,4852,282,487,13450,13053,43,8.903,35,7.246,2095,307,1788,2.352,16.050,1235,234,1001,1.793,9.461,860,6.589,18.923,23,24,209
2016,4853,6827,6990,77537,77467,1095,15.652,1107,15.823,13351,4325,9026,5.583,17.234,13596,4943,8653,6.381,17.551,-245,-0.316,34.469,890,893,3535
2016,4854,2504,4239,242880,236212,367,8.755,273,6.512,30260,8235,22025,3.486,12.811,16721,5017,11704,2.124,7.079,13539,5.732,14.158,166,166,2153
2016,4855,1111,1239,34195,34082,116,9.243,148,11.793,4529,1002,3527,2.940,13.289,4359,1482,2877,4.348,12.790,170,0.499,25.579,103,104,718
2016,4859,3920,4429,93158,90492,773,18.000,504,11.736,16328,5798,10530,6.407,18.044,10912,4634,6278,5.121,12.059,5416,5.985,24.117,384,387,3339
2016,4861,80,780,14302,14135,60,7.752,48,6.202,2176,786,1390,5.561,15.394,1821,349,1472,2.469,12.883,355,2.511,25.766,7,7,51
2016,4862,112,2151,29980,29590,70,3.260,62,2.888,2607,1254,1353,4.238,8.811,1806,432,1374,1.460,6.104,801,2.707,12.207,8,8,23
2016,4869,72,697,8480,8243,23,3.295,25,3.582,1380,205,1175,2.487,16.742,904,393,511,4.768,10.968,476,5.775,21.935,D,D,D
2016,4871,560,610,11902,11609,92,15.449,63,10.579,2134,457,1677,3.937,18.382,1497,586,911,5.048,12.895,637,5.487,25.790,43,43,540
2016,4872,1260,1302,14580,13830,181,14.097,145,11.293,2734,552,2182,3.991,19.769,1180,597,583,4.317,8.532,1554,11.236,17.064,94,94,472
2016,4879,173,197,2699,2522,31,16.533,12,6.400,632,103,529,4.085,25.064,257,54,203,2.142,10.192,375,14.872,20.385,8,8,48
2016,4881,3792,5564,182256,178294,451,8.170,363,6.576,23620,5070,18550,2.844,13.248,15393,5248,10145,2.943,8.634,8227,4.614,17.267,211,214,1423
2016,4882,504,1359,41901,40733,92,6.693,123,8.949,6314,887,5427,2.178,15.501,4078,1582,2496,3.884,10.012,2236,5.489,20.023,26,28,201
2016,4883,1806,2390,93497,95721,203,8.535,180,7.568,8780,1599,7181,1.670,9.172,13380,2950,10430,3.082,13.978,-4600,-4.806,18.345,122,123,573
2016,4884,9264,10894,101650,98829,1561,14.645,1091,10.235,19724,8821,10903,8.926,19.958,13896,5575,8321,5.641,14.061,5828,5.897,28.121,758,765,3167
2016,4885,13812,19617,256215,255026,1552,7.888,1670,8.487,31954,8693,23261,3.409,12.530,29266,13976,15290,5.480,11.476,2688,1.054,22.951,881,924,5542
2016,4889,1354,1480,16515,16489,225,15.459,176,12.092,2623,1128,1495,6.841,15.908,2588,1024,1564,6.210,15.696,35,0.212,31.392,135,142,785
2016,4921,3825,9664,566993,561238,1033,10.643,1116,11.499,49448,21093,28355,3.758,8.811,36659,13684,22975,2.438,6.532,12789,2.279,13.064,547,549,2552
2016,4922,3560,4064,44128,41759,577,14.116,624,15.266,11218,4582,6636,10.972,26.864,6498,3154,3344,7.553,15.561,4720,11.303,31.121,528,531,2513
2016,4931,7277,15274,830017,809809,1543,10.295,971,6.479,112142,37032,75110,4.573,13.848,73587,24335,49252,3.005,9.087,38555,4.761,18.174,368,395,4035
2016,5111,11263,16049,367916,378282,1290,8.026,1339,8.330,31677,11896,19781,3.145,8.374,52408,13208,39200,3.492,13.854,-20731,-5.480,16.748,793,851,5648
2016,5112,6966,10046,526814,509629,1532,15.706,948,9.719,87780,40003,47777,7.849,17.224,53486,14871,38615,2.918,10.495,34294,6.729,20.990,517,604,5771
2016,5121,14021,17317,386552,388260,2473,14.422,2135,12.450,63053,18144,44909,4.673,16.240,64989,23063,41926,5.940,16.739,-1936,-0.499,32.480,1321,1332,6167
2016,5122,2743,2940,22831,25486,355,12.054,365,12.394,2523,858,1665,3.367,9.900,7609,2203,5406,8.644,29.856,-5086,-19.956,19.799,249,249,625
2016,5151,3918,7337,212101,212365,458,6.087,832,11.058,23867,8049,15818,3.790,11.239,24543,11869,12674,5.589,11.557,-676,-0.318,22.477,206,212,1733
2016,5152,390,717,51544,52045,47,6.523,54,7.495,3468,1247,2221,2.396,6.664,4504,1009,3495,1.939,8.654,-1036,-1.991,13.327,22,22,50
2016,5173,5063,52368,1002829,988275,7461,14.942,2591,5.189,126200,63946,62254,6.470,12.770,98381,33524,64857,3.392,9.955,27819,2.815,19.910,282,297,2045
2016,5174,322,397,8458,8474,50,12.392,63,15.613,1249,353,896,4.166,14.740,1269,464,805,5.476,14.976,-20,-0.236,29.480,42,42,140
2016,5179,3440,4067,57407,57200,754,18.617,720,17.778,11788,4100,7688,7.168,20.608,11204,5904,5300,10.322,19.587,584,1.021,39.175,483,501,2647
2016,5182,9044,13376,481085,478587,1520,11.451,1315,9.907,65959,18695,47264,3.906,13.782,60886,26373,34513,5.511,12.722,5073,1.060,25.444,817,831,9287
2016,5191,8382,10705,283326,276907,1492,14.045,1328,12.501,45779,12232,33547,4.417,16.532,33160,11542,21618,4.168,11.975,12619,4.557,23.950,963,974,5615
2016,5211,13,59,19366,19277,D,D,0,0.000,717,D,716,D,3.719,513,0,513,0.000,2.661,204,1.058,5.322,0,0,0
2016,5221,11318,118248,1962937,1934866,3934,3.321,4368,3.687,231640,43379,188261,2.242,11.972,181076,35845,145231,1.853,9.359,50564,2.613,18.717,381,551,6040
2016,5222,13343,43136,606421,593063,5017,11.893,3114,7.382,105754,28106,77648,4.739,17.832,78582,29492,49090,4.973,13.250,27172,4.582,26.500,1043,1196,8266
2016,5223,11622,26977,287193,279887,2170,8.001,2459,9.067,44896,10040,34856,3.587,16.041,30742,11838,18904,4.230,10.984,14154,5.057,21.967,1057,1180,6806
2016,5231,10811,39729,403047,402308,3239,8.166,3113,7.848,45664,14475,31189,3.598,11.351,44610,11064,33546,2.750,11.089,1054,0.262,22.177,798,817,3076
2016,5232,10,32,6246,6166,D,D,D,D,287,D,279,D,4.655,139,D,98,D,2.254,148,2.400,4.509,0,0,0
2016,5239,43506,51867,492171,486188,8320,16.553,5109,10.165,68677,28556,40121,5.873,14.126,55950,21062,34888,4.332,11.508,12727,2.618,23.016,3464,3486,10339
2016,5241,4772,35917,1548690,1519487,8207,24.378,3705,11.005,214738,82860,131878,5.453,14.132,152945,40604,112341,2.672,10.066,61793,4.067,20.131,281,291,2199
2016,5242,119289,135085,977512,950886,11761,8.746,10538,7.836,170838,86559,84279,9.103,17.966,116833,46377,70456,4.877,12.287,54005,5.679,24.574,7203,7335,25257
2016,5259,674,699,5941,7728,144,20.705,137,19.698,1252,849,403,10.987,16.202,4987,1077,3910,13.937,64.536,-3735,-48.334,32.404,109,109,463
2016,5311,86932,116300,574382,574025,11732,10.163,10010,8.671,89107,40896,48211,7.124,15.523,88289,40268,48021,7.015,15.381,818,0.143,30.761,7065,7170,24665
2016,5312,72288,84389,301192,290825,15111,18.577,9019,11.088,64470,35326,29144,12.147,22.168,43793,18739,25054,6.443,15.058,20677,7.110,30.116,4938,4996,10225
2016,5313,65923,82433,674890,662127,10591,13.039,8177,10.067,113336,49679,63657,7.503,17.117,88526,36441,52085,5.504,13.370,24810,3.747,26.740,4879,4933,20228
2016,5321,3522,15399,166182,165085,1462,9.588,1159,7.601,20497,9503,10994,5.756,12.416,18629,4315,14314,2.614,11.285,1868,1.132,22.569,334,353,1607
2016,5322,7082,17996,144046,143312,1001,5.526,1241,6.850,17475,5631,11844,3.929,12.194,16084,6768,9316,4.723,11.223,1391,0.971,22.446,686,730,3414
2016,5323,2187,2637,19256,18913,161,6.090,174,6.582,2853,764,2089,4.040,15.085,2148,717,1431,3.791,11.357,705,3.728,22.715,127,128,475
2016,5324,7266,14036,181210,181311,1413,10.216,1003,7.252,28487,10734,17753,5.920,15.712,28668,6646,22022,3.666,15.812,-181,-0.100,31.423,564,592,3232
2016,5331,2020,2233,35758,34822,242,10.872,228,10.243,5846,1379,4467,3.960,16.788,4103,1256,2847,3.607,11.783,1743,5.006,23.566,175,175,1039
2016,5411,157186,168979,1137159,1138145,13203,7.807,13487,7.975,112174,35551,76623,3.124,9.856,114232,37390,76842,3.285,10.037,-2058,-0.181,19.712,9959,10050,27219
2016,5412,99577,119432,1251546,1244415,10022,8.396,9877,8.275,166813,51464,115349,4.136,13.405,152224,60969,91255,4.899,12.233,14589,1.172,24.465,6375,6564,34355
2016,5413,81334,101012,1453096,1452744,9216,9.141,8834,8.762,182446,49002,133444,3.373,12.559,183001,57828,125173,3.981,12.597,-555,-0.038,25.117,5016,5066,22569
2016,5414,26149,26541,119825,117020,3844,14.689,3099,11.842,21296,8851,12445,7.564,18.199,15654,6776,8878,5.790,13.377,5642,4.821,26.755,2176,2180,4878
2016,5415,99172,122042,1820913,1776407,21144,17.702,15954,13.357,325441,108210,217231,6.092,18.320,236135,77327,158808,4.353,13.293,89306,5.027,26.586,10455,10549,43031
2016,5416,121981,132798,1234738,1201991,23400,17.782,20987,15.949,245320,103246,142074,8.590,20.409,180197,78631,101566,6.542,14.992,65123,5.418,29.983,14919,14970,52303
2016,5417,12963,16431,668325,661849,2198,13.490,1923,11.802,80141,26602,53539,4.019,12.109,67547,18863,48684,2.850,10.206,12594,1.903,20.412,1073,1089,7073
2016,5418,29202,33331,473824,467699,3974,11.998,3554,10.730,84904,35429,49475,7.575,18.154,72481,20859,51622,4.460,15.497,12423,2.656,30.995,2569,2596,12566
2016,5419,54099,61040,633876,622173,6880,11.431,5177,8.601,95666,33523,62143,5.388,15.376,72513,27567,44946,4.431,11.655,23153,3.721,23.310,3771,3811,18417
2016,5511,26849,54156,3378665,3366630,5059,9.461,3693,6.906,458923,130427,328496,3.874,13.632,437273,104696,332577,3.110,12.988,21650,0.643,25.977,684,722,13760
2016,5611,25516,28129,452051,440297,3583,12.898,2882,10.375,84023,26658,57365,6.055,19.083,60499,21956,38543,4.987,13.740,23524,5.343,27.481,2179,2207,16688
2016,5612,1829,6450,232776,242961,915,14.412,713,11.230,42863,17715,25148,7.291,17.642,61145,21531,39614,8.862,25.167,-18282,-7.525,35.284,111,114,2054
2016,5613,24390,48385,5734603,5720995,5408,11.311,4259,8.908,1062513,255401,807112,4.464,18.572,1034659,314952,719707,5.505,18.085,27854,0.487,36.171,2144,2184,112323
2016,5614,22529,29463,793934,790821,2818,9.537,2987,10.109,115592,35270,80322,4.460,14.617,109657,32674,76983,4.132,13.866,5935,0.750,27.732,2206,2239,16242
2016,5615,12737,22049,225405,227816,3031,13.885,2592,11.874,38529,18588,19941,8.159,16.912,42846,17015,25831,7.469,18.807,-4317,-1.895,33.825,930,944,4256
2016,5616,17804,23702,934819,922550,2318,9.814,2151,9.107,117016,29928,87088,3.244,12.684,92736,31627,61109,3.428,10.052,24280,2.632,20.104,1422,1454,19337
2016,5617,150897,158558,1883213,1848269,23581,15.214,16451,10.614,302742,100557,202185,5.441,16.380,230572,72106,158466,3.901,12.475,72170,3.905,24.950,11383,11402,49252
2016,5619,15599,17685,286153,277926,1870,10.674,1537,8.774,50879,15316,35563,5.511,18.307,34345,9100,25245,3.274,12.358,16534,5.949,24.715,1104,1110,5995
2016,5621,7167,11030,203727,201773,1138,10.564,623,5.783,25583,9363,16220,4.640,12.679,21921,4455,17466,2.208,10.864,3662,1.815,21.728,463,466,3124
2016,5622,1237,2533,52650,51584,157,6.236,126,5.005,6255,1369,4886,2.654,12.126,4235,1123,3112,2.177,8.210,2020,3.916,16.420,84,84,506
2016,5629,8414,9877,131469,132206,914,9.323,767,7.824,20251,5398,14853,4.083,15.318,21691,6728,14963,5.089,16.407,-1440,-1.089,30.636,503,528,4233
2016,6111,18813,21541,1023414,1008326,940,4.353,1044,4.835,86709,16905,69804,1.677,8.599,56247,17169,39078,1.703,5.578,30462,3.021,11.157,625,638,11599
2016,6112,448,994,73762,76075,29,2.888,49,4.880,4136,439,3697,0.577,5.437,8772,2455,6317,3.227,11.531,-4636,-6.094,10.874,21,34,2169
2016,6113,2366,4371,1865594,1868598,142,3.176,341,7.628,79576,3388,76188,0.181,4.259,84606,8701,75905,0.466,4.528,-5030,-0.269,8.517,71,120,5460
2016,6114,6480,6971,59517,59084,797,11.461,763,10.972,9628,2714,6914,4.593,16.296,8723,3373,5350,5.709,14.764,905,1.532,29.528,521,524,2321
2016,6115,6078,7707,109591,110013,666,8.619,707,9.149,15801,3582,12219,3.256,14.363,16510,6784,9726,6.167,15.007,-709,-0.644,28.726,404,472,5341
2016,6116,41397,44690,421723,411045,5883,13.418,4194,9.565,82414,32547,49867,7.918,20.050,61075,20127,40948,4.897,14.858,21339,5.191,29.717,3102,3135,13853
2016,6117,6367,7237,106006,105647,1226,17.397,846,12.005,19968,6084,13884,5.759,18.901,19255,10408,8847,9.852,18.226,713,0.675,36.452,555,560,3700
2016,6211,157707,207021,2491863,2441761,17326,8.388,16379,7.930,362822,138563,224259,5.675,14.859,260391,97499,162892,3.993,10.664,102431,4.195,21.328,11487,11831,58778
2016,6212,119162,129073,922590,914381,7112,5.520,6656,5.166,110745,38222,72523,4.180,12.111,94397,31949,62448,3.494,10.324,16348,1.788,20.647,5525,5597,26889
2016,6213,119513,138865,843449,826518,13459,9.818,9911,7.230,137745,48886,88859,5.915,16.666,104092,43253,60839,5.233,12.594,33653,4.072,25.188,6904,7069,25135
2016,6214,16368,41473,973448,950330,3459,8.502,1882,4.626,123699,42490,81209,4.471,13.016,77262,22576,54686,2.376,8.130,46437,4.886,16.260,945,1020,10249
2016,6215,7026,16505,287547,283669,1552,9.482,1278,7.808,39382,12442,26940,4.386,13.883,31402,9859,21543,3.476,11.070,7980,2.813,22.140,610,623,5495
2016,6216,20713,30387,1419421,1392097,3707,12.455,2457,8.255,208322,49388,158934,3.548,14.965,153068,42706,110362,3.068,10.995,55254,3.969,21.991,1618,1655,24525
2016,6219,6212,10276,296123,294709,1285,12.861,716,7.166,42700,16113,26587,5.467,14.489,39060,9378,29682,3.182,13.254,3640,1.235,26.508,478,506,6235
2016,6221,2485,5018,5204969,5155498,83,1.651,100,1.989,228954,19191,209763,0.372,4.441,131089,23723,107366,0.460,2.543,97865,1.898,5.085,38,38,6758
2016,6222,413,633,236371,232120,24,3.813,17,2.701,17743,2581,15162,1.112,7.644,9516,1745,7771,0.752,4.100,8227,3.544,8.199,9,9,756
2016,6223,348,951,291515,288457,25,2.636,20,2.109,14839,1861,12978,0.645,5.144,8637,2326,6311,0.806,2.994,6202,2.150,5.988,13,13,1337
2016,6231,8388,16439,1675926,1676152,994,6.082,802,4.907,145772,64080,81692,3.823,8.697,144906,59017,85889,3.521,8.645,866,0.052,17.290,523,534,38610
2016,6232,9885,41636,763104,759351,2922,7.158,1290,3.160,92653,27734,64919,3.652,12.202,85072,16661,68411,2.194,11.203,7581,0.998,22.407,360,404,4894
2016,6233,16496,23402,930816,919028,2035,8.790,1536,6.634,97904,31489,66415,3.426,10.653,75312,24528,50784,2.669,8.195,22592,2.458,16.389,1121,1163,18361
2016,6239,2961,4883,130412,129466,402,8.297,326,6.729,14746,3766,10980,2.909,11.390,12840,3088,9752,2.385,9.918,1906,1.472,19.835,166,178,1296
2016,6241,58690,76756,1692258,1665897,10031,13.383,6431,8.580,237286,64230,173056,3.856,14.244,186626,42594,144032,2.557,11.203,50660,3.041,22.405,4367,4422,28863
2016,6242,10171,14326,199685,195000,749,5.262,563,3.956,29306,4506,24800,2.311,15.029,19809,3770,16039,1.933,10.158,9497,4.870,20.317,262,303,1526
2016,6243,3966,7566,319074,321953,423,5.625,332,4.415,34298,7627,26671,2.369,10.653,39953,5752,34201,1.787,12.410,-5655,-1.756,21.306,151,154,2381
2016,6244,55676,71225,931243,913801,6753,9.553,5686,8.043,127167,42810,84357,4.685,13.916,92033,35723,56310,3.909,10.071,35134,3.845,20.143,4155,4257,26788
2016,7111,7270,7417,125642,123880,877,11.930,746,10.148,19628,5241,14387,4.231,15.844,16013,4386,11627,3.541,12.926,3615,2.918,25.852,488,488,3067
2016,7112,3232,3414,135856,132149,415,12.179,402,11.798,19596,4037,15559,3.055,14.829,12146,2238,9908,1.694,9.191,7450,5.638,18.382,318,319,1878
2016,7113,6265,6710,171583,167961,804,12.152,616,9.311,23152,5797,17355,3.451,13.784,15718,3498,12220,2.083,9.358,7434,4.426,18.716,439,439,2477
2016,7114,3037,3215,20377,20134,517,16.473,364,11.598,3341,1314,2027,6.526,16.594,2833,1229,1604,6.104,14.071,508,2.523,28.142,242,244,760
2016,7115,15825,15866,46762,46770,3118,20.101,2410,15.536,11452,6553,4899,14.011,24.486,11531,5452,6079,11.657,24.655,-79,-0.169,48.972,1440,1440,3577
2016,7121,6655,7135,150824,148305,366,5.163,275,3.879,12642,1243,11399,0.838,8.524,7584,1069,6515,0.721,5.114,5058,3.411,10.228,173,173,744
2016,7131,2398,2780,204472,201586,441,16.213,321,11.801,18745,7617,11128,3.779,9.299,12587,3963,8624,1.966,6.244,6158,3.055,12.488,262,266,2927
2016,7132,1756,2882,152130,152294,257,8.977,219,7.649,9116,2830,6286,1.858,5.986,9364,2423,6941,1.591,6.149,-248,-0.163,11.972,140,149,1499
2016,7139,52652,60900,1304749,1276453,7635,12.750,5599,9.350,191689,67314,124375,5.274,15.017,133784,50556,83228,3.961,10.481,57905,4.536,20.962,4233,4268,35663
2016,7211,41091,52262,2004023,1993227,4983,9.604,4223,8.140,212730,96413,116317,4.837,10.673,191465,82529,108936,4.140,9.606,21265,1.067,19.212,2793,2834,45736
2016,7212,5374,5974,44405,43966,491,8.244,454,7.623,6720,1558,5162,3.544,15.285,5758,1676,4082,3.812,13.097,962,2.188,26.193,309,310,1141
2016,7213,1692,1882,10927,10980,110,5.808,134,7.075,1551,267,1284,2.432,14.126,1651,455,1196,4.144,15.036,-100,-0.911,28.251,93,93,274
2016,7223,14780,37873,786503,749280,7762,21.730,3458,9.681,210271,123585,86686,16.494,28.063,137566,39745,97821,5.304,18.360,72705,9.703,36.720,1614,1629,8948
2016,7224,36532,37464,372944,368392,3897,10.395,3944,10.521,67957,32629,35328,8.857,18.447,58934,25751,33183,6.990,15.998,9023,2.449,31.995,3304,3330,22138
2016,7225,368115,509789,10482642,10291163,53977,10.728,40697,8.088,1584148,768029,816119,7.463,15.393,1202686,439319,763367,4.269,11.687,381462,3.707,23.373,32465,33431,337114
2016,8111,135064,149161,890738,878568,12790,8.610,11549,7.775,128961,46846,82115,5.332,14.679,104529,41426,63103,4.715,11.898,24432,2.781,23.795,8558,8675,30873
2016,8112,9882,11224,101359,99883,1331,11.930,1197,10.729,16975,5125,11850,5.131,16.995,14004,4633,9371,4.638,14.020,2971,2.974,28.041,897,905,3057
2016,8113,18197,20017,197517,198120,1728,8.659,1607,8.053,27114,9310,17804,4.699,13.686,27962,7745,20217,3.909,14.114,-848,-0.428,27.371,1157,1168,4095
2016,8114,17534,18324,70969,70162,2232,12.303,1867,10.291,11689,5019,6670,7.153,16.660,10087,4470,5617,6.371,14.377,1602,2.283,28.753,1386,1390,3378
2016,8121,98658,115598,699322,685200,15251,13.382,11989,10.520,128609,62240,66369,9.083,18.770,100740,43318,57422,6.322,14.702,27869,4.067,29.405,9433,9572,35110
2016,8122,14157,20197,139922,139444,712,3.532,636,3.155,11441,2553,8888,1.831,8.205,10412,2079,8333,1.491,7.467,1029,0.738,14.934,423,438,1488
2016,8123,27139,32384,294546,295186,2410,7.405,2736,8.406,32585,10946,21639,3.708,11.039,34052,14286,19766,4.840,11.536,-1467,-0.497,22.078,2148,2241,9406
2016,8129,29354,39231,309838,301193,5982,15.574,4340,11.299,59455,23356,36099,7.755,19.740,41550,17502,24048,5.811,13.795,17905,5.945,27.590,2582,2623,9931
2016,8131,178574,179120,1688483,1683876,8461,4.738,7392,4.139,141311,23752,117559,1.411,8.392,132562,23164,109398,1.376,7.872,8749,0.520,15.745,4652,4652,15404
2016,8132,16961,18978,194587,190372,1496,7.971,1075,5.728,27229,11982,15247,6.294,14.303,18965,8334,10631,4.378,9.962,8264,4.341,19.924,761,768,2050
2016,8133,14276,16898,175218,172978,1336,7.981,1019,6.087,21948,4982,16966,2.880,12.688,17365,4718,12647,2.728,10.039,4583,2.649,20.078,631,637,2275
2016,8134,22771,24723,243316,242094,1478,6.003,1272,5.167,26433,5756,20677,2.378,10.919,24142,5478,18664,2.263,9.972,2291,0.946,19.944,827,830,3328
2016,8139,53592,55770,491961,489393,2612,4.684,2590,4.645,48448,9569,38879,1.955,9.900,43427,11444,31983,2.338,8.874,5021,1.026,17.747,1849,1851,7320
2017,1131,414,449,3829,4022,59,13.501,35,8.009,424,149,275,3.705,10.543,798,362,436,9.002,19.843,-374,-9.300,21.087,21,21,78
2017,1132,122,138,1122,1195,16,11.594,16,11.594,139,52,87,4.351,11.632,285,31,254,2.594,23.849,-146,-12.218,23.264,8,8,18
2017,1133,7118,7213,48648,49531,602,8.257,758,10.396,5993,1720,4273,3.473,12.099,7765,2430,5335,4.906,15.677,-1772,-3.578,24.199,516,516,1612
2017,1141,1322,1339,5539,5338,238,17.976,208,15.710,1307,600,707,11.241,24.487,867,347,520,6.501,16.244,440,8.244,32.487,122,122,210
2017,1142,309,311,1679,1689,42,13.816,28,9.211,232,90,142,5.329,13.736,249,90,159,5.329,14.742,-17,-1.007,27.472,22,22,69
2017,1151,3757,4099,68217,66248,469,11.549,393,9.677,13575,4275,9300,6.453,20.491,9614,3513,6101,5.303,14.512,3961,5.979,29.024,253,253,2463
2017,1152,3928,4016,20414,20169,500,12.553,434,10.896,3113,1180,1933,5.851,15.435,2646,1080,1566,5.355,13.119,467,2.315,26.238,327,327,822
2017,1153,1340,1447,12243,12010,208,14.679,148,10.445,2817,975,1842,8.119,23.456,2336,535,1801,4.455,19.451,481,4.005,38.903,96,96,253
2017,2111,4603,5884,110369,112995,387,6.284,936,15.199,16854,6336,10518,5.607,14.916,22241,11736,10505,10.386,19.683,-5387,-4.767,29.832,523,541,2722
2017,2121,332,657,49168,51134,49,7.107,114,16.534,7084,3289,3795,6.432,13.854,10987,3344,7643,6.540,21.487,-3903,-7.633,27.708,52,54,574
2017,2122,181,244,36701,37385,29,11.440,48,18.935,3610,1097,2513,2.934,9.656,4992,2328,2664,6.227,13.353,-1382,-3.697,19.313,28,28,135
2017,2123,2493,4613,85705,83218,241,5.193,296,6.379,13745,1823,11922,2.191,16.517,9029,2554,6475,3.069,10.850,4716,5.667,21.700,135,137,879
2017,2131,9273,12100,293630,291877,1707,13.899,2070,16.855,62396,23161,39235,7.935,21.377,59752,25440,34312,8.716,20.472,2644,0.906,40.943,1204,1255,11624
2017,2211,1725,10860,510430,511083,680,6.311,510,4.733,36878,13692,23186,2.679,7.216,38337,5607,32730,1.097,7.501,-1459,-0.285,14.431,73,77,790
2017,2212,403,2491,90212,89151,170,6.800,188,7.520,9141,3050,6091,3.421,10.253,6858,3113,3745,3.492,7.693,2283,2.561,15.385,20,20,137
2017,2213,3450,4644,44500,44283,246,5.308,227,4.898,4894,1744,3150,3.938,11.052,4510,1020,3490,2.303,10.184,384,0.867,20.369,132,132,422
2017,2361,136604,137967,680149,664970,24285,17.927,19283,14.235,152351,66218,86133,9.958,22.911,122378,53993,68385,8.120,18.404,29973,4.507,36.807,12842,12849,36214
2017,2362,36625,38063,644559,634216,3514,9.220,3615,9.485,103381,19891,83490,3.136,16.301,82552,20759,61793,3.273,13.016,20829,3.284,26.033,2442,2444,12978
2017,2371,15950,17554,584742,585684,1383,7.838,1566,8.875,87225,14748,72477,2.518,14.893,88575,22842,65733,3.900,15.123,-1350,-0.230,29.786,962,968,7471
2017,2372,3995,4096,21173,20986,395,9.593,438,10.638,3615,1381,2234,6.581,17.226,3308,1313,1995,6.257,15.763,307,1.463,31.526,316,316,960
2017,2373,7864,8717,294212,288257,502,5.724,609,6.944,43031,4758,38273,1.651,14.928,31219,4885,26334,1.695,10.830,11812,4.098,21.661,381,384,2979
2017,2379,3566,3686,66470,66319,392,10.671,367,9.990,11541,3213,8328,4.845,17.402,11263,3292,7971,4.964,16.983,278,0.419,33.966,244,247,1124
2017,2381,76962,77903,852155,840050,9775,12.641,8624,11.153,163462,41568,121894,4.948,19.459,139117,36591,102526,4.356,16.561,24345,2.898,33.121,5497,5503,23993
2017,2382,161558,166228,1980404,1948900,16016,9.729,12814,7.784,299307,59955,239352,3.076,15.358,236242,60938,175304,3.127,12.122,63065,3.236,24.244,8744,8759,39796
2017,2383,98208,99425,793576,777172,13493,13.753,10861,11.070,155333,44866,110467,5.773,19.987,122805,37349,85456,4.806,15.802,32528,4.185,31.603,7259,7269,25809
2017,2389,57234,58056,615929,603231,7093,12.356,5788,10.083,103442,26084,77358,4.324,17.148,77899,22496,55403,3.729,12.914,25543,4.234,25.827,3694,3697,15036
2017,3111,1090,1714,50252,49905,86,5.023,82,4.790,5224,1347,3877,2.699,10.468,4611,1181,3430,2.367,9.240,613,1.228,18.479,52,52,677
2017,3112,517,862,56381,56134,51,5.982,32,3.754,4444,546,3898,0.973,7.917,4018,463,3555,0.825,7.158,426,0.759,14.316,19,19,257
2017,3113,1656,1829,81646,81590,133,7.274,132,7.219,7065,968,6097,1.186,8.659,7064,1789,5275,2.193,8.658,1,0.001,17.316,99,101,993
2017,3114,1410,1771,159654,158351,137,7.760,126,7.137,16073,1965,14108,1.241,10.150,13484,2680,10804,1.692,8.515,2589,1.635,17.031,84,85,1133
2017,3115,1046,1547,145571,144520,111,7.194,103,6.675,13197,2241,10956,1.551,9.132,11235,3042,8193,2.105,7.774,1962,1.358,15.548,78,78,1682
2017,3116,2704,3335,509456,502488,169,5.052,190,5.679,39536,7402,32134,1.473,7.868,25695,5639,20056,1.122,5.114,13841,2.754,10.227,137,137,2205
2017,3117,400,495,31767,31149,32,6.394,43,8.591,3381,706,2675,2.267,10.854,2231,688,1543,2.209,7.162,1150,3.692,14.325,30,31,575
2017,3118,9710,10517,294466,292515,973,9.281,906,8.642,34708,8714,25994,2.979,11.865,30963,9627,21336,3.291,10.585,3745,1.280,21.170,698,709,5850
2017,3119,3053,3534,210534,204969,373,10.731,257,7.394,25763,5227,20536,2.550,12.569,14750,5351,9399,2.611,7.196,11013,5.373,14.392,176,181,2756
2017,3121,7286,7971,203956,192909,1273,16.821,467,6.171,34799,10397,24402,5.390,18.039,12487,3518,8969,1.824,6.473,22312,11.566,12.946,319,319,1896
2017,3122,133,156,13891,13784,22,14.148,21,13.505,1427,177,1250,1.284,10.353,1180,206,974,1.494,8.561,247,1.792,17.121,15,15,110
2017,3131,221,277,22858,23588,17,5.986,31,10.915,1609,366,1243,1.552,6.821,3216,1191,2025,5.049,13.634,-1607,-6.813,13.643,21,24,560
2017,3132,724,806,45729,46483,44,5.409,59,7.253,3970,772,3198,1.661,8.541,5434,1154,4280,2.483,11.690,-1464,-3.150,17.082,40,42,487
2017,3133,746,789,26988,27521,43,5.352,72,8.961,2100,668,1432,2.427,7.631,3191,1217,1974,4.422,11.595,-1091,-3.964,15.261,53,53,793
2017,3141,1460,1565,51571,52265,92,5.814,127,8.025,5230,1723,3507,3.297,10.007,6828,2410,4418,4.611,13.064,-1598,-3.058,20.014,97,98,496
2017,3149,3647,3744,56584,56804,287,7.597,355,9.397,5632,1036,4596,1.824,9.915,6105,1890,4215,3.327,10.748,-473,-0.833,19.830,258,258,921
2017,3151,201,210,11074,11276,10,4.695,16,7.512,899,350,549,3.104,7.973,1301,425,876,3.769,11.538,-402,-3.565,15.945,15,15,280
2017,3152,4245,4293,72489,75119,589,13.317,849,19.195,10797,5022,5775,6.685,14.373,16028,6121,9907,8.148,21.337,-5231,-6.964,28.746,754,756,5512
2017,3159,504,511,8235,8517,57,11.166,56,10.970,919,325,594,3.816,10.790,1442,182,1260,2.137,16.931,-523,-6.141,21.580,49,49,159
2017,3161,156,165,3564,3458,12,7.143,18,10.714,461,28,433,0.810,13.333,244,87,157,2.516,7.057,217,6.276,14.114,12,12,56
2017,3162,182,200,12184,11827,21,10.526,20,10.025,1307,67,1240,0.567,11.051,628,159,469,1.344,5.310,679,5.741,10.620,17,17,50
2017,3169,685,690,11439,11495,56,8.034,70,10.043,1232,332,900,2.888,10.718,1310,304,1006,2.645,11.396,-78,-0.679,21.435,59,59,188
2017,3211,2642,3103,88212,87652,196,6.292,220,7.063,8970,2119,6851,2.418,10.234,7779,2833,4946,3.232,8.875,1191,1.359,17.750,153,153,1430
2017,3212,1026,1390,79886,77742,91,6.578,78,5.638,11183,2932,8251,3.771,14.385,6759,2080,4679,2.676,8.694,4424,5.691,17.388,50,50,918
2017,3219,8056,9158,237870,232697,859,9.478,670,7.392,31035,8277,22758,3.557,13.337,20514,7399,13115,3.180,8.816,10521,4.521,17.632,487,491,4705
2017,3221,155,368,96706,98683,12,3.252,14,3.794,3955,951,3004,0.964,4.008,8040,1293,6747,1.310,8.147,-4085,-4.140,8.016,5,5,61
2017,3222,2331,3596,247584,248068,120,3.306,188,5.179,20079,4491,15588,1.810,8.094,21076,6278,14798,2.531,8.496,-997,-0.402,16.188,107,110,1734
2017,3231,22287,23742,452246,457088,1376,5.735,1882,7.843,40567,12192,28375,2.667,8.875,50373,16982,33391,3.715,11.020,-9806,-2.145,17.750,1452,1462,8973
2017,3241,889,2065,105340,105662,94,4.514,129,6.194,6882,772,6110,0.731,6.513,7664,3217,4447,3.045,7.253,-782,-0.740,13.026,38,38,559
2017,3251,1209,2394,156810,155920,105,4.327,170,7.006,16845,3572,13273,2.291,10.804,14754,5857,8897,3.756,9.463,2091,1.341,18.925,62,63,959
2017,3252,1037,1374,100001,99358,54,3.907,70,5.065,9498,1511,7987,1.521,9.559,8172,2570,5602,2.587,8.225,1326,1.335,16.450,41,42,1157
2017,3253,675,922,30881,30510,64,6.960,59,6.417,3037,684,2353,2.242,9.954,2274,517,1757,1.695,7.453,763,2.501,14.907,28,29,274
2017,3254,1749,2246,253004,249651,214,9.605,178,7.989,28448,4558,23890,1.826,11.395,21660,6806,14854,2.726,8.676,6788,2.719,17.352,99,99,1743
2017,3255,1318,1691,63364,62833,74,4.371,78,4.607,4619,664,3955,1.057,7.351,3588,1128,2460,1.795,5.710,1031,1.641,11.421,51,51,682
2017,3256,1900,2109,101822,100362,177,8.439,154,7.342,11289,1912,9377,1.905,11.248,8472,3178,5294,3.167,8.441,2817,2.807,16.883,118,118,1591
2017,3259,1695,2176,83556,83108,141,6.419,182,8.286,8543,1536,7007,1.848,10.279,7577,1975,5602,2.376,9.117,966,1.162,18.234,115,125,1294
2017,3261,7682,10073,635747,629469,374,3.688,508,5.010,59488,8687,50801,1.380,9.451,46681,12870,33811,2.045,7.416,12807,2.035,14.832,329,336,5632
2017,3262,1355,1784,133164,133605,64,3.571,80,4.464,8843,1329,7514,0.995,6.619,9796,2928,6868,2.192,7.332,-953,-0.713,13.238,51,51,1030
2017,3271,861,1040,33991,34017,61,5.826,75,7.163,2770,556,2214,1.635,8.143,2823,938,1885,2.757,8.299,-53,-0.156,16.286,52,53,305
2017,3272,1341,1587,93050,91929,100,6.274,114,7.152,8268,1944,6324,2.115,8.994,5950,2026,3924,2.204,6.472,2318,2.522,12.945,78,78,867
2017,3273,3914,8506,172899,170691,399,4.696,381,4.484,23264,4869,18395,2.853,13.629,18825,5143,13682,3.013,11.029,4439,2.601,22.057,168,169,2229
2017,3274,146,278,13742,13279,15,5.329,22,7.815,1500,95,1405,0.715,11.296,514,82,432,0.618,3.871,986,7.426,7.742,19,19,77
2017,3279,2578,3048,78443,78398,183,5.972,216,7.048,8626,1753,6873,2.236,11.003,8576,2610,5966,3.329,10.939,50,0.064,21.878,126,127,1247
2017,3311,166,289,86965,86607,16,5.351,36,12.040,8645,3636,5009,4.198,9.982,7860,1529,6331,1.765,9.075,785,0.906,18.151,21,21,619
2017,3312,483,650,48507,48085,34,5.263,26,4.025,4214,434,3780,0.903,8.764,3381,219,3162,0.455,7.031,833,1.732,14.063,18,18,108
2017,3313,314,445,57417,57293,24,5.357,30,6.696,5099,2312,2787,4.035,8.900,5294,2380,2914,4.154,9.240,-195,-0.340,17.800,20,24,2034
2017,3314,608,799,56166,57243,25,3.092,44,5.442,3503,1001,2502,1.749,6.120,5600,2080,3520,3.634,9.783,-2097,-3.663,12.239,26,26,364
2017,3315,1436,1633,116174,117927,53,3.212,87,5.273,8212,1061,7151,0.900,6.964,11764,2866,8898,2.430,9.976,-3552,-3.012,13.927,61,62,1708
2017,3321,2023,2287,103692,103903,67,2.900,113,4.892,8471,1566,6905,1.507,8.153,8947,2651,6296,2.551,8.611,-476,-0.458,16.306,81,81,1233
2017,3322,1001,1076,34147,34359,56,5.173,69,6.374,2647,613,2034,1.784,7.704,3049,708,2341,2.061,8.874,-402,-1.170,15.408,50,50,290
2017,3323,11245,12276,359691,358257,746,6.083,722,5.887,38925,10424,28501,2.910,10.865,35917,12536,23381,3.499,10.025,3008,0.840,20.051,504,506,6844
2017,3324,1183,1497,84504,84892,70,4.631,99,6.550,10590,2648,7942,3.119,12.475,11324,2305,9019,2.715,13.339,-734,-0.865,24.949,55,55,904
2017,3325,544,590,28785,28365,32,5.433,30,5.093,2479,709,1770,2.500,8.740,1532,206,1326,0.726,5.401,947,3.339,10.802,23,23,187
2017,3326,952,1101,38478,38623,28,2.513,54,4.847,3031,682,2349,1.766,7.848,3311,1117,2194,2.892,8.573,-280,-0.725,15.696,36,36,558
2017,3327,20992,21575,370724,373365,981,4.497,1463,6.706,34544,8683,25861,2.326,9.252,39916,12910,27006,3.458,10.691,-5372,-1.439,18.504,1042,1052,7934
2017,3328,4759,5317,127987,127351,223,4.155,323,6.018,14135,2241,11894,1.760,11.099,12826,3568,9258,2.802,10.071,1309,1.028,20.143,230,230,2230
2017,3329,5441,5948,249217,250788,377,6.300,450,7.519,21130,4131,16999,1.647,8.425,24455,9052,15403,3.609,9.751,-3325,-1.326,16.851,306,309,3959
2017,3331,2428,2808,183342,184788,129,4.533,205,7.203,17195,3303,13892,1.787,9.305,20200,3975,16225,2.151,10.931,-3005,-1.626,18.611,118,118,1045
2017,3332,2829,2993,110040,108052,151,5.025,175,5.824,12225,2239,9986,2.072,11.314,8250,2658,5592,2.460,7.635,3975,3.679,15.270,118,119,1649
2017,3333,1689,1812,70234,70374,114,6.255,135,7.407,6286,1299,4987,1.846,8.932,6508,2170,4338,3.084,9.248,-222,-0.315,17.865,90,90,1143
2017,3334,1390,1651,127726,127102,74,4.448,99,5.951,9132,1238,7894,0.974,7.185,7755,2352,5403,1.850,6.101,1377,1.083,12.203,64,64,952
2017,3335,5800,6046,147547,147334,245,4.015,358,5.866,14063,2903,11160,1.970,9.545,13637,4231,9406,2.872,9.256,426,0.289,18.512,268,269,2601
2017,3336,723,926,100592,100901,32,3.349,91,9.524,9958,1429,8529,1.416,9.869,10850,5060,5790,5.015,10.753,-892,-0.884,19.738,39,40,814
2017,3339,5097,5800,296541,297908,251,4.295,340,5.817,24818,5487,19331,1.842,8.331,27759,7662,20097,2.572,9.318,-2941,-0.987,16.662,232,232,3103
2017,3341,851,882,39185,38954,75,8.427,91,10.225,4351,375,3976,0.963,11.170,3851,1173,2678,3.011,9.886,500,1.284,19.772,68,68,438
2017,3342,1094,1195,81981,82714,69,5.667,114,9.363,5243,845,4398,1.022,6.339,6699,2625,4074,3.174,8.099,-1456,-1.760,12.677,74,75,829
2017,3343,423,435,8925,9236,33,7.517,41,9.339,834,133,701,1.440,9.030,1460,704,756,7.622,15.808,-626,-6.778,18.060,24,24,132
2017,3344,3292,3738,256483,259993,182,4.818,261,6.909,17223,2323,14900,0.893,6.624,24199,7440,16759,2.862,9.308,-6976,-2.683,13.249,186,187,2988
2017,3345,4233,4929,387633,386299,243,4.895,313,6.305,31338,5251,26087,1.359,8.112,28858,7006,21852,1.814,7.470,2480,0.642,14.941,217,217,2884
2017,3346,399,407,7991,8868,29,6.980,46,11.071,887,128,759,1.443,10.002,2513,668,1845,7.533,28.338,-1626,-18.336,20.005,40,40,348
2017,3351,954,1014,43111,43319,74,7.283,78,7.677,3137,567,2570,1.309,7.242,3455,946,2509,2.184,7.976,-318,-0.734,14.483,58,58,671
2017,3352,239,287,51914,50375,28,9.773,27,9.424,4833,1198,3635,2.378,9.594,1827,514,1313,1.020,3.627,3006,5.967,7.254,18,18,40
2017,3353,1681,1942,113003,114530,82,4.179,122,6.218,8921,1777,7144,1.552,7.789,11980,2494,9486,2.178,10.460,-3059,-2.671,15.579,74,74,971
2017,3359,1703,1988,132402,132195,110,5.508,128,6.410,10393,1966,8427,1.487,7.862,9897,3452,6445,2.611,7.487,496,0.375,14.973,81,81,1331
2017,3361,247,297,206729,199382,33,11.224,27,9.184,20443,344,20099,0.173,10.253,5769,950,4819,0.476,2.893,14674,7.360,5.787,19,19,239
2017,3362,1541,1852,152360,149517,126,6.822,116,6.280,19041,4409,14632,2.949,12.735,13524,4816,8708,3.221,9.045,5517,3.690,18.090,79,80,2754
2017,3363,3852,4801,588836,581277,217,4.476,312,6.435,52244,6453,45791,1.110,8.988,37308,9837,27471,1.692,6.418,14936,2.570,12.837,191,198,3328
2017,3364,1254,1680,366358,366585,86,5.069,119,7.014,23877,1200,22677,0.327,6.513,24505,5792,18713,1.580,6.685,-628,-0.171,13.027,69,69,877
2017,3365,147,225,29119,29861,6,2.597,18,7.792,2040,477,1563,1.597,6.832,3512,489,3023,1.638,11.761,-1472,-4.930,13.664,9,9,224
2017,3366,1271,1400,137585,139290,109,7.791,107,7.648,9314,1627,7687,1.168,6.687,12575,1709,10866,1.227,9.028,-3261,-2.341,13.374,71,71,677
2017,3369,758,791,32914,33250,73,9.194,79,9.950,3474,1641,1833,4.935,10.448,4132,1043,3089,3.137,12.427,-658,-1.979,20.897,64,64,614
2017,3371,9270,9517,224008,222709,609,6.343,777,8.093,21429,3745,17684,1.682,9.622,18806,7067,11739,3.173,8.444,2623,1.178,16.888,559,562,4377
2017,3372,3272,3412,115423,115418,171,4.939,272,7.856,11869,1596,10273,1.383,10.283,11857,4713,7144,4.083,10.273,12,0.010,20.546,196,199,2393
2017,3379,603,708,31995,31621,48,6.770,50,7.052,4690,1025,3665,3.242,14.832,3852,1507,2345,4.766,12.182,838,2.650,24.364,35,35,339
2017,3391,8612,9522,278314,276196,530,5.491,790,8.185,28607,4661,23946,1.688,10.357,24350,9418,14932,3.410,8.816,4257,1.541,17.632,600,601,5163
2017,3399,15604,16011,266006,263203,1637,10.332,1302,8.218,32105,9301,22804,3.534,12.198,26464,8390,18074,3.188,10.055,5641,2.143,20.109,940,942,5083
2017,4231,14626,22561,404729,403212,1419,6.252,1693,7.459,47214,12231,34983,3.033,11.709,44100,13092,31008,3.247,10.937,3114,0.772,21.874,1071,1122,6827
2017,4232,10302,12345,170143,166002,882,7.138,904,7.316,26057,5880,20177,3.542,15.697,17890,5597,12293,3.372,10.777,8167,4.920,21.554,626,639,3169
2017,4233,9447,16755,246964,241979,1112,6.655,1020,6.104,34768,8291,26477,3.426,14.368,24427,9078,15349,3.752,10.095,10341,4.274,20.189,510,540,3641
2017,4234,21067,32326,642532,643086,2641,8.147,2823,8.708,84380,25295,59085,3.933,13.121,85796,31228,54568,4.856,13.341,-1416,-0.220,26.242,1468,1511,10632
2017,4235,6730,9218,150301,150213,435,4.666,645,6.918,16567,2681,13886,1.785,11.029,16542,5134,11408,3.418,11.012,25,0.017,22.025,356,376,2618
2017,4236,17782,27843,523938,527784,1718,6.099,2373,8.424,58488,15471,43017,2.931,11.082,65175,26244,38931,4.972,12.349,-6687,-1.267,22.164,1271,1326,8504
2017,4237,9760,19096,246767,242353,1056,5.547,938,4.927,32191,8881,23310,3.664,13.283,23327,6859,16468,2.830,9.625,8864,3.657,19.250,484,524,3462
2017,4238,38327,55800,754910,761035,2942,5.235,3750,6.672,84838,21505,63333,2.826,11.148,96544,32893,63651,4.322,12.686,-11706,-1.538,22.295,1938,2024,12070
2017,4239,26171,29452,322413,321137,2544,8.558,3090,10.395,43983,11995,31988,3.735,13.696,41527,15556,25971,4.844,12.931,2456,0.765,25.862,2243,2288,10371
2017,4241,6877,9322,147295,148101,462,4.893,703,7.445,14546,3824,10722,2.582,9.822,15989,6431,9558,4.342,10.796,-1443,-0.974,19.643,411,414,2177
2017,4242,6246,9567,310388,311693,785,8.180,844,8.795,38518,12820,25698,4.113,12.358,41497,14885,26612,4.776,13.313,-2979,-0.956,24.715,516,541,3510
2017,4243,13002,14081,200817,200909,1445,10.191,1642,11.580,26636,7403,19233,3.685,13.258,26901,9518,17383,4.737,13.390,-265,-0.132,26.515,1271,1290,6375
2017,4244,25064,32903,828579,819834,2780,8.477,2560,7.807,98696,29009,69687,3.538,12.039,81449,30168,51281,3.680,9.935,17247,2.104,19.870,1664,1684,10972
2017,4245,3233,6046,62557,62862,266,4.378,326,5.365,7836,1696,6140,2.698,12.465,8364,2150,6214,3.420,13.305,-528,-0.840,24.931,149,154,955
2017,4246,7766,12218,161988,160120,619,5.011,889,7.197,22553,4818,17735,3.009,14.085,18596,7400,11196,4.622,11.614,3957,2.471,23.228,374,394,2429
2017,4247,3803,6153,98965,99004,272,4.381,384,6.185,13017,3757,9260,3.795,13.148,13253,4274,8979,4.317,13.386,-236,-0.238,26.296,187,195,2286
2017,4248,3222,4222,204103,202351,353,8.350,364,8.610,19236,6415,12821,3.170,9.506,15851,6613,9238,3.268,7.833,3385,1.673,15.667,233,237,3248
2017,4249,19690,26624,340787,342455,2176,8.154,2300,8.619,40727,10444,30283,3.050,11.893,43838,14324,29514,4.183,12.801,-3111,-0.908,23.785,1585,1619,7799
2017,4251,29986,32130,280708,277537,3497,10.762,4222,12.994,51920,11522,40398,4.152,18.707,44983,19207,25776,6.921,16.208,6937,2.499,32.416,3162,3185,10349
2017,4411,37556,43806,1329815,1313339,3669,8.385,3569,8.157,144561,45510,99051,3.465,11.007,111205,38497,72708,2.931,8.467,33356,2.540,16.935,2681,2717,26755
2017,4412,11079,12825,150733,147903,850,6.609,924,7.184,20681,5615,15066,3.796,13.983,15090,5419,9671,3.664,10.203,5591,3.780,20.405,644,663,3635
2017,4413,26100,55884,533009,529660,2843,5.097,2623,4.703,54416,17567,36849,3.317,10.274,47967,14750,33217,2.785,9.056,6449,1.218,18.112,1600,1659,6955
2017,4421,12728,22312,208577,208335,1596,7.149,1622,7.265,28795,7781,21014,3.735,13.821,28524,7697,20827,3.695,13.691,271,0.130,27.383,1053,1124,4880
2017,4422,17266,25358,250639,249327,1575,6.168,1933,7.569,26412,8237,18175,3.304,10.593,23744,8102,15642,3.250,9.523,2668,1.070,19.047,1225,1252,3916
2017,4431,17845,29075,318963,334655,1774,5.510,8014,24.892,32260,7972,24288,2.382,9.640,64593,40072,24521,11.974,19.301,-32333,-9.662,19.280,2481,2827,12777
2017,4441,33727,55328,1146104,1153161,2438,4.391,2828,5.093,74247,17154,57093,1.488,6.439,86870,16285,70585,1.412,7.533,-12623,-1.095,12.877,1735,1829,9471
2017,4442,12353,16264,157226,154867,865,5.295,1009,6.177,23118,4335,18783,2.799,14.928,17964,4445,13519,2.870,11.600,5154,3.328,23.199,664,673,2782
2017,4451,59975,86370,2798203,2809042,7852,9.106,7573,8.782,235323,91365,143958,3.253,8.377,258695,79647,179048,2.835,9.209,-23372,-0.832,16.755,5538,5616,27181
2017,4452,15880,19774,157031,157017,2191,11.110,2086,10.577,28086,11397,16689,7.258,17.887,28063,10153,17910,6.466,17.873,23,0.015,35.745,1496,1522,7424
2017,4453,27996,32054,170257,168024,2546,7.975,2288,7.167,26559,8938,17621,5.319,15.807,22347,7821,14526,4.655,13.300,4212,2.507,26.600,1758,1780,5805
2017,4461,39294,92763,1010929,1019191,5443,5.886,4857,5.253,166306,35689,130617,3.502,16.317,182922,26268,156654,2.577,17.948,-16616,-1.630,32.635,3271,3386,17168
2017,4471,61741,107466,945590,943607,7621,7.104,7237,6.746,135122,48682,86440,5.159,14.320,130686,37924,92762,4.019,13.850,4436,0.470,27.699,4492,4945,22875
2017,4481,32228,91242,1391704,1384929,7092,7.729,8135,8.865,172696,63757,108939,4.604,12.470,161510,49205,112305,3.553,11.662,11186,0.808,23.324,3519,4096,18654
2017,4482,4809,24081,243102,242093,961,3.964,1285,5.300,31861,6971,24890,2.879,13.161,29463,6851,22612,2.830,12.170,2398,0.991,24.340,463,574,2176
2017,4483,14287,21024,121770,123150,1180,5.559,1589,7.485,14823,4648,10175,3.774,12.037,17705,5533,12172,4.493,14.377,-2882,-2.340,24.073,964,973,2611
2017,4511,24169,34800,452655,463951,2997,8.512,3815,10.835,60549,21005,39544,4.527,13.051,80615,37175,43440,8.013,17.376,-20066,-4.325,26.101,2081,2483,13068
2017,4512,3141,7114,84138,85910,612,8.658,522,7.384,9515,4103,5412,4.776,11.076,12825,3084,9741,3.590,14.928,-3310,-3.853,22.151,292,315,1565
2017,4522,16,4321,476710,501605,32,0.698,563,12.275,36634,1752,34882,0.349,7.303,84548,46936,37612,9.357,16.856,-47914,-9.552,14.607,3,3,19
2017,4523,7101,47218,2224424,2219170,2526,5.356,2411,5.112,119424,33224,86200,1.497,5.381,108887,39735,69152,1.791,4.907,10537,0.475,9.813,807,815,2506
2017,4531,11148,11641,56219,56773,895,7.594,1185,10.054,8545,2697,5848,4.751,15.051,9645,3688,5957,6.496,16.989,-1100,-1.938,30.103,899,904,2781
2017,4532,16078,25156,217066,221030,1812,7.041,2972,11.548,29290,9034,20256,4.087,13.252,37266,13679,23587,6.189,16.860,-7976,-3.609,26.503,1655,1725,6302
2017,4533,12666,18928,198787,204068,1472,7.714,1781,9.333,23244,7773,15471,3.809,11.390,33857,7801,26056,3.823,16.591,-10613,-5.201,22.781,1299,1336,4989
2017,4539,32497,44057,283627,282433,5168,11.856,4233,9.711,45902,19924,25978,7.054,16.252,43794,14663,29131,5.192,15.506,2108,0.746,31.012,3094,3192,10674
2017,4541,33241,34720,532920,509802,6094,18.015,4308,12.735,122931,24856,98075,4.876,24.114,73921,38422,35499,7.537,14.500,49010,9.614,29.000,3211,3230,15545
2017,4542,2881,3425,41636,40649,420,12.335,380,11.160,7962,5736,2226,14.111,19.587,6086,1473,4613,3.624,14.972,1876,4.615,29.945,302,303,1088
2017,4543,22243,27616,182416,181068,3066,11.218,2497,9.136,28881,11080,17801,6.119,15.950,25827,8216,17611,4.538,14.264,3054,1.687,28.527,1738,1759,6022
2017,4811,413,2135,429455,428138,162,7.672,115,5.446,32475,3980,28495,0.930,7.585,29915,3402,26513,0.795,6.987,2560,0.598,13.974,25,39,428
2017,4812,1681,1922,40315,39538,221,11.472,230,11.939,5896,1915,3981,4.844,14.912,4362,1473,2889,3.726,11.033,1534,3.880,22.065,167,168,668
2017,4831,587,916,40855,41493,125,13.736,113,12.418,4470,1043,3427,2.514,10.773,5647,1572,4075,3.789,13.610,-1177,-2.837,21.546,56,69,329
2017,4832,416,480,18974,19231,60,12.658,48,10.127,1361,523,838,2.720,7.077,1900,375,1525,1.950,9.880,-539,-2.803,14.154,41,42,162
2017,4841,54207,64903,976043,976429,9831,15.212,9282,14.362,118695,37496,81199,3.840,12.156,120173,49743,70430,5.094,12.307,-1478,-0.151,24.312,6473,6519,24223
2017,4842,39271,42977,489214,487381,5217,12.157,5092,11.865,74542,20595,53947,4.226,15.294,70708,23892,46816,4.902,14.508,3834,0.787,29.016,3497,3557,15009
2017,4851,410,693,53689,53517,68,9.913,54,7.872,2459,558,1901,1.043,4.595,2022,782,1240,1.461,3.778,437,0.817,7.556,34,34,478
2017,4852,311,556,14536,14406,60,11.101,29,5.365,1394,526,868,3.651,9.677,1127,401,726,2.784,7.823,267,1.853,15.646,18,18,233
2017,4853,6720,6888,75317,76232,1050,15.109,1173,16.879,10175,4026,6149,5.281,13.348,12206,4960,7246,6.506,16.012,-2031,-2.664,26.695,965,967,3948
2017,4854,2488,4201,237100,238488,195,4.605,262,6.187,16258,3697,12561,1.550,6.817,19297,9026,10271,3.785,8.091,-3039,-1.274,13.634,161,165,2603
2017,4855,1070,1198,34114,33885,106,8.819,114,9.484,4351,1448,2903,4.273,12.841,3942,1794,2148,5.294,11.634,409,1.207,23.267,78,78,953
2017,4859,4035,4548,97804,95613,786,17.590,627,14.032,16030,5136,10894,5.372,16.766,11640,4819,6821,5.040,12.174,4390,4.591,24.348,468,475,3174
2017,4861,68,783,13274,13718,48,6.004,81,10.131,1164,436,728,3.178,8.486,2011,751,1260,5.475,14.660,-847,-6.175,16.971,13,13,58
2017,4862,113,2133,27945,28392,144,6.831,94,4.459,3165,1179,1986,4.153,11.148,4044,966,3078,3.402,14.243,-879,-3.096,22.295,4,4,41
2017,4869,66,709,8492,8410,50,7.092,42,5.957,1172,560,612,6.659,13.936,1008,330,678,3.924,11.986,164,1.950,23.971,5,5,24
2017,4871,569,613,11055,11381,86,14.180,73,12.036,1557,431,1126,3.787,13.681,2268,1190,1078,10.456,19.929,-711,-6.248,27.363,51,53,294
2017,4872,1274,1324,15025,14860,189,14.499,148,11.354,2281,840,1441,5.653,15.350,2002,541,1461,3.641,13.473,279,1.878,26.946,90,90,353
2017,4879,171,204,3392,3282,21,10.169,26,12.591,443,108,335,3.291,13.498,228,60,168,1.828,6.947,215,6.551,13.894,17,17,43
2017,4881,3878,5683,199207,193959,428,7.507,464,8.139,39100,6492,32608,3.347,20.159,28404,12329,16075,6.357,14.644,10696,5.515,29.289,252,277,2466
2017,4882,520,1474,40617,41583,184,12.773,117,8.122,4717,1952,2765,4.694,11.344,6735,1981,4754,4.764,16.197,-2018,-4.853,22.687,23,23,175
2017,4883,1829,2449,92482,94383,183,7.465,188,7.669,7640,1378,6262,1.460,8.095,11360,1376,9984,1.458,12.036,-3720,-3.941,16.189,115,118,626
2017,4884,9540,11270,103760,102286,1409,12.663,1122,10.084,16983,5916,11067,5.784,16.604,14142,5172,8970,5.056,13.826,2841,2.778,27.652,785,791,3257
2017,4885,13823,19920,265606,261098,1764,8.882,1644,8.278,40422,10709,29713,4.102,15.482,31489,11004,20485,4.215,12.060,8933,3.421,24.120,971,997,4458
2017,4889,1411,1507,16397,16727,212,14.157,193,12.888,2499,1158,1341,6.923,14.940,3110,818,2292,4.890,18.593,-611,-3.653,29.880,137,139,524
2017,4921,3787,9424,590766,581093,526,5.466,923,9.592,46151,7631,38520,1.313,7.942,25956,8470,17486,1.458,4.467,20195,3.475,8.934,484,488,2405
2017,4922,3467,3903,47700,45754,524,13.196,660,16.620,12178,5045,7133,11.026,26.617,8324,4267,4057,9.326,18.193,3854,8.423,36.386,456,457,2589
2017,4931,7488,16075,915167,868641,1532,9.643,1157,7.282,186367,80213,106154,9.234,21.455,88328,24982,63346,2.876,10.169,98039,11.286,20.337,367,376,3536
2017,5111,10739,15288,362802,370822,919,5.867,1672,10.674,37599,9358,28241,2.524,10.139,53621,19428,34193,5.239,14.460,-16022,-4.321,20.279,877,918,5700
2017,5112,8365,11674,610661,597078,1529,13.382,1033,9.041,85881,25748,60133,4.312,14.384,58472,18301,40171,3.065,9.793,27409,4.591,19.586,643,654,8437
2017,5121,14122,17395,307988,347643,2141,12.312,2131,12.254,45458,18717,26741,5.384,13.076,124140,12488,111652,3.592,35.709,-78682,-22.633,26.152,1341,1347,7042
2017,5122,2738,2943,23298,23322,365,12.434,350,11.923,3697,1432,2265,6.140,15.852,3652,2164,1488,9.279,15.659,45,0.193,31.319,244,244,629
2017,5151,3866,7265,207317,210736,345,4.729,406,5.565,15011,4428,10583,2.101,7.123,21740,5765,15975,2.736,10.316,-6729,-3.193,14.246,227,235,2194
2017,5152,356,682,50860,50460,27,3.899,48,6.931,3642,424,3218,0.840,7.218,2746,934,1812,1.851,5.442,896,1.776,10.884,30,30,704
2017,5173,6333,53438,1004882,1016319,5673,10.424,7647,14.051,146875,37241,109634,3.664,14.452,172241,56925,115316,5.601,16.948,-25366,-2.496,28.903,302,360,2992
2017,5174,299,370,8843,8306,54,14.536,57,15.343,2279,1071,1208,12.894,27.438,1184,351,833,4.226,14.255,1095,13.183,28.510,36,36,106
2017,5179,2655,3527,53792,52573,757,21.184,850,23.786,11121,5486,5635,10.435,21.153,8597,4355,4242,8.284,16.353,2524,4.801,32.705,712,727,3527
2017,5182,9648,15837,526286,518400,3214,21.341,1661,11.029,104247,47564,56683,9.175,20.109,88451,33299,55152,6.423,17.062,15796,3.047,34.125,812,860,13409
2017,5191,8395,10642,300553,295280,1358,12.738,1396,13.094,48502,10851,37651,3.675,16.426,38214,12900,25314,4.369,12.942,10288,3.484,25.883,965,987,6352
2017,5211,12,58,19737,19552,0,0.000,D,D,675,0,675,0.000,3.452,309,D,308,D,1.580,366,1.872,3.161,D,D,D
2017,5221,10858,117754,1969446,1966517,4674,3.962,5097,4.321,217015,50738,166277,2.580,11.036,212115,40001,172114,2.034,10.786,4900,0.249,21.573,327,527,5906
2017,5222,12976,43686,616948,619880,3736,8.544,3821,8.738,104769,26993,77776,4.355,16.901,109525,39803,69722,6.421,17.669,-4756,-0.767,33.803,1080,1186,6704
2017,5223,11615,25526,295001,291171,1943,7.457,3006,11.536,50209,15793,34416,5.424,17.244,42958,19708,23250,6.769,14.754,7251,2.490,29.507,895,1006,5513
2017,5231,9417,26768,357361,362650,2361,8.664,3325,12.202,31280,10982,20298,3.028,8.625,41890,12850,29040,3.543,11.551,-10610,-2.926,17.251,825,839,3046
2017,5232,13,36,6028,6164,D,D,D,D,83,D,61,D,1.347,369,D,348,D,5.987,-286,-4.640,2.693,D,D,D
2017,5239,44959,64826,536732,529907,6672,10.404,5282,8.236,78518,28575,49943,5.392,14.817,65307,22621,42686,4.269,12.324,13211,2.493,24.648,3476,3517,12911
2017,5241,4335,31033,1538223,1546881,3770,11.359,8081,24.349,241569,112268,129301,7.258,15.617,261651,122557,139094,7.923,16.915,-20082,-1.298,31.233,306,338,4121
2017,5242,119912,135679,1020777,1004391,11505,8.481,11453,8.443,167395,71478,95917,7.117,16.666,134009,55139,78870,5.490,13.342,33386,3.324,26.685,7563,7664,26321
2017,5259,571,576,3839,3977,164,28.497,163,28.323,1768,1491,277,37.495,44.461,2022,1282,740,32.239,50.849,-254,-6.388,88.922,120,120,428
2017,5311,87045,117832,584114,579283,11484,9.784,10567,9.003,98476,41293,57183,7.128,17.000,87470,37716,49754,6.511,15.100,11006,1.900,30.199,7402,7642,23589
2017,5312,77203,92319,327324,317467,17623,19.967,9510,10.775,69473,38693,30780,12.188,21.884,48838,20118,28720,6.337,15.384,20635,6.500,30.767,5523,5572,11499
2017,5313,67324,84326,695551,681623,10055,12.096,7652,9.205,114180,41898,72282,6.147,16.751,86155,36492,49663,5.354,12.640,28025,4.112,25.279,4765,4836,20777
2017,5321,3411,15423,160205,162220,1089,7.080,1006,6.540,18288,4309,13979,2.656,11.274,21538,4551,16987,2.805,13.277,-3250,-2.003,22.547,349,354,1507
2017,5322,6887,17653,135219,140759,2386,13.452,2554,14.399,22266,7758,14508,5.512,15.819,33097,14199,18898,10.087,23.513,-10831,-7.695,31.637,701,777,5778
2017,5323,2119,2802,19323,18964,256,9.250,187,6.757,3221,896,2325,4.725,16.985,2468,730,1738,3.849,13.014,753,3.971,26.028,124,130,468
2017,5324,7255,14278,185565,183451,1309,9.246,1069,7.551,27139,7633,19506,4.161,14.794,22655,6191,16464,3.375,12.349,4484,2.444,24.699,517,529,2404
2017,5331,2145,2355,38460,37681,292,12.489,258,11.035,6523,1463,5060,3.883,17.311,5052,1903,3149,5.050,13.407,1471,3.904,26.815,163,164,828
2017,5411,156478,168473,1151629,1144035,12695,7.521,13348,7.908,134697,37098,97599,3.243,11.774,119552,38274,81278,3.346,10.450,15145,1.324,20.900,9633,9798,26244
2017,5412,99464,118975,1148758,1152471,9388,7.888,9470,7.957,142669,40522,102147,3.516,12.379,149730,74634,75096,6.476,12.992,-7061,-0.613,24.759,6378,6443,45119
2017,5413,81901,101519,1501440,1477387,8606,8.474,8672,8.539,212117,54678,157439,3.701,14.358,163824,57688,106136,3.905,11.089,48293,3.269,22.178,4950,5030,22842
2017,5414,26464,26844,119112,118453,3691,13.863,3254,12.221,19087,7376,11711,6.227,16.114,17708,8427,9281,7.114,14.949,1379,1.164,29.899,2238,2239,4922
2017,5415,98846,122008,1830889,1800376,17505,14.417,16325,13.445,276407,82646,193761,4.590,15.353,217044,83035,134009,4.612,12.055,59363,3.297,24.111,10917,10996,46200
2017,5416,124824,134966,1272710,1250065,23360,17.453,21116,15.777,248744,90294,158450,7.223,19.898,201964,94699,107265,7.576,16.156,46780,3.742,32.313,14391,14473,51240
2017,5417,13313,16672,711751,702785,2090,12.611,1892,11.416,87593,17444,70149,2.482,12.464,70064,23957,46107,3.409,9.969,17529,2.494,19.939,1117,1140,7045
2017,5418,28787,32963,483940,479322,3467,10.480,3703,11.194,73937,20692,53245,4.317,15.425,64308,27365,36943,5.709,13.416,9629,2.009,26.833,2651,2677,17228
2017,5419,54672,62155,644745,637144,7138,11.595,5950,9.665,101903,36605,65298,5.745,15.994,86767,37706,49061,5.918,13.618,15136,2.376,27.236,4014,4092,23386
2017,5511,26485,55298,3493863,3422211,5516,10.066,4512,8.234,569992,166512,403480,4.866,16.656,428506,137154,291352,4.008,12.521,141486,4.134,25.043,780,811,15889
2017,5611,26620,29317,481007,464779,3604,12.413,3038,10.464,97740,35021,62719,7.535,21.029,64934,26902,38032,5.788,13.971,32806,7.058,27.942,2154,2173,16369
2017,5612,1985,6490,277924,255472,508,7.779,588,9.005,86771,67404,19367,26.384,33.965,44000,26588,17412,10.407,17.223,42771,16.742,34.446,101,110,2286
2017,5613,24441,48949,5820578,5779733,4672,9.573,4382,8.979,1009488,178536,830952,3.089,17.466,923893,256351,667542,4.435,15.985,85595,1.481,31.970,2281,2346,103964
2017,5614,21720,28615,796538,796828,2412,8.310,3230,11.129,128957,44811,84146,5.624,16.184,130366,46571,83795,5.845,16.361,-1409,-0.177,32.368,2130,2160,24588
2017,5615,12664,21974,232597,230735,1295,5.858,1563,7.070,32446,6720,25726,2.912,14.062,28448,10980,17468,4.759,12.329,3998,1.733,24.659,970,989,4745
2017,5616,17998,23078,954925,945923,2311,9.862,3024,12.904,236024,120966,115058,12.788,24.952,219167,82741,136426,8.747,23.170,16857,1.782,46.339,1353,1371,16873
2017,5617,153227,162122,1948062,1917583,22562,14.069,19057,11.883,334908,115283,219625,6.012,17.465,275194,94456,180738,4.926,14.351,59714,3.114,28.702,12760,12799,60958
2017,5619,15637,17729,287540,289037,1683,9.478,1737,9.783,43221,9026,34195,3.123,14.953,46309,16122,30187,5.578,16.022,-3088,-1.068,29.907,1143,1267,10767
2017,5621,7214,11126,215424,211154,690,6.215,643,5.791,23146,5541,17605,2.624,10.962,14331,5606,8725,2.655,6.787,8815,4.175,13.574,471,483,3690
2017,5622,1208,2531,57962,55071,139,5.496,135,5.338,9764,3211,6553,5.831,17.730,3971,1890,2081,3.432,7.211,5793,10.519,14.422,81,85,466
2017,5629,8507,10005,133375,132647,852,8.547,778,7.805,21824,4824,17000,3.637,16.453,20311,7243,13068,5.460,15.312,1513,1.141,30.624,525,533,3681
2017,6111,18736,21450,1049755,1036417,904,4.209,958,4.461,88767,16605,72162,1.602,8.565,62232,20959,41273,2.022,6.005,26535,2.560,12.009,612,637,13703
2017,6112,425,786,61560,67583,17,1.915,220,24.789,3573,210,3363,0.311,5.287,16285,11100,5185,16.424,24.096,-12712,-18.810,10.574,29,182,9853
2017,6113,2352,4337,1866989,1876394,218,5.007,251,5.765,76346,2774,73572,0.148,4.069,94046,14719,79327,0.784,5.012,-17700,-0.943,8.138,80,99,2237
2017,6114,6658,7159,64168,63587,839,11.752,800,11.205,10567,3011,7556,4.735,16.618,9449,3730,5719,5.866,14.860,1118,1.758,29.720,532,541,2595
2017,6115,6140,7644,109278,109597,731,9.505,825,10.727,18563,5699,12864,5.200,16.938,19385,6988,12397,6.376,17.688,-822,-0.750,33.875,417,598,5072
2017,6116,42207,45572,439245,426887,5715,12.719,4435,9.870,86017,29636,56381,6.942,20.150,61107,21957,39150,5.144,14.315,24910,5.835,28.629,3278,3325,16073
2017,6117,6548,7265,98325,98162,1241,17.363,1006,14.075,17779,6053,11726,6.166,18.112,18039,5607,12432,5.712,18.377,-260,-0.265,36.224,634,641,2603
2017,6211,154662,204889,2443080,2410799,16413,7.998,17072,8.319,369620,111552,258068,4.627,15.332,305749,122603,183146,5.086,12.682,63871,2.649,25.365,11129,11397,60531
2017,6212,118631,129488,944953,933641,7426,5.745,6989,5.407,126036,40962,85074,4.387,13.499,103555,35059,68496,3.755,11.092,22481,2.408,22.183,5695,5765,28526
2017,6213,121328,142314,870374,856219,14446,10.270,11153,7.929,149226,50121,99105,5.854,17.428,120348,47116,73232,5.503,14.056,28878,3.373,28.112,6955,7103,27071
2017,6214,17144,43463,1109702,1085582,3945,9.137,3375,7.816,167804,50762,117042,4.676,15.458,120553,45293,75260,4.172,11.105,47251,4.353,22.210,954,1249,13445
2017,6215,6788,16029,287870,287095,1307,8.050,1722,10.606,40445,9415,31030,3.279,14.088,38839,17381,21458,6.054,13.528,1606,0.559,27.057,666,739,6785
2017,6216,21364,30894,1401776,1377622,3595,11.763,2930,9.587,212512,48045,164467,3.488,15.426,165582,57412,108170,4.167,12.019,46930,3.407,24.039,1755,1801,29428
2017,6219,6389,10790,334125,320567,1113,10.496,741,6.988,58315,17270,41045,5.387,18.191,31040,9283,21757,2.896,9.683,27275,8.508,19.366,390,404,5323
2017,6221,2405,5061,5442930,5353266,80,1.576,109,2.148,338133,28941,309192,0.541,6.316,158831,25697,133134,0.480,2.967,179302,3.349,5.934,42,42,12078
2017,6222,393,627,232115,230777,12,1.899,22,3.481,17889,2176,15713,0.943,7.752,15131,4344,10787,1.882,6.557,2758,1.195,13.113,9,9,1727
2017,6223,289,860,255867,257284,27,3.075,63,7.175,15999,1731,14268,0.673,6.218,18731,6944,11787,2.699,7.280,-2732,-1.062,12.437,18,18,1106
2017,6231,8364,15976,1618281,1643900,1000,6.194,1339,8.293,145458,63620,81838,3.870,8.848,198425,98948,99477,6.019,12.070,-52967,-3.222,17.697,596,641,46382
2017,6232,10272,41619,796556,788416,2495,5.990,2560,6.146,115095,26257,88838,3.330,14.598,98724,25530,73194,3.238,12.522,16371,2.076,25.044,446,552,5547
2017,6233,16583,23866,947379,939849,2051,8.655,1711,7.221,102019,37030,64989,3.940,10.855,87557,33144,54413,3.527,9.316,14462,1.539,18.632,1205,1252,21112
2017,6239,2952,4896,121322,123446,444,9.137,371,7.635,16571,4234,12337,3.430,13.424,20499,5014,15485,4.062,16.606,-3928,-3.182,26.847,177,195,2221
2017,6241,60643,79093,1843850,1804379,9803,12.547,7882,10.088,298354,67061,231293,3.717,16.535,218401,55111,163290,3.054,12.104,79953,4.431,24.208,5028,5151,31688
2017,6242,10088,14137,198985,195755,657,4.644,680,4.806,32138,6482,25656,3.311,16.418,25291,5013,20278,2.561,12.920,6847,3.498,25.840,313,333,2001
2017,6243,3834,7186,291048,295297,359,4.963,455,6.290,35465,6904,28561,2.338,12.010,44402,7531,36871,2.550,15.036,-8937,-3.026,24.020,149,153,1494
2017,6244,56547,72365,969134,956176,6480,8.993,5863,8.137,138446,45425,93021,4.751,14.479,112856,41047,71809,4.293,11.803,25590,2.676,23.606,4098,4167,26802
2017,7111,7165,7295,121166,120961,817,11.233,774,10.641,18740,4608,14132,3.809,15.493,18307,4898,13409,4.049,15.135,433,0.358,30.269,506,506,3322
2017,7112,2990,3172,128162,128814,344,10.722,417,12.997,15825,2906,12919,2.256,12.285,16930,3465,13465,2.690,13.143,-1105,-0.858,24.570,300,300,1676
2017,7113,6385,6832,184004,182182,771,11.358,683,10.062,30528,5465,25063,3.000,16.757,26594,11009,15585,6.043,14.597,3934,2.159,29.195,428,429,3209
2017,7114,3098,3238,21209,20647,437,13.511,430,13.294,3835,1543,2292,7.473,18.574,2711,1106,1605,5.357,13.130,1124,5.444,26.260,280,281,747
2017,7115,17006,17050,49891,48151,3510,21.232,2473,14.959,13870,8287,5583,17.210,28.805,10370,5240,5130,10.882,21.536,3500,7.269,43.073,1517,1517,3476
2017,7121,6635,7122,155074,153217,326,4.590,287,4.041,13136,1779,11357,1.161,8.573,9454,1765,7689,1.152,6.170,3682,2.403,12.341,173,173,1155
2017,7131,2479,3161,225453,219470,685,22.875,352,11.755,29847,7735,22112,3.524,13.600,18453,4200,14253,1.914,8.408,11394,5.192,16.816,267,267,2937
2017,7132,1749,2894,134545,134068,234,8.068,247,8.516,12645,5625,7020,4.196,9.432,11736,4704,7032,3.509,8.754,909,0.678,17.508,113,133,2227
2017,7139,53907,62952,1356891,1340037,7849,12.662,5921,9.552,189117,73857,115260,5.512,14.113,154946,52770,102176,3.938,11.563,34171,2.550,23.126,4370,4390,37345
2017,7211,42024,53269,2046611,2036960,5083,9.609,4337,8.199,228444,96236,132208,4.724,11.215,209900,86901,122999,4.266,10.305,18544,0.910,20.609,2935,3001,45074
2017,7212,5463,6066,46765,45674,520,8.633,435,7.222,8363,1746,6617,3.823,18.310,6204,1810,4394,3.963,13.583,2159,4.727,27.166,266,267,872
2017,7213,1611,1786,9398,9772,114,6.300,161,8.897,1296,348,948,3.561,13.263,2034,1047,987,10.715,20.816,-738,-7.553,26.526,111,123,898
2017,7223,15371,39301,824664,794859,8277,21.466,6794,17.620,229804,113049,116755,14.223,28.911,178115,107563,70552,13.532,22.408,51689,6.503,44.817,1836,1889,10493
2017,7224,35711,36479,363524,360280,3631,9.906,3982,10.864,66917,30808,36109,8.551,18.574,60646,26667,33979,7.402,16.833,6271,1.741,33.666,3193,3208,21111
2017,7225,376558,521164,10729868,10619037,53686,10.401,43705,8.467,1687416,779891,907525,7.344,15.890,1467610,513715,953895,4.838,13.821,219806,2.070,27.641,33030,34404,368592
2017,8111,135007,150030,903697,894584,12971,8.670,12131,8.108,142189,58643,83546,6.555,15.894,123242,45166,78076,5.049,13.776,18947,2.118,27.553,9000,9179,33636
2017,8112,9986,11315,96175,96132,1247,11.017,1255,11.088,15979,6521,9458,6.783,16.622,15878,6253,9625,6.505,16.517,101,0.105,33.034,859,881,3611
2017,8113,18181,19989,199688,198436,1546,7.701,1718,8.558,29304,7174,22130,3.615,14.767,26911,9134,17777,4.603,13.562,2393,1.206,27.123,1144,1161,5069
2017,8114,17688,18569,72384,71422,2272,12.329,1990,10.799,12665,5443,7222,7.621,17.733,10496,4653,5843,6.515,14.696,2169,3.037,29.392,1461,1467,3344
2017,8121,101833,118787,714194,707373,15467,13.190,12418,10.590,129975,62376,67599,8.818,18.374,115902,47168,68734,6.668,16.385,14073,1.989,32.770,9515,9677,35786
2017,8122,14121,20006,142478,141120,920,4.576,1122,5.580,21975,4369,17606,3.096,15.572,18967,6280,12687,4.450,13.440,3008,2.132,26.881,461,488,1761
2017,8123,26679,31849,287616,289761,2363,7.363,2851,8.884,35701,11387,24314,3.930,12.321,40173,14107,26066,4.868,13.864,-4472,-1.543,24.642,2131,2235,9387
2017,8129,30866,40864,320741,315044,6006,15.026,4221,10.560,57538,22983,34555,7.295,18.264,45672,19734,25938,6.264,14.497,11866,3.766,28.994,2941,2981,13261
2017,8131,179407,180082,1691132,1689471,8340,4.644,7337,4.086,133163,23197,109966,1.373,7.882,129997,21784,108213,1.289,7.695,3166,0.187,15.389,4833,4833,14473
2017,8132,16995,18772,191056,189560,1400,7.478,1301,6.949,22435,4586,17849,2.419,11.835,19526,6382,13144,3.367,10.301,2909,1.535,20.601,878,909,3688
2017,8133,14329,16980,181012,177688,1280,7.578,1101,6.518,23443,3808,19635,2.143,13.193,16802,4394,12408,2.473,9.456,6641,3.737,18.912,675,676,2744
2017,8134,22450,24021,218370,217183,1392,5.788,1448,6.021,26755,4770,21985,2.196,12.319,24133,5550,18583,2.555,11.112,2622,1.207,22.224,947,953,3392
2017,8139,52970,55110,487945,490635,2281,4.112,2994,5.398,45640,9097,36543,1.854,9.302,51131,12193,38938,2.485,10.421,-5491,-1.119,18.604,2049,2061,8646
2018,1131,390,415,3599,3710,29,6.744,59,13.721,428,49,379,1.321,11.538,646,271,375,7.306,17.415,-218,-5.877,23.076,38,38,128
2018,1132,131,146,1117,1107,24,17.143,12,8.571,163,43,120,3.886,14.731,152,32,120,2.892,13.737,11,0.994,27.474,10,10,23
2018,1133,7067,7136,48852,48786,645,8.985,730,10.169,6879,1732,5147,3.550,14.101,6742,2400,4342,4.919,13.820,137,0.281,27.639,518,518,1610
2018,1141,1306,1320,5434,5475,212,15.970,227,17.100,1085,426,659,7.781,19.817,1159,745,414,13.607,21.169,-74,-1.352,39.635,134,134,484
2018,1142,303,305,1661,1660,29,9.493,30,9.820,220,64,156,3.855,13.253,204,48,156,2.892,12.289,16,0.964,24.578,20,20,32
2018,1151,3789,4132,67865,68039,442,10.759,394,9.591,9317,4160,5157,6.114,13.694,9620,2810,6810,4.130,14.139,-303,-0.445,27.387,287,287,2034
2018,1152,4035,4117,20593,20362,556,13.711,432,10.654,3277,1352,1925,6.640,16.094,2815,1128,1687,5.540,13.825,462,2.269,27.650,328,328,725
2018,1153,1344,1445,13189,12664,151,10.468,146,10.121,2837,847,1990,6.689,22.403,1770,567,1203,4.477,13.977,1067,8.426,27.954,96,96,333
2018,2111,4448,5732,109365,110741,373,6.407,552,9.482,10748,3290,7458,2.971,9.706,13594,3928,9666,3.547,12.276,-2846,-2.570,19.411,378,391,1585
2018,2121,334,629,49593,49742,39,6.037,73,11.300,6355,780,5575,1.568,12.776,6533,2069,4464,4.159,13.134,-178,-0.358,25.552,31,32,700
2018,2122,189,250,35176,35916,34,13.793,27,10.953,1961,409,1552,1.139,5.460,3491,681,2810,1.896,9.720,-1530,-4.260,10.920,21,22,195
2018,2123,2488,4624,86270,86140,217,4.682,238,5.135,10493,2031,8462,2.358,12.181,9959,1987,7972,2.307,11.561,534,0.620,23.123,123,126,821
2018,2131,9428,12013,325463,309820,1524,12.648,1597,13.254,78336,15456,62880,4.989,25.284,46160,22957,23203,7.410,14.899,32176,10.385,29.798,883,917,7762
2018,2211,1782,11303,510279,510831,1628,14.681,1200,10.822,66720,37392,29328,7.320,13.061,67460,34704,32756,6.794,13.206,-740,-0.145,26.122,81,89,469
2018,2212,393,2445,91013,90375,96,3.889,143,5.793,6228,1767,4461,1.955,6.891,5036,1840,3196,2.036,5.572,1192,1.319,11.145,19,20,255
2018,2213,3445,4631,45875,45109,232,5.008,236,5.094,5492,1761,3731,3.904,12.175,3886,1435,2451,3.181,8.615,1606,3.560,17.230,118,119,361
2018,2361,143525,144926,725843,703022,26056,18.395,19500,13.767,167542,72793,94749,10.354,23.832,122054,53556,68498,7.618,17.361,45488,6.470,34.723,13277,13291,37371
2018,2362,36725,38249,670500,656029,3616,9.474,3453,9.047,110687,21537,89150,3.283,16.872,81408,17296,64112,2.636,12.409,29279,4.463,24.818,2405,2408,11532
2018,2371,16005,17645,614709,600393,1330,7.546,1291,7.325,108209,23277,84932,3.877,18.023,79457,14675,64782,2.444,13.234,28752,4.789,26.468,854,871,8183
2018,2372,3963,4068,21953,21755,413,10.119,440,10.780,3726,1185,2541,5.447,17.127,3290,1300,1990,5.976,15.123,436,2.004,30.246,338,340,937
2018,2373,7818,8682,300813,297203,505,5.802,550,6.319,39529,4932,34597,1.659,13.300,32621,3952,28669,1.330,10.976,6908,2.324,21.952,349,349,2159
2018,2379,3614,3745,69001,67835,389,10.442,350,9.395,12635,3761,8874,5.544,18.626,10148,2173,7975,3.203,14.960,2487,3.666,29.920,227,227,1220
2018,2381,78570,79553,887121,869002,10103,12.834,8438,10.719,170603,45283,125320,5.211,19.632,134392,36104,98288,4.155,15.465,36211,4.167,30.930,5420,5424,24651
2018,2382,163682,168494,2061288,2020214,15966,9.550,13329,7.973,312973,71922,241051,3.560,15.492,230919,61821,169098,3.060,11.430,82054,4.062,22.861,9417,9431,41297
2018,2383,100476,101740,818514,803078,13527,13.443,11294,11.224,155128,50217,104911,6.253,19.317,124665,36963,87702,4.603,15.523,30463,3.793,31.047,7692,7693,26122
2018,2389,58247,59063,636145,625753,7140,12.242,5659,9.703,106975,26822,80153,4.286,17.095,85656,22655,63001,3.620,13.688,21319,3.407,27.377,3647,3647,14795
2018,3111,1130,1755,52664,51444,108,6.223,69,3.976,5897,1003,4894,1.950,11.463,3443,1074,2369,2.088,6.693,2454,4.770,13.386,39,39,655
2018,3112,531,881,59308,58171,46,5.245,38,4.333,7290,324,6966,0.557,12.532,4701,822,3879,1.413,8.081,2589,4.451,16.163,27,28,577
2018,3113,1651,1818,80244,80155,128,7.027,135,7.411,6825,1146,5679,1.430,8.515,6742,1581,5161,1.972,8.411,83,0.104,16.822,94,94,706
2018,3114,1435,1797,160358,159806,134,7.469,128,7.135,14903,3624,11279,2.268,9.326,13891,3616,10275,2.263,8.692,1012,0.633,17.385,86,86,1189
2018,3115,1077,1583,148608,147244,93,5.907,76,4.827,10783,1886,8897,1.281,7.323,8010,1610,6400,1.093,5.440,2773,1.883,10.880,51,51,824
2018,3116,2676,3316,522695,515853,152,4.569,174,5.230,34349,3606,30743,0.699,6.659,20513,3140,17373,0.609,3.977,13836,2.682,7.953,132,132,1671
2018,3117,411,507,31333,31555,38,7.577,27,5.384,2897,673,2224,2.133,9.181,3332,613,2719,1.943,10.559,-435,-1.379,18.362,22,22,186
2018,3118,9890,10730,295343,294879,991,9.265,924,8.638,32278,9043,23235,3.067,10.946,31475,9716,21759,3.295,10.674,803,0.272,21.348,719,722,5216
2018,3119,3149,3653,217572,213545,426,11.909,274,7.660,25091,5692,19399,2.665,11.750,16948,4091,12857,1.916,7.937,8143,3.813,15.873,213,213,1909
2018,3121,8155,8901,224858,215283,1330,15.713,457,5.399,36505,11898,24607,5.527,16.957,17293,5264,12029,2.445,8.033,19212,8.924,16.065,337,339,2576
2018,3122,115,139,13273,13485,10,7.042,16,11.268,1010,49,961,0.363,7.490,1397,177,1220,1.313,10.360,-387,-2.870,14.980,13,13,131
2018,3131,205,260,22732,23128,18,6.704,35,13.035,1783,201,1582,0.869,7.709,2633,711,1922,3.074,11.385,-850,-3.675,15.419,23,23,355
2018,3132,705,790,46023,45736,38,4.774,50,6.281,3851,631,3220,1.380,8.420,3320,708,2612,1.548,7.259,531,1.161,14.518,42,42,565
2018,3133,748,786,26588,26852,69,8.835,59,7.554,2181,380,1801,1.415,8.122,2739,585,2154,2.179,10.201,-558,-2.078,16.245,43,43,449
2018,3141,1461,1559,48999,49957,88,5.587,120,7.619,3944,885,3059,1.772,7.895,6019,1173,4846,2.348,12.048,-2075,-4.154,15.790,91,91,645
2018,3149,3667,3765,56777,56726,306,8.134,300,7.974,6111,1836,4275,3.237,10.773,6099,1516,4583,2.673,10.752,12,0.021,21.504,225,225,947
2018,3151,194,202,10584,10832,11,5.379,16,7.824,603,56,547,0.517,5.567,1127,258,869,2.382,10.404,-524,-4.838,11.134,12,12,109
2018,3152,4052,4102,65471,68876,604,14.453,758,18.138,10075,4742,5333,6.885,14.628,17079,7882,9197,11.444,24.797,-7004,-10.169,29.256,671,671,7088
2018,3159,504,510,8098,8205,64,12.598,60,11.811,858,260,598,3.169,10.458,1076,379,697,4.619,13.115,-218,-2.657,20.915,43,43,155
2018,3161,154,162,3338,3479,12,7.362,14,8.589,192,32,160,0.920,5.520,483,60,423,1.725,13.885,-291,-8.366,11.039,10,10,23
2018,3162,192,208,11361,11789,13,6.235,14,6.715,804,381,423,3.232,6.820,1658,113,1545,0.959,14.064,-854,-7.244,13.640,11,11,22
2018,3169,690,696,11271,11386,63,8.936,81,11.489,1128,313,815,2.749,9.907,1366,441,925,3.873,11.998,-238,-2.090,19.815,68,68,378
2018,3211,2566,3023,92229,91063,191,6.287,221,7.275,9540,2736,6804,3.005,10.476,7116,2497,4619,2.742,7.814,2424,2.662,15.629,148,148,1151
2018,3212,1044,1415,79283,78897,60,4.248,55,3.894,7851,1094,6757,1.387,9.951,7155,1408,5747,1.785,9.069,696,0.882,18.138,39,39,726
2018,3219,8046,9156,243547,240948,703,7.697,657,7.194,27107,7413,19694,3.077,11.250,22246,6967,15279,2.891,9.233,4861,2.017,18.465,469,471,4014
2018,3221,223,432,95814,96643,16,3.712,14,3.248,3937,402,3535,0.416,4.074,5471,918,4553,0.950,5.661,-1534,-1.587,8.148,4,4,360
2018,3222,2178,3464,245811,245025,104,2.972,175,5.001,18424,3222,15202,1.315,7.519,16788,4720,12068,1.926,6.852,1636,0.668,13.703,126,126,2714
2018,3231,21966,23382,433571,443140,1320,5.576,1898,8.018,36984,8594,28390,1.939,8.346,55534,18578,36956,4.192,12.532,-18550,-4.186,16.692,1456,1463,10152
2018,3241,889,2056,106736,105966,61,2.945,92,4.441,6888,978,5910,0.923,6.500,5291,972,4319,0.917,4.993,1597,1.507,9.986,45,45,303
2018,3251,1189,2366,154249,155187,89,3.748,106,4.464,10887,2387,8500,1.538,7.015,12726,5398,7328,3.478,8.200,-1839,-1.185,14.031,51,54,918
2018,3252,1048,1400,105612,103188,67,4.791,64,4.576,12905,2211,10694,2.143,12.506,8384,3360,5024,3.256,8.125,4521,4.381,16.250,37,40,1390
2018,3253,684,936,32392,31623,59,6.327,52,5.576,3678,914,2764,2.890,11.631,2148,315,1833,0.996,6.793,1530,4.838,13.585,37,37,192
2018,3254,1772,2293,256195,254399,216,9.520,168,7.404,25181,3284,21897,1.291,9.898,21258,5032,16226,1.978,8.356,3923,1.542,16.712,110,110,1954
2018,3255,1303,1658,64351,64077,80,4.780,111,6.633,7485,1264,6221,1.973,11.681,6991,3983,3008,6.216,10.910,494,0.771,21.821,63,63,871
2018,3256,1959,2167,101589,101911,152,7.029,143,6.613,10507,2227,8280,2.185,10.310,11118,4115,7003,4.038,10.910,-611,-0.600,20.620,90,94,2255
2018,3259,1655,2138,84574,84086,124,5.769,147,6.839,7657,1410,6247,1.677,9.106,6689,1354,5335,1.610,7.955,968,1.151,15.910,101,102,586
2018,3261,7481,9905,648105,642255,351,3.522,473,4.746,57411,8561,48850,1.333,8.939,45985,9722,36263,1.514,7.160,11426,1.779,14.320,336,337,5415
2018,3262,1360,1805,136612,135460,100,5.571,80,4.457,11231,2125,9106,1.569,8.291,8973,1416,7557,1.045,6.624,2258,1.667,13.248,51,51,663
2018,3271,828,1001,35402,34623,70,6.876,104,10.216,3903,738,3165,2.132,11.273,2378,932,1446,2.692,6.868,1525,4.405,13.737,66,67,585
2018,3272,1323,1585,94739,94134,117,7.382,117,7.382,7003,1670,5333,1.774,7.439,5725,1102,4623,1.171,6.082,1278,1.358,12.164,84,84,590
2018,3273,3839,8468,175127,173940,395,4.658,419,4.941,22936,6140,16796,3.530,13.186,20374,4479,15895,2.575,11.713,2562,1.473,23.426,178,185,1882
2018,3274,147,295,14385,14080,27,9.375,13,4.514,1103,301,802,2.138,7.834,523,114,409,0.810,3.715,580,4.119,7.429,5,5,25
2018,3279,2629,3101,80658,79951,178,5.746,172,5.552,8677,2950,5727,3.690,10.853,7295,1594,5701,1.994,9.124,1382,1.729,18.249,121,124,916
2018,3311,253,389,87048,87935,32,8.377,18,4.712,3758,925,2833,1.052,4.274,5612,109,5503,0.124,6.382,-1854,-2.108,8.547,14,14,77
2018,3312,526,697,50733,49579,45,6.526,30,4.351,6009,1045,4964,2.108,12.120,3688,412,3276,0.831,7.439,2321,4.681,14.877,15,15,138
2018,3313,345,478,59906,58956,21,4.403,19,3.983,4589,521,4068,0.884,7.784,2602,505,2097,0.857,4.413,1987,3.370,8.827,12,13,326
2018,3314,631,815,57839,57297,26,3.161,41,4.985,4351,554,3797,0.967,7.594,3191,531,2660,0.927,5.569,1160,2.025,11.138,26,26,220
2018,3315,1343,1533,118190,116651,49,3.158,86,5.543,11702,1223,10479,1.048,10.032,8470,2311,6159,1.981,7.261,3232,2.771,14.522,68,69,1065
2018,3321,1989,2248,106199,105204,65,2.867,104,4.587,8726,850,7876,0.808,8.294,6677,1898,4779,1.804,6.347,2049,1.948,12.693,72,72,815
2018,3322,949,1024,34114,34084,37,3.561,67,6.449,2571,382,2189,1.121,7.543,2563,653,1910,1.916,7.520,8,0.023,15.039,56,56,577
2018,3323,11859,12916,377104,369776,784,6.083,728,5.649,46573,11700,34873,3.164,12.595,32146,9440,22706,2.553,8.693,14427,3.902,17.387,533,539,6156
2018,3324,1143,1460,86398,85609,57,3.864,87,5.898,8526,801,7725,0.936,9.959,6964,1941,5023,2.267,8.135,1562,1.825,16.269,56,56,812
2018,3325,519,564,28426,28587,22,3.853,36,6.305,2374,145,2229,0.507,8.305,2793,512,2281,1.791,9.770,-419,-1.466,16.609,27,27,125
2018,3326,922,1076,38465,38366,45,4.157,58,5.358,3357,834,2523,2.174,8.750,3201,1167,2034,3.042,8.343,156,0.407,16.687,43,44,544
2018,3327,21465,22050,381763,376850,1075,4.851,1300,5.866,42040,9399,32641,2.494,11.156,32056,10221,21835,2.712,8.506,9984,2.649,17.013,986,994,6793
2018,3328,4850,5415,129575,128690,257,4.743,265,4.890,14587,3905,10682,3.034,11.335,12975,3215,9760,2.498,10.082,1612,1.253,20.165,209,214,1417
2018,3329,5238,5796,255260,253056,427,7.390,391,6.767,25319,7021,18298,2.774,10.005,20915,4288,16627,1.694,8.265,4404,1.740,16.530,284,284,2254
2018,3331,2392,2784,189222,186257,153,5.505,144,5.181,17899,2061,15838,1.107,9.610,11833,2404,9429,1.291,6.353,6066,3.257,12.706,94,94,876
2018,3332,2765,2941,109967,108882,147,4.998,147,4.998,10277,1569,8708,1.441,9.439,8187,1752,6435,1.609,7.519,2090,1.920,15.038,120,120,1050
2018,3333,1666,1796,70748,70461,105,5.820,121,6.707,6009,1673,4336,2.374,8.528,5496,1251,4245,1.775,7.800,513,0.728,15.600,92,92,893
2018,3334,1371,1631,129032,128517,63,3.840,82,4.998,8915,1100,7815,0.856,6.937,7995,2023,5972,1.574,6.221,920,0.716,12.442,59,59,1082
2018,3335,5953,6208,149823,149596,252,4.036,325,5.205,12736,3205,9531,2.142,8.514,12245,3313,8932,2.215,8.185,491,0.328,16.371,241,242,2242
2018,3336,761,968,103538,102850,37,3.793,52,5.331,12919,4034,8885,3.922,12.561,11423,1721,9702,1.673,11.106,1496,1.455,22.213,24,24,243
2018,3339,4980,5830,307606,301516,411,7.137,268,4.654,30019,5451,24568,1.808,9.956,17855,3805,14050,1.262,5.922,12164,4.034,11.844,183,184,1797
2018,3341,800,828,40218,39670,60,7.109,92,10.900,5238,314,4924,0.792,13.204,3981,586,3395,1.477,10.035,1257,3.169,20.071,64,64,429
2018,3342,1066,1173,79569,80728,66,5.563,93,7.838,4600,1095,3505,1.356,5.698,6868,797,6071,0.987,8.508,-2268,-2.809,11.396,69,69,414
2018,3343,402,418,8975,8842,33,7.857,37,8.810,942,198,744,2.239,10.654,652,222,430,2.511,7.374,290,3.280,14.748,30,30,152
2018,3344,3193,3636,257060,256967,170,4.640,225,6.142,19130,3262,15868,1.269,7.445,18872,6356,12516,2.473,7.344,258,0.100,14.688,170,173,2328
2018,3345,4128,4954,381886,385383,396,8.024,358,7.254,29561,7251,22310,1.882,7.671,36325,6489,29836,1.684,9.426,-6764,-1.755,15.341,244,245,2476
2018,3346,367,374,7227,7607,24,6.154,56,14.359,1114,396,718,5.206,14.644,1892,1315,577,17.287,24.872,-778,-10.227,29.289,43,43,295
2018,3351,961,1027,42371,42900,69,6.712,71,6.907,4089,1061,3028,2.473,9.531,5124,1842,3282,4.294,11.944,-1035,-2.413,19.063,50,50,453
2018,3352,240,290,52085,51916,26,9.171,13,4.586,2812,833,1979,1.605,5.416,2363,370,1993,0.713,4.552,449,0.865,9.103,9,9,32
2018,3353,1654,1987,116688,114821,155,7.892,109,5.550,11660,3048,8612,2.655,10.155,7807,2082,5725,1.813,6.799,3853,3.356,13.599,74,74,555
2018,3359,1692,1970,133875,133240,97,4.903,114,5.762,10542,1693,8849,1.271,7.912,9445,2346,7099,1.761,7.089,1097,0.823,14.177,86,87,866
2018,3361,244,296,210708,208169,26,8.874,20,6.826,12857,559,12298,0.269,6.176,8327,232,8095,0.111,4.000,4530,2.176,8.000,18,18,132
2018,3362,1511,1846,167546,160276,137,7.448,124,6.741,22728,4035,18693,2.518,14.181,8536,2777,5759,1.733,5.326,14192,8.855,10.652,88,90,1330
2018,3363,3653,4659,598589,593510,238,5.105,245,5.255,48146,5292,42854,0.892,8.112,37924,6045,31879,1.019,6.390,10222,1.722,12.780,170,170,3103
2018,3364,1229,1833,374470,370497,264,15.021,113,6.430,29378,9179,20199,2.477,7.929,22832,2482,20350,0.670,6.163,6546,1.767,12.325,75,75,1173
2018,3365,147,229,26934,27901,14,6.195,8,3.540,1252,89,1163,0.319,4.487,3130,497,2633,1.781,11.218,-1878,-6.731,8.975,3,3,122
2018,3366,1249,1379,137961,137662,120,8.750,105,7.656,11923,2549,9374,1.852,8.661,11547,1822,9725,1.324,8.388,376,0.273,16.776,81,81,1302
2018,3369,753,781,33586,33082,79,10.089,83,10.600,3509,448,3061,1.354,10.607,2482,916,1566,2.769,7.503,1027,3.104,15.005,66,66,366
2018,3371,9210,9472,226703,225191,592,6.201,741,7.762,20148,5045,15103,2.240,8.947,16976,4133,12843,1.835,7.538,3172,1.409,15.077,574,575,3305
2018,3372,3415,3554,116608,116473,214,6.032,201,5.666,10866,2065,8801,1.773,9.329,10699,2359,8340,2.025,9.186,167,0.143,18.372,153,153,1570
2018,3379,582,681,33176,32882,34,4.892,62,8.921,4266,346,3920,1.052,12.974,3681,1363,2318,4.145,11.195,585,1.779,22.389,43,43,348
2018,3391,8371,9298,284786,281765,563,5.985,780,8.292,27413,6766,20647,2.401,9.729,21669,7226,14443,2.565,7.690,5744,2.039,15.381,628,629,4093
2018,3399,13475,14315,266663,261345,1590,11.158,1459,10.239,37634,17776,19858,6.802,14.400,27666,8370,19296,3.203,10.586,9968,3.814,21.172,1155,1157,6163
2018,4231,14295,22291,406590,404886,1415,6.325,1573,7.032,41789,10761,31028,2.658,10.321,38630,11587,27043,2.862,9.541,3159,0.780,19.082,987,1042,6126
2018,4232,9968,11966,165281,166254,763,6.319,982,8.132,18104,4044,14060,2.432,10.889,20033,6608,13425,3.975,12.050,-1929,-1.160,21.779,688,707,3864
2018,4233,9362,16610,254726,249772,927,5.567,1008,6.054,32219,5428,26791,2.173,12.899,22538,7966,14572,3.189,9.023,9681,3.876,18.047,572,613,4523
2018,4234,20686,32289,640074,640075,3337,10.360,3179,9.870,75565,19530,56035,3.051,11.806,75359,26177,49182,4.090,11.773,206,0.032,23.547,1442,1481,8726
2018,4235,6613,9080,149179,149118,383,4.187,519,5.673,15033,2273,12760,1.524,10.081,14740,3657,11083,2.452,9.885,293,0.196,19.770,335,349,1746
2018,4236,17274,27089,518125,518533,1586,5.798,2120,7.750,57690,9233,48457,1.781,11.126,58589,17584,41005,3.391,11.299,-899,-0.173,22.251,1194,1217,6791
2018,4237,9468,18962,255542,252135,810,4.262,893,4.699,28198,9760,18438,3.871,11.184,21123,6119,15004,2.427,8.378,7075,2.806,16.755,491,508,2614
2018,4238,37284,54472,762912,757160,2474,4.504,3384,6.161,84943,14457,70486,1.909,11.219,73633,25272,48361,3.338,9.725,11310,1.494,19.450,1930,2035,11265
2018,4239,25654,28911,323995,322983,2392,8.212,2824,9.695,41260,10221,31039,3.165,12.775,39263,13903,25360,4.305,12.156,1997,0.618,24.313,2086,2103,8871
2018,4241,6577,8726,149711,149112,317,3.524,855,9.505,18108,2711,15397,1.818,12.144,16382,7450,8932,4.996,10.986,1726,1.158,21.973,400,419,1879
2018,4242,6278,9588,302591,308153,726,7.585,694,7.250,25618,4050,21568,1.314,8.313,36711,12311,24400,3.995,11.913,-11093,-3.600,16.627,503,517,4425
2018,4243,12454,13474,195593,197900,1169,8.514,1682,12.250,23350,6430,16920,3.249,11.799,28183,10110,18073,5.109,14.241,-4833,-2.442,23.598,1317,1330,6488
2018,4244,24977,32725,853921,841279,2560,7.816,2617,7.990,99427,30364,69063,3.609,11.819,73307,25172,48135,2.992,8.714,26120,3.105,17.428,1731,1737,11128
2018,4245,3098,5839,60232,61969,219,3.714,334,5.664,7423,1595,5828,2.574,11.979,10988,2551,8437,4.117,17.732,-3565,-5.753,23.957,168,178,853
2018,4246,7489,11766,161759,161512,455,3.812,798,6.685,17199,2219,14980,1.374,10.649,16632,6941,9691,4.298,10.298,567,0.351,20.595,407,417,2106
2018,4247,3722,6071,100066,99337,251,4.103,344,5.623,13960,3777,10183,3.802,14.053,12365,4144,8221,4.172,12.448,1595,1.606,24.895,173,181,1544
2018,4248,3200,4218,200590,201993,320,7.604,301,7.152,13537,3530,10007,1.748,6.702,16474,2862,13612,1.417,8.156,-2937,-1.454,13.403,212,217,1758
2018,4249,19259,26084,340611,341443,1786,6.797,2173,8.269,40334,9565,30769,2.801,11.813,42050,14235,27815,4.169,12.315,-1716,-0.503,23.626,1469,1513,8095
2018,4251,31533,33734,284700,286423,3490,10.304,3764,11.113,28949,11934,17015,4.167,10.107,32496,12100,20396,4.225,11.345,-3547,-1.238,20.214,2815,2827,8771
2018,4411,37262,43627,1331662,1330746,3442,7.874,3618,8.276,124090,44387,79703,3.335,9.325,122296,37386,84910,2.809,9.190,1794,0.135,18.380,2741,2795,27896
2018,4412,11012,12804,151776,151339,805,6.276,850,6.627,17971,5550,12421,3.667,11.875,16894,6281,10613,4.150,11.163,1077,0.712,22.326,629,645,4589
2018,4413,25683,55728,524488,530615,2421,4.338,2574,4.613,47685,12903,34782,2.432,8.987,58956,12420,46536,2.341,11.111,-11271,-2.124,17.973,1678,1797,7654
2018,4421,12470,22021,208612,208864,1356,6.115,1667,7.517,25149,8617,16532,4.126,12.041,25884,7379,18505,3.533,12.393,-735,-0.352,24.082,1085,1152,4837
2018,4422,17070,25296,261390,256509,1629,6.427,1733,6.837,45555,11997,33558,4.677,17.760,37180,7695,29485,3.000,14.495,8375,3.265,28.989,1116,1139,3906
2018,4431,16622,26527,309707,313005,1449,5.272,3361,12.229,36248,6971,29277,2.227,11.581,43235,20150,23085,6.438,13.813,-6987,-2.232,23.161,1934,2378,12914
2018,4441,32986,54983,1204109,1174597,2358,4.275,2713,4.918,113120,15443,97677,1.315,9.631,54282,14277,40005,1.215,4.621,58838,5.009,9.243,1766,1830,9061
2018,4442,12057,16207,155661,156460,923,5.682,995,6.126,18791,5789,13002,3.700,12.010,20615,4798,15817,3.067,13.176,-1824,-1.166,24.020,676,700,3172
2018,4451,60090,86508,2750810,2774436,7762,8.987,7481,8.662,202168,87606,114562,3.158,7.287,253289,71533,181756,2.578,9.129,-51121,-1.843,14.574,5469,5641,36270
2018,4452,16029,19907,160848,160032,2188,11.006,2135,10.739,29869,12965,16904,8.102,18.664,28086,10166,17920,6.352,17.550,1783,1.114,35.101,1499,1585,7255
2018,4453,28261,32341,174642,172384,2537,7.879,2253,6.997,26338,9343,16995,5.420,15.279,21796,7470,14326,4.333,12.644,4542,2.635,25.288,1755,1769,5818
2018,4461,39236,89485,1039286,1025041,5259,5.777,8343,9.165,215101,35194,179907,3.433,20.985,186440,113339,73101,11.057,18.189,28661,2.796,36.377,3094,3333,15834
2018,4471,61497,107905,973929,959948,7473,6.936,7133,6.621,148704,50308,98396,5.241,15.491,117997,39035,78962,4.066,12.292,30707,3.199,24.584,4496,4776,22781
2018,4481,31890,89396,1339845,1362990,6125,6.786,7854,8.701,163031,54743,108288,4.016,11.961,208294,53234,155060,3.906,15.282,-45263,-3.321,23.923,3562,4194,18945
2018,4482,4609,22985,239166,241203,1048,4.454,2137,9.082,24680,7572,17108,3.139,10.232,28847,10309,18538,4.274,11.960,-4167,-1.728,20.464,443,481,1991
2018,4483,13890,20777,120074,121556,1206,5.744,1641,7.816,15128,4636,10492,3.814,12.445,18201,6191,12010,5.093,14.973,-3073,-2.528,24.891,978,1002,2988
2018,4511,23723,34311,456148,454590,2407,6.961,2942,8.508,51372,13277,38095,2.921,11.301,48670,13387,35283,2.945,10.706,2702,0.594,21.413,2085,2229,8258
2018,4512,3090,6753,70002,77112,438,6.314,806,11.619,5061,2427,2634,3.147,6.563,19340,4538,14802,5.885,25.080,-14279,-18.517,13.126,297,566,3169
2018,4522,21,4113,456067,466482,12,0.284,228,5.402,18251,602,17649,0.129,3.912,37968,15054,22914,3.227,8.139,-19717,-4.227,7.825,D,D,D
2018,4523,6980,48090,2212375,2219586,2094,4.389,1331,2.790,82104,16045,66059,0.723,3.699,97006,23301,73705,1.050,4.370,-14902,-0.671,7.398,783,808,2728
2018,4531,10866,11339,55569,55918,832,7.234,1155,10.043,8403,2616,5787,4.678,15.027,9148,3501,5647,6.261,16.360,-745,-1.332,30.055,880,887,2687
2018,4532,15558,24226,206163,211330,1609,6.523,2487,10.083,25247,7431,17816,3.516,11.947,35903,12030,23873,5.693,16.989,-10656,-5.042,23.893,1605,1712,6449
2018,4533,12270,18366,202881,200754,1290,6.932,1776,9.544,26697,6649,20048,3.312,13.298,22758,7592,15166,3.782,11.336,3939,1.962,22.673,1252,1319,4610
2018,4539,33135,44989,295167,289402,4922,11.043,4085,9.165,50336,22247,28089,7.687,17.393,38970,14525,24445,5.019,13.466,11366,3.927,26.931,2975,3042,10326
2018,4541,33810,35425,547887,542509,5797,16.635,4643,13.324,75891,29479,46412,5.434,13.989,66307,28067,38240,5.174,12.222,9584,1.767,24.445,3667,3695,14605
2018,4542,2800,3363,41280,41437,298,8.793,350,10.328,3490,931,2559,2.247,8.422,3819,1485,2334,3.584,9.216,-329,-0.794,16.845,287,293,1228
2018,4543,21781,26784,179896,180065,2553,9.456,2984,11.052,25230,8423,16807,4.678,14.012,25787,10147,15640,5.635,14.321,-557,-0.309,28.023,1954,2003,7139
2018,4811,400,2105,436431,432814,104,4.913,128,6.046,24824,1905,22919,0.440,5.735,18023,2568,15455,0.593,4.164,6801,1.571,8.328,39,44,911
2018,4812,1696,1926,42045,41302,193,9.972,212,10.953,5655,740,4915,1.792,13.692,4128,1085,3043,2.627,9.995,1527,3.697,19.990,142,145,825
2018,4831,594,916,42085,41456,102,11.123,104,11.341,4771,637,4134,1.537,11.509,3537,1481,2056,3.572,8.532,1234,2.977,17.064,54,54,209
2018,4832,423,488,19423,19449,47,9.671,43,8.848,2115,576,1539,2.962,10.875,2086,716,1370,3.681,10.725,29,0.149,21.451,30,31,494
2018,4841,58182,69290,1015564,996190,12405,18.480,8078,12.034,145238,53772,91466,5.398,14.579,104911,31263,73648,3.138,10.531,40327,4.048,21.062,5830,5847,19980
2018,4842,39494,43254,494038,491327,5197,12.058,4892,11.350,73566,22551,51015,4.590,14.973,68193,21316,46877,4.338,13.879,5373,1.094,27.759,3532,3551,13984
2018,4851,413,695,55328,54546,55,7.919,54,7.775,4727,1032,3695,1.892,8.666,3243,1371,1872,2.513,5.945,1484,2.721,11.891,28,28,884
2018,4852,295,593,18015,16145,104,18.326,53,9.339,5549,3100,2449,19.202,34.371,1626,537,1089,3.326,10.072,3923,24.299,20.143,24,34,169
2018,4853,6548,6729,73568,74395,1032,15.185,1166,17.157,12306,5095,7211,6.849,16.541,13997,5199,8798,6.988,18.814,-1691,-2.273,33.083,948,951,4166
2018,4854,2441,4146,234263,235617,257,6.163,305,7.314,21705,5798,15907,2.461,9.212,25273,10031,15242,4.257,10.726,-3568,-1.514,18.424,162,167,4263
2018,4855,1047,1179,32770,33431,98,8.235,120,10.084,3381,656,2725,1.962,10.113,4507,1662,2845,4.971,13.481,-1126,-3.368,20.227,91,94,917
2018,4859,4259,4707,97861,97642,762,16.375,655,14.075,14986,4348,10638,4.453,15.348,14495,6355,8140,6.509,14.845,491,0.503,29.690,458,467,4078
2018,4861,78,764,12802,12951,45,5.852,55,7.152,935,388,547,2.996,7.220,1235,460,775,3.552,9.536,-300,-2.317,14.440,5,5,61
2018,4862,107,1959,26196,26677,70,3.440,222,10.909,2820,676,2144,2.534,10.571,3811,1761,2050,6.601,14.286,-991,-3.715,21.142,9,9,109
2018,4869,76,681,8359,8445,17,2.446,45,6.475,550,71,479,0.841,6.513,764,452,312,5.352,9.047,-214,-2.534,13.025,3,3,5
2018,4871,580,624,11599,11329,86,13.871,78,12.581,2138,561,1577,4.952,18.873,1578,616,962,5.438,13.929,560,4.943,27.859,56,56,483
2018,4872,1312,1361,14605,14833,195,14.498,163,12.119,1748,526,1222,3.546,11.785,2227,942,1285,6.351,15.014,-479,-3.229,23.570,108,108,592
2018,4879,184,218,3464,3430,26,12.235,15,7.059,250,65,185,1.895,7.289,188,38,150,1.108,5.481,62,1.808,10.962,11,11,23
2018,4881,3854,5713,209731,204543,464,8.144,433,7.600,31573,7526,24047,3.679,15.436,21327,6528,14799,3.192,10.427,10246,5.009,20.853,239,241,1769
2018,4882,534,1451,41828,41519,86,5.860,119,8.109,4916,1145,3771,2.758,11.841,4369,1242,3127,2.991,10.523,547,1.317,21.046,22,22,165
2018,4883,1818,2409,97841,94908,136,5.605,171,7.047,13731,1160,12571,1.222,14.468,7476,1487,5989,1.567,7.877,6255,6.591,15.754,90,91,410
2018,4884,9689,11263,103921,103424,1276,11.359,1216,10.825,16474,5528,10946,5.345,15.929,15578,6194,9384,5.989,15.062,896,0.866,30.125,762,770,3459
2018,4885,13717,19660,269307,267291,1519,7.679,1762,8.907,39058,10015,29043,3.747,14.613,34741,14301,20440,5.350,12.997,4317,1.615,25.995,933,955,5599
2018,4889,1461,1560,18444,17613,203,13.059,192,12.351,4257,1721,2536,9.771,24.170,2590,938,1652,5.326,14.705,1667,9.465,29.410,149,149,553
2018,4921,3741,9417,620283,605503,621,6.591,631,6.697,70398,9253,61145,1.528,11.626,40714,8896,31818,1.469,6.724,29684,4.902,13.448,405,428,4329
2018,4922,3380,3952,55386,51470,599,15.259,546,13.909,15342,7309,8033,14.201,29.808,7481,3818,3663,7.418,14.535,7861,15.273,29.069,436,436,3089
2018,4931,7613,16209,965815,939752,1339,8.306,1164,7.220,127134,43511,83623,4.630,13.528,75291,22865,52426,2.433,8.012,51843,5.517,16.024,378,399,4213
2018,5111,10410,14408,347486,354336,801,5.394,1683,11.334,39162,9907,29255,2.796,11.052,53979,16549,37430,4.670,15.234,-14817,-4.182,22.104,829,843,5302
2018,5112,9023,12324,622085,612525,1986,16.550,1338,11.150,99371,32120,67251,5.244,16.223,79141,26458,52683,4.319,12.920,20230,3.303,25.841,779,795,7394
2018,5121,14106,17363,303792,305518,2130,12.262,2145,12.349,36534,12817,23717,4.195,11.958,39416,12437,26979,4.071,12.901,-2882,-0.943,23.916,1388,1395,7629
2018,5122,2787,2973,23123,22661,388,13.110,361,12.198,3848,1803,2045,7.957,16.981,2958,970,1988,4.281,13.054,890,3.928,26.107,239,241,521
2018,5151,3750,7076,199701,203620,239,3.334,425,5.928,12051,2779,9272,1.365,5.918,20286,4276,16010,2.100,9.963,-8235,-4.044,11.837,239,247,1207
2018,5152,340,656,50488,50676,34,5.075,62,9.254,2877,649,2228,1.281,5.677,3283,905,2378,1.786,6.478,-406,-0.801,11.355,27,28,145
2018,5173,7029,56175,1065003,1055551,5680,10.279,3848,6.964,151098,61098,90000,5.788,14.315,132227,37356,94871,3.539,12.527,18871,1.788,25.054,707,937,5596
2018,5174,288,368,8297,8553,51,13.784,55,14.865,1066,192,874,2.245,12.464,1598,924,674,10.804,18.685,-532,-6.220,24.928,46,47,869
2018,5179,2652,3438,54327,54452,402,11.505,514,14.711,8430,2752,5678,5.054,15.482,8797,3034,5763,5.572,16.156,-367,-0.674,30.963,306,322,2063
2018,5182,9543,16381,553336,541572,2189,13.584,1656,10.276,93584,26032,67552,4.807,17.280,70021,28853,41168,5.328,12.929,23563,4.351,25.858,859,883,10213
2018,5191,8615,10726,313982,307594,1454,13.604,1378,12.893,55653,21049,34604,6.843,18.093,41995,13221,28774,4.298,13.653,13658,4.440,27.306,840,928,8796
2018,5211,12,58,19785,19761,0,0.000,0,0.000,347,0,347,0.000,1.756,301,0,301,0.000,1.523,46,0.233,3.046,0,0,0
2018,5221,10422,115597,1942796,1956478,3223,2.762,5384,4.614,173580,32675,140905,1.670,8.872,202826,42420,160406,2.168,10.367,-29246,-1.495,17.744,360,924,9250
2018,5222,12876,44069,627088,622541,4388,10.000,4013,9.145,100694,31069,69625,4.991,16.175,92566,33956,58610,5.454,14.869,8128,1.306,29.738,1011,1090,8342
2018,5223,11446,25044,292679,292905,1678,6.654,2029,8.045,37427,10927,26500,3.731,12.778,37848,12369,25479,4.223,12.922,-421,-0.144,25.556,958,1076,5301
2018,5231,9236,27402,355581,355937,3572,13.167,3023,11.144,54060,18795,35265,5.280,15.188,54238,11485,42753,3.227,15.238,-178,-0.050,30.376,708,739,2833
2018,5232,13,35,9867,7950,D,D,D,D,4749,D,433,D,59.736,809,D,689,D,10.176,3940,49.560,20.352,0,0,0
2018,5239,46041,65627,563386,551743,6696,10.271,5823,8.932,84981,33026,51955,5.986,15.402,62766,24581,38185,4.455,11.376,22215,4.026,22.752,3545,3557,12777
2018,5241,4598,31810,1539193,1539911,4681,14.875,4000,12.711,189718,76231,113487,4.950,12.320,191501,47969,143532,3.115,12.436,-1783,-0.116,24.640,275,279,2923
2018,5242,119195,136373,1086895,1052865,12997,9.568,11914,8.771,230064,117659,112405,11.175,21.851,159029,63383,95646,6.020,15.104,71035,6.747,30.209,8031,8127,28234
2018,5259,775,797,5643,5072,260,35.183,144,19.486,2868,2477,391,48.842,56.551,1819,1455,364,28.690,35.867,1049,20.684,71.734,117,117,1344
2018,5311,86995,117860,594686,588756,11160,9.491,10602,9.017,104325,49531,54794,8.413,17.720,93283,38775,54508,6.586,15.844,11042,1.875,31.688,7197,7360,23402
2018,5312,82562,97832,341163,334530,17054,17.929,11629,12.226,75944,36310,39634,10.854,22.702,62263,30976,31287,9.260,18.612,13681,4.090,37.224,5891,5966,11020
2018,5313,69437,87120,709612,703292,9861,11.473,7524,8.754,100534,38093,62441,5.416,14.295,87899,36285,51614,5.159,12.498,12635,1.797,24.996,4769,4859,19642
2018,5321,3378,15518,172413,166281,1007,6.510,909,5.876,26545,4261,22284,2.563,15.964,15019,3731,11288,2.244,9.032,11526,6.932,18.065,362,366,1546
2018,5322,6756,16585,131332,133081,920,5.388,1897,11.111,17108,3481,13627,2.616,12.855,20686,8811,11875,6.621,15.544,-3578,-2.689,25.711,682,712,4119
2018,5323,2069,2937,19515,19584,227,7.759,204,6.973,2570,695,1875,3.549,13.123,2708,875,1833,4.468,13.828,-138,-0.705,26.246,146,151,644
2018,5324,7370,14563,192349,188837,1371,9.505,1093,7.578,29721,9281,20440,4.915,15.739,22858,7519,15339,3.982,12.105,6863,3.634,24.209,494,516,2713
2018,5331,2156,2336,38521,38398,276,11.891,246,10.599,4568,1516,3052,3.948,11.896,4361,1632,2729,4.250,11.357,207,0.539,22.715,182,182,894
2018,5411,155189,167240,1147377,1148826,12209,7.274,13416,7.993,124537,34391,90146,2.994,10.840,127518,38376,89142,3.340,11.100,-2981,-0.259,21.681,9726,9806,26442
2018,5412,99372,119385,1149572,1147855,9982,8.379,9484,7.961,135378,38983,96395,3.396,11.794,130919,48163,82756,4.196,11.406,4459,0.388,22.811,6386,6466,31316
2018,5413,81866,101707,1528347,1513750,8740,8.613,8283,8.162,201327,59055,142272,3.901,13.300,173990,55240,118750,3.649,11.494,27337,1.806,22.988,5039,5112,20278
2018,5414,26939,27323,121916,120918,3706,13.667,3293,12.144,19513,7870,11643,6.509,16.137,17582,8159,9423,6.748,14.540,1931,1.597,29.081,2257,2258,5792
2018,5415,98710,118427,1895048,1864289,15290,12.723,18791,15.636,300423,72345,228078,3.881,16.115,239236,110732,128504,5.940,12.833,61187,3.282,25.665,11021,11085,43194
2018,5416,129026,139580,1322783,1296584,24805,18.065,20262,14.757,256301,94743,161558,7.307,19.767,203831,88648,115183,6.837,15.721,52470,4.047,31.441,14451,14573,51424
2018,5417,13764,17143,742965,728982,2172,12.812,1791,10.565,89988,17238,72750,2.365,12.344,61670,15021,46649,2.061,8.460,28318,3.885,16.919,1105,1116,7261
2018,5418,28534,32641,479437,480532,3324,10.140,3607,11.003,56794,21264,35530,4.425,11.819,59022,23236,35786,4.835,12.283,-2228,-0.464,23.638,2589,2630,16807
2018,5419,55298,62641,671957,657176,7030,11.285,6342,10.180,108262,37192,71070,5.659,16.474,78266,36445,41821,5.546,11.909,29996,4.564,23.819,4209,4438,27728
2018,5511,25641,53569,3494326,3486391,2466,4.544,3871,7.133,457689,87378,370311,2.506,13.128,440459,139256,301203,3.994,12.634,17230,0.494,25.267,739,763,12086
2018,5611,26805,29536,498128,489872,3319,11.281,3087,10.493,85994,27199,58795,5.552,17.554,70222,24034,46188,4.906,14.335,15772,3.220,28.670,2207,2222,16489
2018,5612,2001,6047,270519,272430,290,4.635,709,11.332,30946,4900,26046,1.799,11.359,34651,13682,20969,5.022,12.719,-3705,-1.360,22.719,87,89,2961
2018,5613,24482,49054,5993950,5908661,4504,9.194,4368,8.917,1006035,219666,786369,3.718,17.026,827099,206291,620808,3.491,13.998,178936,3.028,27.996,2299,2362,89500
2018,5614,21245,28234,809814,807922,2538,8.909,3046,10.692,150674,51013,99661,6.314,18.650,147581,56954,90627,7.049,18.267,3093,0.383,36.533,2023,2051,16729
2018,5615,12655,16369,220722,227258,1381,7.210,6953,36.299,33218,16658,16560,7.330,14.617,43817,31874,11943,14.025,19.281,-10599,-4.664,29.234,908,922,3794
2018,5616,18191,23247,990290,973278,2353,10.151,2220,9.577,128275,30482,97793,3.132,13.180,95101,29861,65240,3.068,9.771,33174,3.408,19.542,1406,1424,14745
2018,5617,156118,164983,1989367,1968624,21776,13.319,18805,11.502,305370,91189,214181,4.632,15.512,261887,86176,175711,4.377,13.303,43483,2.209,26.606,12884,12919,55515
2018,5619,15746,17708,295716,290823,1817,10.286,1732,9.804,50576,11656,38920,4.008,17.391,41488,13508,27980,4.645,14.266,9088,3.125,28.531,1161,1179,6924
2018,5621,7314,11220,223713,219702,743,6.645,666,5.956,27021,8793,18228,4.002,12.299,18744,7043,11701,3.206,8.532,8277,3.767,17.063,456,459,3429
2018,5622,1216,2533,58548,58113,131,5.175,128,5.056,3703,855,2848,1.471,6.372,2800,964,1836,1.659,4.818,903,1.554,9.636,81,81,529
2018,5629,8687,10228,142784,138682,928,9.146,765,7.540,25913,8243,17670,5.944,18.685,17716,5153,12563,3.716,12.775,8197,5.911,25.549,511,518,3026
2018,6111,18704,21385,1064601,1057407,787,3.674,854,3.987,75793,14658,61135,1.386,7.168,61491,15645,45846,1.480,5.815,14302,1.353,11.631,592,596,11563
2018,6112,407,764,57599,59357,30,3.878,49,6.335,4041,274,3767,0.462,6.808,7427,1129,6298,1.902,12.513,-3386,-5.705,13.616,20,21,249
2018,6113,2365,4243,1866499,1861789,164,3.818,268,6.240,90063,4787,85276,0.257,4.837,79180,5143,74037,0.276,4.253,10883,0.585,8.506,65,68,1372
2018,6114,6705,7150,65793,65053,877,12.293,845,11.845,11530,4100,7430,6.303,17.724,10158,4375,5783,6.725,15.615,1372,2.109,31.230,536,555,2595
2018,6115,6172,7617,108614,109860,674,8.820,724,9.474,15053,3920,11133,3.568,13.702,17542,5644,11898,5.137,15.968,-2489,-2.266,27.404,430,447,2877
2018,6116,43479,46961,456006,447594,5678,12.264,4353,9.402,78718,26077,52641,5.826,17.587,61869,21248,40621,4.747,13.823,16849,3.764,27.645,3266,3283,16316
2018,6117,6927,7732,106066,102135,1255,16.658,859,11.402,19695,7686,12009,7.525,19.283,11546,4348,7198,4.257,11.305,8149,7.979,22.609,630,633,2484
2018,6211,152483,203352,2476365,2462541,15216,7.451,16955,8.302,342405,122991,219414,4.994,13.905,314045,104288,209757,4.235,12.753,28360,1.152,25.506,10947,11211,52432
2018,6212,117942,129211,949049,947506,7078,5.473,7307,5.650,117845,37863,79982,3.996,12.437,114339,38925,75414,4.108,12.067,3506,0.370,24.135,5883,5935,29435
2018,6213,123616,145642,912097,891656,14493,10.063,11265,7.821,154866,54173,100693,6.076,17.368,113653,42195,71458,4.732,12.746,41213,4.622,25.493,7215,7396,24995
2018,6214,17663,44583,1133593,1119589,3808,8.657,2619,5.954,153116,48081,105035,4.295,13.676,124351,41816,82535,3.735,11.107,28765,2.569,22.214,960,991,13320
2018,6215,6658,17093,291586,290298,2793,16.862,1735,10.475,45510,15817,29693,5.449,15.677,42624,16013,26611,5.516,14.683,2886,0.994,29.366,618,632,5809
2018,6216,21736,31216,1474799,1439670,3439,11.097,2989,9.645,237967,54680,183287,3.798,16.529,168087,48902,119185,3.397,11.675,69880,4.854,23.351,1855,1926,26574
2018,6219,6442,11206,335780,335841,1402,12.710,1052,9.537,47249,16660,30589,4.961,14.069,47021,13682,33339,4.074,14.001,228,0.068,28.002,454,473,5631
2018,6221,2482,5364,5525635,5512034,252,4.779,71,1.346,221961,49551,172410,0.899,4.027,196596,21346,175250,0.387,3.567,25365,0.460,7.133,23,23,6030
2018,6222,420,682,246781,246997,55,8.333,11,1.667,18377,11994,6383,4.856,7.440,18671,2162,16509,0.875,7.559,-294,-0.119,14.880,6,6,1581
2018,6223,302,782,244534,244782,35,4.484,32,4.100,12893,3179,9714,1.299,5.267,13645,3092,10553,1.263,5.574,-752,-0.307,10.534,4,4,223
2018,6231,8656,16279,1621620,1630690,1109,6.851,928,5.732,150398,71529,78869,4.386,9.223,168583,62819,105764,3.852,10.338,-18185,-1.115,18.446,446,481,28632
2018,6232,10326,42128,797728,797045,2153,5.135,1761,4.200,98870,25695,73175,3.224,12.405,97622,22328,75294,2.801,12.248,1248,0.157,24.496,495,562,7458
2018,6233,16723,24125,977498,964354,1977,8.223,1810,7.529,114295,41121,73174,4.264,11.852,88551,34188,54363,3.545,9.182,25744,2.670,18.365,1246,1265,19804
2018,6239,2996,4865,122501,121880,331,6.763,390,7.968,16925,3638,13287,2.985,13.887,15610,6062,9548,4.974,12.808,1315,1.079,25.615,166,174,1913
2018,6241,54274,72766,1897076,1856624,8208,11.374,7005,9.707,293859,79080,214779,4.259,15.828,209606,54253,155353,2.922,11.290,84253,4.538,22.579,4765,4819,29612
2018,6242,10216,14243,199185,199276,624,4.385,599,4.209,24988,5143,19845,2.581,12.539,24979,4610,20369,2.313,12.535,9,0.005,25.070,251,251,1258
2018,6243,3769,7071,284092,286874,359,5.033,483,6.771,34833,5462,29371,1.904,12.142,40282,7925,32357,2.763,14.042,-5449,-1.899,24.285,164,173,2617
2018,6244,56662,72543,986532,977179,6205,8.568,5955,8.223,130442,42633,87809,4.363,13.349,112147,39147,73000,4.006,11.477,18295,1.872,22.953,4188,4257,26023
2018,7111,7328,7465,122941,122476,842,11.384,705,9.532,19030,5578,13452,4.554,15.538,18056,4594,13462,3.751,14.742,974,0.795,29.485,469,469,3449
2018,7112,3143,3325,132730,130309,445,13.555,361,10.996,16494,3869,12625,2.969,12.658,11482,2606,8876,2.000,8.811,5012,3.846,17.623,271,271,1938
2018,7113,6477,6927,195284,189944,735,10.665,665,9.649,28917,5206,23711,2.741,15.224,18131,5592,12539,2.944,9.545,10786,5.679,19.091,467,470,3155
2018,7114,3159,3286,22365,21831,428,13.125,378,11.592,3750,1061,2689,4.860,17.177,2606,1355,1251,6.207,11.937,1144,5.240,23.874,259,259,860
2018,7115,17750,17796,52859,51636,3522,20.212,2781,15.959,14210,7504,6706,14.533,27.520,11774,5829,5945,11.289,22.802,2436,4.718,45.604,1710,1711,3630
2018,7121,6712,7204,157780,156534,298,4.154,237,3.304,12491,1276,11215,0.815,7.980,9831,1132,8699,0.723,6.280,2660,1.699,12.561,145,145,844
2018,7131,2762,3205,228725,227415,571,17.849,559,17.474,20290,8802,11488,3.870,8.922,17470,3172,14298,1.395,7.682,2820,1.240,15.364,239,243,2476
2018,7132,1785,2935,134532,135010,214,7.321,190,6.500,9502,3116,6386,2.308,7.038,10327,3109,7218,2.303,7.649,-825,-0.611,14.076,113,122,1795
2018,7139,55245,64659,1386961,1371417,7686,12.047,5973,9.362,196954,80274,116680,5.853,14.361,165738,52218,113520,3.808,12.085,31216,2.276,24.170,4504,4592,37486
2018,7211,42501,53967,2061065,2058524,5022,9.367,4321,8.059,232649,107090,125559,5.202,11.302,227279,86192,141087,4.187,11.041,5370,0.261,22.082,3011,3062,51832
2018,7212,5534,6143,47837,47285,526,8.621,443,7.261,7115,1699,5416,3.593,15.047,6004,1670,4334,3.532,12.697,1111,2.350,25.395,294,297,878
2018,7213,1623,1792,9744,9600,115,6.414,117,6.525,1653,593,1060,6.177,17.220,1349,233,1116,2.427,14.053,304,3.167,28.106,83,83,169
2018,7223,16103,39756,823332,823825,4282,10.855,3668,9.298,72902,30228,42674,3.669,8.849,72693,32960,39733,4.001,8.824,209,0.025,17.648,1825,1838,11135
2018,7224,35400,36201,367171,364450,3501,9.646,3692,10.172,64899,29473,35426,8.087,17.807,59605,24673,34932,6.770,16.355,5294,1.453,32.710,3006,3011,20734
2018,7225,383387,528898,11011955,10872556,53897,10.264,46366,8.829,1731557,752191,979366,6.918,15.926,1454460,548915,905545,5.049,13.377,277097,2.549,26.755,34896,36371,386953
2018,8111,134894,150181,924423,914359,12264,8.168,12188,8.118,142903,50038,92865,5.472,15.629,123038,44222,78816,4.836,13.456,19865,2.173,26.912,8976,9218,33279
2018,8112,9842,11180,100486,99444,1030,9.122,1253,11.097,16496,5529,10967,5.560,16.588,14308,6776,7532,6.814,14.388,2188,2.200,28.776,902,911,3363
2018,8113,18256,20095,201958,200504,1681,8.388,1570,7.835,28459,8384,20075,4.181,14.194,25458,9510,15948,4.743,12.697,3001,1.497,25.394,1124,1125,3704
2018,8114,17641,18348,72672,72115,1995,10.852,2066,11.238,11436,4615,6821,6.400,15.858,10366,4521,5845,6.269,14.374,1070,1.484,28.749,1514,1514,3160
2018,8121,105073,120861,736865,725587,15768,13.157,13739,11.464,138068,66690,71378,9.191,19.028,115745,53343,62402,7.352,15.952,22323,3.077,31.904,9714,9860,37522
2018,8122,13958,19860,134471,138428,744,3.733,890,4.465,12113,2770,9343,2.001,8.750,19664,4085,15579,2.951,14.205,-7551,-5.455,17.501,493,528,2475
2018,8123,26149,31193,283366,285214,2110,6.692,2780,8.818,31634,11455,20179,4.016,11.091,35517,11835,23682,4.150,12.453,-3883,-1.361,22.183,2109,2163,8898
2018,8129,32421,42063,347353,334277,6146,14.854,4773,11.536,74904,27893,47011,8.344,22.408,47359,20668,26691,6.183,14.168,27545,8.240,28.335,2930,3024,12485
2018,8131,179038,179830,1695438,1692718,7554,4.199,7693,4.276,136454,22172,114282,1.310,8.061,130714,23276,107438,1.375,7.722,5740,0.339,15.444,5038,5038,15470
2018,8132,17307,19397,196280,193446,1717,8.990,1120,5.864,24352,7353,16999,3.801,12.589,18654,5542,13112,2.865,9.643,5698,2.946,19.286,801,809,3003
2018,8133,14570,17288,184622,183673,1298,7.556,1080,6.287,21942,4329,17613,2.357,11.946,20094,4835,15259,2.632,10.940,1848,1.006,21.880,648,669,2470
2018,8134,22455,24006,220627,221196,1400,5.826,1451,6.038,24452,5197,19255,2.350,11.054,25685,6067,19618,2.743,11.612,-1233,-0.557,22.109,956,960,3585
2018,8139,52842,54879,493439,490204,2753,5.013,2820,5.135,48357,11349,37008,2.315,9.865,41657,10524,31133,2.147,8.498,6700,1.367,16.996,1996,1998,7020
2019,1131,400,423,3619,3624,42,10.048,32,7.656,421,74,347,2.042,11.617,434,106,328,2.925,11.976,-13,-0.359,23.234,19,19,31
2019,1132,126,141,1022,1059,16,11.388,15,10.676,169,53,116,5.005,15.958,237,94,143,8.876,22.380,-68,-6.421,31.917,13,13,89
2019,1133,6937,7009,47527,48270,616,8.706,749,10.586,5856,1717,4139,3.557,12.132,7267,2183,5084,4.522,15.055,-1411,-2.923,24.264,563,563,1674
2019,1141,1359,1376,5593,5548,248,18.229,217,15.950,989,552,437,9.950,17.826,904,401,503,7.228,16.294,85,1.532,32.588,137,137,256
2019,1142,311,313,1703,1684,35,11.290,29,9.355,238,98,140,5.821,14.137,197,102,95,6.059,11.702,41,2.435,23.404,25,25,91
2019,1151,3839,4192,70262,69215,456,10.954,398,9.560,11191,3394,7797,4.904,16.168,9106,2340,6766,3.381,13.156,2085,3.012,26.312,288,288,1890
2019,1152,4147,4235,21650,21194,566,13.526,465,11.112,3972,1913,2059,9.026,18.742,3111,1201,1910,5.667,14.679,861,4.063,29.358,363,363,959
2019,1153,1374,1477,12999,13041,176,12.063,140,9.596,2023,647,1376,4.961,15.513,2128,538,1590,4.125,16.318,-105,-0.805,31.025,100,100,353
2019,2111,4370,5623,108161,107548,426,7.521,508,8.969,13263,4390,8873,4.082,12.332,12153,3642,8511,3.386,11.300,1110,1.032,22.600,310,316,1381
2019,2121,338,637,50514,49846,84,13.397,64,10.207,6918,1438,5480,2.885,13.879,5604,1675,3929,3.360,11.243,1314,2.636,22.485,34,34,457
2019,2122,182,246,37608,36411,23,9.312,25,10.121,3414,364,3050,1.000,9.376,998,205,793,0.563,2.741,2416,6.635,5.482,16,16,84
2019,2123,2478,4672,89344,87831,282,6.070,229,4.930,11751,3627,8124,4.130,13.379,8559,1846,6713,2.102,9.745,3192,3.634,19.490,113,114,587
2019,2131,9438,11929,341691,333448,1370,11.500,1338,11.231,58668,15732,42936,4.718,17.594,42187,14523,27664,4.355,12.652,16481,4.943,25.304,895,920,8099
2019,2211,1793,11377,502608,505957,569,5.018,493,4.348,28573,11103,17470,2.194,5.647,35600,11197,24403,2.213,7.036,-7027,-1.389,11.295,99,99,737
2019,2212,400,2457,92746,92003,148,6.022,149,6.063,6641,1987,4654,2.160,7.218,5292,1351,3941,1.468,5.752,1349,1.466,11.504,22,22,157
2019,2213,3525,4658,46259,46178,227,4.885,205,4.411,3867,763,3104,1.652,8.374,3620,1130,2490,2.447,7.839,247,0.535,15.679,103,103,562
2019,2361,149184,150724,757151,739198,27222,18.445,20939,14.188,170358,80359,89999,10.871,23.046,134519,56561,77958,7.652,18.198,35839,4.848,36.396,14854,14856,41734
2019,2362,37201,38773,698238,685842,3641,9.424,3367,8.715,110965,24489,86476,3.571,16.179,86427,18246,68181,2.660,12.602,24538,3.578,25.203,2448,2450,12596
2019,2371,16186,17801,640193,628168,1410,7.947,1293,7.288,103079,13747,89332,2.188,16.409,80548,13480,67068,2.146,12.823,22531,3.587,25.645,860,872,7093
2019,2372,3833,3938,21589,21795,347,8.695,453,11.351,3275,1011,2264,4.639,15.027,3638,1880,1758,8.626,16.692,-363,-1.666,30.053,349,349,1064
2019,2373,7838,8719,303925,302149,553,6.346,542,6.220,37281,4409,32872,1.459,12.339,33667,4970,28697,1.645,11.143,3614,1.196,22.285,346,346,2338
2019,2379,3675,3792,73199,71684,379,10.050,337,8.937,13185,3049,10136,4.253,18.393,10310,2207,8103,3.079,14.383,2875,4.011,28.765,226,226,1730
2019,2381,80655,81714,895931,892267,10673,13.211,8820,10.918,154247,43641,110606,4.891,17.287,146586,36361,110225,4.075,16.428,7661,0.859,32.857,6072,6083,26491
2019,2382,165565,170671,2149938,2104656,16147,9.539,13341,7.882,326230,75243,250987,3.575,15.500,235973,63871,172102,3.035,11.212,90257,4.288,22.424,9789,9816,44798
2019,2383,103126,104479,844351,832686,13861,13.405,11712,11.326,150589,46468,104121,5.580,18.085,127550,38193,89357,4.587,15.318,23039,2.767,30.636,8178,8200,28048
2019,2389,60235,61089,659852,648242,7747,12.882,5843,9.716,105195,28177,77018,4.347,16.228,81870,22474,59396,3.467,12.630,23325,3.598,25.259,3846,3847,15787
2019,3111,1096,1734,56689,54601,108,6.227,109,6.284,8124,1860,6264,3.407,14.879,4020,1472,2548,2.696,7.363,4104,7.516,14.725,78,81,714
2019,3112,534,879,58613,58943,44,5.000,46,5.227,3135,353,2782,0.599,5.319,3814,912,2902,1.547,6.471,-679,-1.152,10.637,25,25,160
2019,3113,1628,1803,81427,80555,135,7.461,148,8.179,7690,1680,6010,2.086,9.546,5918,1516,4402,1.882,7.347,1772,2.200,14.693,121,122,1173
2019,3114,1474,1847,162920,162154,159,8.691,124,6.778,15369,2698,12671,1.664,9.478,13716,4431,9285,2.733,8.459,1653,1.019,16.917,76,76,1255
2019,3115,1070,1581,150667,149096,97,6.116,107,6.747,10663,1155,9508,0.775,7.152,7686,2114,5572,1.418,5.155,2977,1.997,10.310,84,85,713
2019,3116,2674,3328,530546,526821,179,5.379,178,5.349,32488,5944,26544,1.128,6.167,25035,4654,20381,0.883,4.752,7453,1.415,9.504,126,126,1130
2019,3117,413,510,31059,31218,37,7.269,35,6.876,2564,439,2125,1.406,8.213,2848,584,2264,1.871,9.123,-284,-0.910,16.426,23,23,183
2019,3118,9833,10692,295559,294597,985,9.231,942,8.828,33084,9748,23336,3.309,11.230,31177,8605,22572,2.921,10.583,1907,0.647,21.166,754,760,6286
2019,3119,3280,3782,222105,218391,423,11.391,286,7.702,24395,5077,19318,2.325,11.170,16911,4247,12664,1.945,7.743,7484,3.427,15.487,220,220,2419
2019,3121,8910,9700,240013,231826,1336,14.347,560,6.014,34829,9531,25298,4.111,15.024,18669,4963,13706,2.141,8.053,16160,6.971,16.106,407,409,3015
2019,3122,107,132,12681,12961,9,6.742,12,8.989,1277,50,1227,0.386,9.853,1698,191,1507,1.474,13.101,-421,-3.248,19.706,10,10,53
2019,3131,197,248,21161,21729,14,5.567,21,8.350,1224,283,941,1.302,5.633,2335,619,1716,2.849,10.746,-1111,-5.113,11.266,12,12,133
2019,3132,704,790,46395,46348,35,4.405,44,5.538,3256,238,3018,0.514,7.025,3153,765,2388,1.651,6.803,103,0.222,13.606,36,37,559
2019,3133,719,758,25494,25847,58,7.637,61,8.032,2066,554,1512,2.143,7.993,2751,806,1945,3.118,10.644,-685,-2.650,15.987,46,46,435
2019,3141,1385,1477,47906,48499,65,4.298,136,8.992,3694,492,3202,1.014,7.617,4928,1253,3675,2.584,10.161,-1234,-2.544,15.233,103,103,916
2019,3149,3628,3726,58081,57604,280,7.458,337,8.976,6805,1339,5466,2.325,11.814,5789,1628,4161,2.826,10.050,1016,1.764,20.099,248,248,1068
2019,3151,190,198,10426,10583,16,8.020,19,9.524,731,216,515,2.041,6.908,1059,268,791,2.532,10.007,-328,-3.099,13.815,16,17,253
2019,3152,3992,4044,61992,63684,570,13.940,660,16.141,9005,3257,5748,5.114,14.140,12429,5181,7248,8.135,19.517,-3424,-5.377,28.280,580,581,4447
2019,3159,510,518,8377,8283,67,13.022,60,11.662,1172,381,791,4.600,14.149,983,284,699,3.429,11.868,189,2.282,23.735,48,48,198
2019,3161,153,161,3267,3297,13,8.100,12,7.477,237,41,196,1.244,7.189,293,61,232,1.850,8.888,-56,-1.699,14.379,10,10,56
2019,3162,188,202,12220,12216,12,5.797,22,10.628,1080,68,1012,0.557,8.841,1074,528,546,4.322,8.792,6,0.049,17.583,18,20,509
2019,3169,704,714,11647,11458,81,11.416,72,10.148,1502,573,929,5.001,13.109,1109,293,816,2.557,9.679,393,3.430,19.358,53,53,228
2019,3211,2516,2973,91219,91531,177,5.911,220,7.347,7583,2371,5212,2.590,8.285,8309,2404,5905,2.626,9.078,-726,-0.793,16.569,169,169,1645
2019,3212,1020,1393,77993,78661,46,3.275,69,4.913,6224,836,5388,1.063,7.912,7491,2161,5330,2.747,9.523,-1267,-1.611,15.825,54,55,793
2019,3219,7941,9105,247492,245754,674,7.390,706,7.740,26678,7308,19370,2.974,10.856,23047,5268,17779,2.144,9.378,3631,1.477,18.756,544,545,3464
2019,3221,211,425,99032,96613,17,4.014,14,3.306,8442,1588,6854,1.644,8.738,3379,423,2956,0.438,3.497,5063,5.241,6.995,12,12,360
2019,3222,2121,3421,247840,247768,120,3.482,171,4.962,19353,4387,14966,1.771,7.811,19541,6060,13481,2.446,7.887,-188,-0.076,15.622,113,116,2772
2019,3231,21486,22914,428795,431436,1330,5.741,1839,7.938,34562,10025,24537,2.324,8.011,39705,13933,25772,3.229,9.203,-5143,-1.192,16.022,1482,1488,8183
2019,3241,886,2060,108082,107522,100,4.865,91,4.427,7281,1639,5642,1.524,6.772,6119,943,5176,0.877,5.691,1162,1.081,11.382,28,28,173
2019,3251,1210,2387,155861,155606,93,3.909,77,3.237,12685,2978,9707,1.914,8.152,12102,1797,10305,1.155,7.777,583,0.375,15.555,46,46,531
2019,3252,1044,1404,107504,107040,55,3.908,62,4.405,8427,1309,7118,1.223,7.873,7232,1690,5542,1.579,6.756,1195,1.116,13.513,39,39,773
2019,3253,694,947,33918,33731,57,6.061,44,4.678,2663,780,1883,2.312,7.895,2262,433,1829,1.284,6.706,401,1.189,13.412,28,28,124
2019,3254,1869,2408,267095,261175,279,11.835,178,7.550,27058,7229,19829,2.768,10.360,15208,3894,11314,1.491,5.823,11850,4.537,11.646,107,111,1414
2019,3255,1277,1631,63687,63708,58,3.522,90,5.464,5064,660,4404,1.036,7.949,5210,1133,4077,1.778,8.178,-146,-0.229,15.898,64,64,716
2019,3256,1975,2192,104323,102330,160,7.343,134,6.150,12058,3036,9022,2.967,11.783,7929,2894,5035,2.828,7.748,4129,4.035,15.497,108,109,1329
2019,3259,1653,2147,84759,84181,169,7.892,158,7.378,9195,3081,6114,3.660,10.923,8036,2544,5492,3.022,9.546,1159,1.377,19.092,94,110,872
2019,3261,7398,9849,654191,649682,393,3.978,453,4.585,55022,9097,45925,1.400,8.469,46266,10400,35866,1.601,7.121,8756,1.348,14.243,315,320,5716
2019,3262,1320,1771,142684,140018,61,3.414,93,5.204,12728,2040,10688,1.457,9.090,7667,1922,5745,1.373,5.476,5061,3.615,10.951,54,54,562
2019,3271,816,984,36414,36159,56,5.631,77,7.743,3036,372,2664,1.029,8.396,2557,556,2001,1.538,7.072,479,1.325,14.143,56,56,295
2019,3272,1297,1552,90392,89966,87,5.557,114,7.282,5814,1016,4798,1.129,6.462,4796,1669,3127,1.855,5.331,1018,1.132,10.662,83,83,613
2019,3273,3760,8537,177621,176188,501,5.897,420,4.943,21537,6690,14847,3.797,12.224,18655,5069,13586,2.877,10.588,2882,1.636,21.176,189,206,2567
2019,3274,143,292,14479,14428,10,3.413,12,4.096,1189,46,1143,0.319,8.241,1134,155,979,1.074,7.860,55,0.381,15.719,7,7,18
2019,3279,2619,3101,83809,82000,186,5.997,187,6.029,10689,1651,9038,2.013,13.035,7147,2373,4774,2.894,8.716,3542,4.320,17.432,133,133,935
2019,3311,266,405,89981,88478,45,11.335,29,7.305,6106,432,5674,0.488,6.901,3275,556,2719,0.628,3.701,2831,3.200,7.403,24,24,350
2019,3312,530,709,52519,51844,42,5.957,34,4.823,4935,1038,3897,2.002,9.519,3522,905,2617,1.746,6.794,1413,2.726,13.587,28,28,599
2019,3313,346,481,62831,61188,30,6.283,23,4.817,6174,1335,4839,2.182,10.090,3012,861,2151,1.407,4.923,3162,5.168,9.845,18,18,535
2019,3314,613,798,59436,58878,26,3.216,47,5.813,4666,779,3887,1.323,7.925,3516,973,2543,1.653,5.972,1150,1.953,11.943,38,38,692
2019,3315,1287,1477,121329,119322,51,3.415,84,5.624,10880,2215,8665,1.856,9.118,7002,2186,4816,1.832,5.868,3878,3.250,11.736,61,62,1021
2019,3321,1968,2222,109164,107054,73,3.271,92,4.123,10263,1177,9086,1.099,9.587,6066,1761,4305,1.645,5.666,4197,3.920,11.333,69,69,1201
2019,3322,940,1017,35023,34572,53,5.201,57,5.594,2926,967,1959,2.797,8.463,2065,539,1526,1.559,5.973,861,2.490,11.946,42,42,271
2019,3323,11796,12876,387666,381582,736,5.710,765,5.935,43625,10686,32939,2.800,11.433,31703,9020,22683,2.364,8.308,11922,3.124,16.617,576,578,5565
2019,3324,1136,1451,88990,88199,54,3.696,74,5.065,7949,1125,6824,1.276,9.013,6525,1923,4602,2.180,7.398,1424,1.615,14.796,53,53,702
2019,3325,524,565,28881,28644,24,4.229,29,5.110,1939,235,1704,0.820,6.769,1457,235,1222,0.820,5.087,482,1.683,10.173,22,22,122
2019,3326,900,1053,37979,38240,30,2.824,49,4.612,2739,362,2377,0.947,7.163,3235,819,2416,2.142,8.460,-496,-1.297,14.325,40,40,277
2019,3327,21124,21729,386269,383537,951,4.343,1286,5.873,36297,6304,29993,1.644,9.464,30665,8299,22366,2.164,7.995,5632,1.468,15.991,1023,1024,6208
2019,3328,4766,5331,132850,131467,188,3.494,288,5.352,13162,1912,11250,1.454,10.012,10526,3518,7008,2.676,8.007,2636,2.005,16.013,206,207,2169
2019,3329,5280,5808,259959,257270,403,6.947,389,6.706,25501,4300,21201,1.671,9.912,19863,6585,13278,2.560,7.721,5638,2.191,15.441,261,262,2274
2019,3331,2386,2783,196963,193037,155,5.565,160,5.744,19218,3152,16066,1.633,9.956,11420,2319,9101,1.201,5.916,7798,4.040,11.832,117,117,1158
2019,3332,2747,2932,112312,111037,161,5.493,159,5.425,10719,2167,8552,1.952,9.654,8030,1569,6461,1.413,7.232,2689,2.422,14.464,119,119,1109
2019,3333,1646,1782,74836,73987,107,5.984,119,6.655,7471,2901,4570,3.921,10.098,5561,1539,4022,2.080,7.516,1910,2.582,15.032,93,93,807
2019,3334,1350,1606,133114,131020,73,4.508,100,6.175,13980,3547,10433,2.707,10.670,9616,4001,5615,3.054,7.339,4364,3.331,14.679,74,74,1323
2019,3335,5810,6086,150098,149811,188,3.060,304,4.948,11306,2226,9080,1.486,7.547,10743,2455,8288,1.639,7.171,563,0.376,14.342,242,243,1715
2019,3336,752,951,101672,101670,40,4.173,55,5.738,6715,275,6440,0.270,6.605,6591,2775,3816,2.729,6.483,124,0.122,12.965,32,32,439
2019,3339,4947,5693,311595,308379,233,4.050,354,6.153,26551,2872,23679,0.931,8.610,20392,7138,13254,2.315,6.613,6159,1.997,13.225,178,179,2151
2019,3341,781,807,39457,39677,54,6.634,68,8.354,2436,193,2243,0.486,6.140,2835,592,2243,1.492,7.145,-399,-1.006,12.279,51,52,312
2019,3342,1042,1149,76538,77976,66,5.685,90,7.752,6721,2004,4717,2.570,8.619,9581,1309,8272,1.679,12.287,-2860,-3.668,17.239,74,74,650
2019,3343,407,425,9258,9127,39,9.231,34,8.047,935,208,727,2.279,10.245,664,317,347,3.473,7.276,271,2.969,14.551,26,26,283
2019,3344,3116,3584,264752,260275,183,5.069,236,6.536,24664,4053,20611,1.557,9.476,15892,4093,11799,1.573,6.106,8772,3.370,12.212,179,179,2685
2019,3345,4107,4914,394595,388470,296,6.003,329,6.673,36791,8054,28737,2.073,9.471,23856,5643,18213,1.453,6.141,12935,3.330,12.282,198,198,1593
2019,3346,343,350,6397,6561,25,7.072,32,9.052,535,158,377,2.408,8.155,854,114,740,1.738,13.017,-319,-4.862,16.310,26,26,100
2019,3351,945,999,42339,42208,69,6.795,102,10.044,3818,668,3150,1.583,9.046,3640,1762,1878,4.175,8.624,178,0.422,17.248,73,73,776
2019,3352,249,301,52052,52087,31,10.473,21,7.095,2828,623,2205,1.196,5.429,2981,304,2677,0.584,5.723,-153,-0.294,10.859,17,17,190
2019,3353,1616,1919,118798,117197,69,3.538,132,6.767,10219,981,9238,0.837,8.720,6925,3223,3702,2.750,5.909,3294,2.811,11.818,68,68,583
2019,3359,1687,1960,137006,135865,122,6.213,129,6.570,10340,2205,8135,1.623,7.610,8046,2708,5338,1.993,5.922,2294,1.688,11.844,93,93,1406
2019,3361,243,299,232895,221756,30,10.256,17,5.812,27415,1678,25737,0.757,12.363,5312,146,5166,0.066,2.395,22103,9.967,4.791,13,13,45
2019,3362,1524,1869,164848,166193,113,6.072,97,5.212,12566,2237,10329,1.346,7.561,15002,2622,12380,1.578,9.027,-2436,-1.466,15.122,69,69,773
2019,3363,3625,4689,615992,611191,210,4.466,236,5.019,48329,8239,40090,1.348,7.907,38940,6367,32573,1.042,6.371,9389,1.536,12.742,169,172,2207
2019,3364,1248,1799,386992,382426,121,6.645,165,9.061,25028,5881,19147,1.538,6.545,15699,3565,12134,0.932,4.105,9329,2.439,8.210,55,55,635
2019,3365,143,236,30834,29035,18,7.759,10,4.310,4411,732,3679,2.521,15.192,738,60,678,0.207,2.542,3673,12.650,5.084,5,5,52
2019,3366,1218,1345,136929,137622,97,7.156,118,8.705,8940,1808,7132,1.314,6.496,10107,3994,6113,2.902,7.344,-1167,-0.848,12.992,85,86,1952
2019,3369,739,766,34036,33641,70,9.044,86,11.111,3334,286,3048,0.850,9.911,2513,891,1622,2.649,7.470,821,2.440,14.940,63,63,676
2019,3371,9055,9311,222848,224605,621,6.597,827,8.785,17265,4019,13246,1.789,7.687,20391,6477,13914,2.884,9.079,-3126,-1.392,15.374,649,656,4714
2019,3372,3348,3494,114782,115472,162,4.596,224,6.355,9438,1623,7815,1.406,8.173,10882,3107,7775,2.691,9.424,-1444,-1.251,16.347,161,161,1032
2019,3379,582,684,31010,32076,41,6.025,34,4.996,2146,524,1622,1.634,6.690,4299,500,3799,1.559,13.403,-2153,-6.712,13.381,24,24,181
2019,3391,8127,9051,288613,286749,553,6.020,823,8.959,26476,6286,20190,2.192,9.233,22845,7414,15431,2.586,7.967,3631,1.266,15.934,652,653,3009
2019,3399,13401,14106,263392,265325,1156,8.151,1308,9.223,25835,6365,19470,2.399,9.737,29374,9473,19901,3.570,11.071,-3539,-1.334,19.474,919,925,5245
2019,4231,13929,22134,417447,413352,1256,5.656,1404,6.322,43453,11629,31824,2.813,10.512,34544,10938,23606,2.646,8.357,8909,2.155,16.714,955,976,5476
2019,4232,9780,11776,166246,165877,675,5.681,886,7.457,16750,4067,12683,2.452,10.098,15971,4879,11092,2.941,9.628,779,0.470,19.256,653,661,3497
2019,4233,9415,16977,262131,258692,1394,8.288,1078,6.409,33771,13015,20756,5.031,13.055,27175,10083,17092,3.898,10.505,6596,2.550,21.010,571,578,3711
2019,4234,20380,32805,642935,642274,2657,8.155,2213,6.792,61607,16587,45020,2.583,9.592,60549,17763,42786,2.766,9.427,1058,0.165,18.855,1548,1582,9292
2019,4235,6559,9030,152390,150980,397,4.378,473,5.216,14695,3272,11423,2.167,9.733,11712,3682,8030,2.439,7.757,2983,1.976,15.515,303,307,2071
2019,4236,16888,26500,517196,518123,1455,5.431,2041,7.618,56307,15804,40503,3.050,10.868,58569,17647,40922,3.406,11.304,-2262,-0.437,21.735,1188,1216,7242
2019,4237,9324,19053,261427,259426,789,4.143,771,4.049,25643,7162,18481,2.761,9.885,21500,5856,15644,2.257,8.288,4143,1.597,16.575,483,507,3061
2019,4238,36655,54105,785933,774975,2685,4.947,3032,5.586,82625,18114,64511,2.337,10.662,60620,20891,39729,2.696,7.822,22005,2.839,15.644,1894,1957,10790
2019,4239,25513,28807,326065,325162,2381,8.244,2527,8.750,39236,10464,28772,3.218,12.067,37230,14324,22906,4.405,11.450,2006,0.617,22.899,1958,1986,9070
2019,4241,6317,8441,147421,148167,336,3.915,619,7.212,10246,2342,7904,1.581,6.915,11653,3877,7776,2.617,7.865,-1407,-0.950,13.830,417,435,1900
2019,4242,6435,9758,303353,303008,843,8.703,700,7.227,28333,6412,21921,2.116,9.351,27585,5219,22366,1.722,9.104,748,0.247,18.207,504,508,2888
2019,4243,12233,13210,192109,193716,1115,8.339,1436,10.740,21667,4280,17387,2.209,11.185,25230,8355,16875,4.313,13.024,-3563,-1.839,22.370,1133,1145,4958
2019,4244,24930,32687,857965,857768,2590,7.907,2724,8.317,80004,24642,55362,2.873,9.327,79067,24078,54989,2.807,9.218,937,0.109,18.436,1858,1886,11793
2019,4245,3069,5883,62149,61181,322,5.495,275,4.693,7989,2342,5647,3.828,13.058,6070,1342,4728,2.193,9.921,1919,3.137,19.843,161,165,718
2019,4246,7299,11597,160259,160978,468,4.007,633,5.420,14474,3268,11206,2.030,8.991,15746,4024,11722,2.500,9.781,-1272,-0.790,17.983,420,434,2267
2019,4247,3647,6009,100754,99948,272,4.494,359,5.931,12639,2437,10202,2.438,12.646,10967,3175,7792,3.177,10.973,1672,1.673,21.945,177,191,1830
2019,4248,3229,4297,206097,203536,401,9.405,334,7.834,23808,9327,14481,4.582,11.697,18424,5465,12959,2.685,9.052,5384,2.645,18.104,230,239,2305
2019,4249,19000,25678,333147,333125,1712,6.609,2164,8.354,35449,7579,27870,2.275,10.641,35599,13782,21817,4.137,10.686,-150,-0.045,21.283,1455,1489,7255
2019,4251,30407,32593,272857,278240,3215,9.720,4182,12.643,30223,10243,19980,3.681,10.862,41565,12995,28570,4.670,14.939,-11342,-4.076,21.724,3316,3331,10232
2019,4411,36989,43533,1333583,1332992,3446,7.903,3590,8.233,113023,43239,69784,3.244,8.479,112373,39527,72846,2.965,8.430,650,0.049,16.860,2893,2944,33329
2019,4412,10863,12746,152878,152388,836,6.549,876,6.862,17157,7266,9891,4.768,11.259,16091,5179,10912,3.399,10.559,1066,0.700,21.119,678,682,4047
2019,4413,25378,56046,536364,530580,2668,4.775,2318,4.149,50853,14707,36146,2.772,9.584,38715,10308,28407,1.943,7.297,12138,2.288,14.593,1642,1698,7141
2019,4421,12220,22023,205009,206341,1611,7.314,1617,7.341,23255,10413,12842,5.047,11.270,25858,6824,19034,3.307,12.532,-2603,-1.262,22.540,1087,1171,5286
2019,4422,16705,24696,266818,264205,1403,5.618,1957,7.836,30517,8270,22247,3.130,11.551,24893,12181,12712,4.610,9.422,5624,2.129,18.844,1173,1204,3842
2019,4431,15147,25047,294899,300596,1410,5.507,2522,9.850,23889,6295,17594,2.094,7.947,34696,11449,23247,3.809,11.542,-10807,-3.595,15.894,1749,1855,7064
2019,4441,32410,54553,1183579,1193175,2446,4.471,2747,5.022,69044,16688,52356,1.399,5.787,87326,19391,67935,1.625,7.319,-18282,-1.532,11.573,1728,1804,9514
2019,4442,11818,16005,154485,154781,855,5.321,979,6.093,15535,4340,11195,2.804,10.037,16014,4189,11825,2.706,10.346,-479,-0.309,20.074,707,730,3095
2019,4451,60034,86272,2809251,2777988,7202,8.343,7304,8.461,243781,69684,174097,2.508,8.775,183955,58367,125588,2.101,6.622,59826,2.154,13.244,5605,5678,30939
2019,4452,16356,20144,162465,162334,2174,10.819,2075,10.326,26989,11117,15872,6.848,16.626,26595,12025,14570,7.408,16.383,394,0.243,32.766,1507,1569,7373
2019,4453,28363,32501,174453,174799,2392,7.376,2252,6.944,22820,8530,14290,4.880,13.055,23431,7450,15981,4.262,13.405,-611,-0.350,26.110,1761,1776,5785
2019,4461,39558,90207,1025706,1032215,6006,6.686,5256,5.851,97122,50086,47036,4.852,9.409,112628,30545,82083,2.959,10.911,-15506,-1.502,18.818,3236,3425,15735
2019,4471,61018,107911,992762,984838,6479,6.001,6585,6.099,128305,42613,85692,4.327,13.028,112690,33532,79158,3.405,11.442,15615,1.586,22.885,4619,4974,23031
2019,4481,31872,89016,1324320,1331709,5581,6.253,6064,6.794,125768,42073,83695,3.159,9.444,142755,46046,96709,3.458,10.720,-16987,-1.276,18.888,3348,3654,13703
2019,4482,4387,22230,222705,230875,709,3.137,1453,6.429,20201,7431,12770,3.219,8.750,35414,9935,25479,4.303,15.339,-15213,-6.589,17.500,420,553,1881
2019,4483,13703,20389,118899,119542,1143,5.554,1523,7.401,14455,4002,10453,3.348,12.092,15649,5879,9770,4.918,13.091,-1194,-0.999,24.184,927,957,2866
2019,4511,23155,33342,413910,435186,2378,7.025,3396,10.032,40466,13928,26538,3.200,9.299,86773,50724,36049,11.656,19.939,-46307,-10.641,18.597,2107,2177,7403
2019,4512,3053,6594,64404,67081,374,5.619,497,7.468,6959,1402,5557,2.090,10.374,12505,2703,9802,4.029,18.642,-5546,-8.268,20.748,265,271,1129
2019,4522,16,3847,425887,440989,11,0.276,277,6.960,10792,911,9881,0.207,2.447,40212,21611,18601,4.901,9.119,-29420,-6.671,4.894,6,263,20886
2019,4523,6962,49624,2307683,2261136,3023,6.184,1539,3.148,149313,34222,115091,1.513,6.603,63798,15990,47808,0.707,2.822,85515,3.782,5.643,773,786,3228
2019,4531,10610,11079,54518,55047,885,7.896,1142,10.190,8008,2676,5332,4.861,14.548,9051,3328,5723,6.046,16.442,-1043,-1.895,29.095,929,935,2730
2019,4532,15084,23608,204014,204988,1506,6.299,2108,8.817,24032,5914,18118,2.885,11.724,25956,8975,16981,4.378,12.662,-1924,-0.939,23.447,1523,1591,5892
2019,4533,11986,18192,202047,202451,1299,7.102,1495,8.174,23680,9166,14514,4.528,11.697,24646,5860,18786,2.895,12.174,-966,-0.477,23.393,1173,1186,3967
2019,4539,34365,46427,308490,301773,5278,11.546,3851,8.424,50681,21704,28977,7.192,16.794,37500,14180,23320,4.699,12.427,13181,4.368,24.853,2958,3044,11079
2019,4541,34810,36487,576554,562570,5804,16.176,4589,12.790,108381,36062,72319,6.410,19.265,80042,29087,50955,5.170,14.228,28339,5.037,28.456,3555,3559,13220
2019,4542,2720,3295,43243,42256,303,9.100,372,11.173,5418,1661,3757,3.931,12.822,3512,1246,2266,2.949,8.311,1906,4.511,16.623,309,312,1087
2019,4543,21525,26839,181253,180477,2664,9.949,2539,9.482,24635,8726,15909,4.835,13.650,22869,10070,12799,5.580,12.671,1766,0.979,25.343,1860,1871,7073
2019,4811,390,2146,456965,446672,155,7.311,103,4.858,39097,3461,35636,0.775,8.753,17902,1046,16856,0.234,4.008,21195,4.745,8.016,35,38,249
2019,4812,1726,1967,44327,43172,239,12.244,209,10.707,5103,1004,4099,2.326,11.820,2803,863,1940,1.999,6.493,2300,5.328,12.985,161,163,624
2019,4831,605,907,42549,42566,114,12.486,126,13.801,4549,851,3698,1.999,10.687,4631,1234,3397,2.899,10.880,-82,-0.193,21.374,57,57,211
2019,4832,442,506,20162,19646,67,13.618,39,7.927,1878,182,1696,0.926,9.559,892,168,724,0.855,4.540,986,5.019,9.081,28,28,109
2019,4841,62603,74021,1077125,1046798,13836,19.331,8941,12.492,162589,57213,105376,5.466,15.532,103361,33923,69438,3.241,9.874,59228,5.658,19.748,6578,6592,21442
2019,4842,40268,44001,503515,499388,5465,12.493,4954,11.325,69043,20942,48101,4.194,13.826,60924,21080,39844,4.221,12.200,8119,1.626,24.399,3625,3706,15382
2019,4851,405,680,55358,55588,48,6.987,62,9.025,3103,814,2289,1.464,5.582,3566,980,2586,1.763,6.415,-463,-0.833,11.164,44,44,407
2019,4852,282,587,18460,18257,40,6.791,44,7.470,3357,1850,1507,10.133,18.388,2914,355,2559,1.945,15.961,443,2.427,31.923,15,15,56
2019,4853,6496,6693,71943,72655,1068,15.933,1088,16.232,11302,4068,7234,5.599,15.556,12753,4462,8291,6.141,17.553,-1451,-1.997,31.111,898,902,3619
2019,4854,2449,4174,235595,234858,227,5.453,205,4.924,19957,6121,13836,2.606,8.497,18541,5359,13182,2.282,7.895,1416,0.603,15.789,143,145,2973
2019,4855,1014,1138,30956,31910,72,6.196,120,10.327,2451,428,2023,1.341,7.681,4526,1409,3117,4.416,14.184,-2075,-6.503,15.362,90,93,1112
2019,4859,4447,4910,100266,99157,822,17.091,621,12.912,15491,6877,8614,6.936,15.623,13297,5554,7743,5.601,13.410,2194,2.213,26.820,496,501,4414
2019,4861,77,722,11343,12073,14,1.884,56,7.537,761,133,628,1.102,6.304,2145,1098,1047,9.095,17.768,-1384,-11.464,12.607,8,8,95
2019,4862,107,1974,27254,26724,56,2.846,43,2.186,2681,1126,1555,4.214,10.032,1719,384,1335,1.437,6.433,962,3.600,12.865,9,9,106
2019,4869,74,670,8577,8464,18,2.669,27,4.003,764,63,701,0.744,9.027,506,136,370,1.607,5.979,258,3.048,11.957,6,6,8
2019,4871,612,653,11093,11380,90,13.997,70,10.886,1388,427,961,3.752,12.197,1981,498,1483,4.376,17.408,-593,-5.211,24.394,56,59,423
2019,4872,1352,1405,14962,14992,195,14.059,159,11.464,2133,648,1485,4.322,14.228,2141,515,1626,3.435,14.281,-8,-0.053,28.455,104,104,414
2019,4879,197,228,3549,3509,24,10.714,16,7.143,369,55,314,1.568,10.517,296,53,243,1.511,8.437,73,2.081,16.873,11,11,28
2019,4881,3924,5830,225314,217480,432,7.462,351,6.063,29250,7048,22202,3.241,13.450,13323,3754,9569,1.726,6.126,15927,7.323,12.252,234,236,1965
2019,4882,526,1400,42157,41951,127,8.925,173,12.157,5910,1391,4519,3.316,14.088,5538,2196,3342,5.235,13.201,372,0.887,26.402,49,78,1114
2019,4883,1809,2396,102692,100322,146,6.072,163,6.779,11634,3716,7918,3.704,11.597,7004,1085,5919,1.082,6.982,4630,4.615,13.963,97,97,565
2019,4884,9934,11597,113975,109310,1409,12.300,1125,9.821,22409,6260,16149,5.727,20.501,12891,4874,8017,4.459,11.793,9518,8.707,23.586,801,814,3393
2019,4885,13742,19950,293468,280968,1693,8.547,1407,7.104,49857,15595,34262,5.550,17.745,25136,9092,16044,3.236,8.946,24721,8.799,17.892,907,935,5003
2019,4889,1514,1617,19219,18751,252,15.874,193,12.157,3635,1716,1919,9.152,19.386,2590,1415,1175,7.546,13.813,1045,5.573,27.625,154,157,1334
2019,4921,3754,9477,779529,699564,653,6.915,586,6.205,171481,10884,160597,1.556,24.513,15622,5407,10215,0.773,2.233,155859,22.279,4.466,426,434,3749
2019,4922,3345,3937,76060,65774,516,13.072,537,13.604,29982,17122,12860,26.032,45.584,9802,5259,4543,7.996,14.903,20180,30.681,29.805,432,439,4241
2019,4931,7765,16762,1098509,1034872,1458,8.830,958,5.802,213740,39162,174578,3.784,20.654,84175,21686,62489,2.096,8.134,129565,12.520,16.268,391,395,5745
2019,5111,10031,14222,317311,332469,1068,7.455,1277,8.914,19726,5950,13776,1.790,5.933,50101,12405,37696,3.731,15.069,-30375,-9.136,11.866,868,895,5855
2019,5112,9559,12824,652293,638211,1870,14.823,1453,11.518,88986,22122,66864,3.466,13.943,60826,21379,39447,3.350,9.531,28160,4.412,19.061,936,944,8212
2019,5121,14744,17997,301473,302481,2798,15.820,2178,12.314,42668,18129,24539,5.993,14.106,44866,11073,33793,3.661,14.833,-2198,-0.727,28.212,1364,1380,6469
2019,5122,2844,3049,22860,23021,455,15.101,383,12.712,2717,1209,1508,5.252,11.803,3087,1278,1809,5.552,13.410,-370,-1.607,23.605,264,264,996
2019,5151,3659,7007,211528,205837,403,5.721,478,6.785,32286,8148,24138,3.958,15.685,21048,5878,15170,2.856,10.226,11238,5.460,20.451,230,243,2110
2019,5152,347,906,53253,52120,307,39.059,67,8.524,9582,6357,3225,12.197,18.384,7508,2514,4994,4.823,14.405,2074,3.979,28.810,21,35,2169
2019,5173,7315,56372,1008693,1035813,5935,10.568,5515,9.820,132373,50256,82117,4.852,12.780,187483,36292,151191,3.504,18.100,-55110,-5.320,25.559,906,1045,5236
2019,5174,271,346,7930,8080,50,14.104,67,18.900,977,390,587,4.827,12.092,1293,805,488,9.963,16.003,-316,-3.911,24.185,35,35,138
2019,5179,2734,4082,60219,58649,908,23.493,474,12.264,12447,6107,6340,10.413,21.223,9520,3802,5718,6.483,16.232,2927,4.991,32.464,290,293,1819
2019,5182,9435,16197,554504,553022,1371,8.412,1575,9.663,77819,23330,54489,4.219,14.072,74462,31512,42950,5.698,13.465,3357,0.607,26.929,837,862,8436
2019,5191,8814,10967,336065,324395,1510,13.965,1202,11.116,63481,18940,44541,5.839,19.569,39980,10163,29817,3.133,12.324,23501,7.245,24.649,844,850,5085
2019,5211,14,59,19991,19888,D,D,D,D,380,D,356,D,1.911,178,D,177,D,0.895,202,1.016,1.790,0,0,0
2019,5221,10008,114653,1949891,1948058,3331,2.894,4231,3.676,161981,31436,130545,1.614,8.315,159152,29991,129161,1.540,8.170,2829,0.145,16.340,306,533,5247
2019,5222,12662,43781,604274,614048,4151,9.486,4112,9.396,77199,29215,47984,4.758,12.572,96619,36013,60606,5.865,15.735,-19420,-3.163,25.144,1095,1242,6805
2019,5223,11386,25808,309823,305496,3054,11.933,2624,10.253,62039,33833,28206,11.075,20.308,54640,21112,33528,6.911,17.886,7399,2.422,35.771,950,980,4191
2019,5231,8895,26740,350565,354266,2086,7.711,2708,10.011,27507,5466,22041,1.543,7.765,34868,12196,22672,3.443,9.842,-7361,-2.078,15.529,736,751,2446
2019,5232,11,31,9404,9626,D,D,D,D,448,D,357,D,4.654,871,D,861,D,9.049,-423,-4.395,9.309,0,0,0
2019,5239,46760,66605,572240,568619,6339,9.604,5131,7.774,70851,24791,46060,4.360,12.460,64092,21768,42324,3.828,11.272,6759,1.189,22.543,3656,3674,12950
2019,5241,4707,29752,1567198,1555274,3508,11.388,5614,18.224,209630,65906,143724,4.238,13.479,184901,69411,115490,4.463,11.889,24729,1.590,23.777,333,340,3789
2019,5242,118474,137935,1139119,1113384,13323,9.724,11466,8.369,186437,90713,95724,8.148,16.745,132154,48794,83360,4.382,11.870,54283,4.875,23.739,8255,8320,27993
2019,5259,1043,1098,7665,7882,276,26.025,201,18.953,2348,1056,1292,13.398,29.789,2801,1790,1011,22.710,35.537,-453,-5.747,59.579,164,164,1655
2019,5311,87326,119061,602541,597759,11385,9.617,10027,8.470,96937,44965,51972,7.522,16.217,88717,35482,53235,5.936,14.842,8220,1.375,29.683,7225,7347,23251
2019,5312,86857,102488,349658,345630,16514,16.481,11938,11.914,60375,34130,26245,9.875,17.468,52901,23257,29644,6.729,15.306,7474,2.162,30.611,6654,6727,12769
2019,5313,70778,89011,722703,715244,10057,11.415,8242,9.355,100906,41055,59851,5.740,14.108,86214,34644,51570,4.844,12.054,14692,2.054,24.108,5174,5304,20152
2019,5321,3431,15497,177736,175170,1205,7.768,1234,7.955,24439,7518,16921,4.292,13.952,19762,8612,11150,4.916,11.282,4677,2.670,22.563,337,352,1589
2019,5322,6656,15824,131354,131393,860,5.308,1616,9.974,18302,4501,13801,3.426,13.929,18327,9022,9305,6.866,13.948,-25,-0.019,27.859,669,718,3864
2019,5323,2056,2844,19546,19510,218,7.547,307,10.628,2404,812,1592,4.162,12.322,2377,1000,1377,5.126,12.183,27,0.138,24.367,106,111,557
2019,5324,7511,14809,200149,196038,1046,7.116,827,5.626,25375,5941,19434,3.031,12.944,17160,5411,11749,2.760,8.753,8215,4.191,17.507,534,542,3709
2019,5331,2170,2344,35481,37128,258,11.009,257,10.967,4535,1350,3185,3.636,12.215,7555,1350,6205,3.636,20.349,-3020,-8.134,24.429,179,182,1065
2019,5411,154191,166536,1148474,1147767,12407,7.434,13106,7.853,115168,33159,82009,2.889,10.034,113577,36728,76849,3.200,9.895,1591,0.139,19.791,10033,10133,26531
2019,5412,99613,119438,1156970,1152099,9574,8.016,9557,8.002,129144,35087,94057,3.045,11.209,120840,44548,76292,3.867,10.489,8304,0.721,20.977,6346,6437,27155
2019,5413,82357,102720,1568776,1549310,9090,8.893,8082,7.907,206986,63200,143786,4.079,13.360,168897,51019,117878,3.293,10.901,38089,2.458,21.803,5177,5238,23480
2019,5414,27370,27767,122713,122441,3812,13.818,3454,12.520,19629,8331,11298,6.804,16.031,18848,8138,10710,6.646,15.394,781,0.638,30.787,2488,2491,6177
2019,5415,99007,119295,1926043,1909310,16375,13.775,15542,13.074,267167,76906,190261,4.028,13.993,232502,81527,150975,4.270,12.177,34665,1.816,24.355,10982,11046,46343
2019,5416,134320,145200,1380388,1350818,26525,18.617,21085,14.799,255611,94172,161439,6.971,18.923,198751,85771,112980,6.350,14.713,56860,4.209,29.427,15135,15169,52541
2019,5417,14196,17654,764388,754366,2257,12.950,1806,10.362,92329,18849,73480,2.499,12.239,73452,19464,53988,2.580,9.737,18877,2.502,19.474,1198,1222,7331
2019,5418,28467,32445,469930,480036,3320,10.189,3601,11.051,49768,14516,35252,3.024,10.368,69862,23961,45901,4.992,14.554,-20094,-4.186,20.735,2604,2631,13914
2019,5419,56250,64236,700401,686442,7895,12.461,6134,9.682,110803,42083,68720,6.131,16.142,84215,36461,47754,5.312,12.268,26588,3.873,24.537,4468,4509,26174
2019,5511,25235,51599,3499834,3505788,2105,4.005,4029,7.665,378695,66456,312239,1.896,10.802,394270,96153,298117,2.743,11.246,-15575,-0.444,21.604,698,731,14175
2019,5611,26982,30166,519969,510175,3796,12.721,3147,10.546,88649,31393,57256,6.153,17.376,69280,26528,42752,5.200,13.580,19369,3.797,27.159,2288,2317,18698
2019,5612,1995,7554,294098,281947,1775,26.088,275,4.042,44494,25385,19109,9.003,15.781,21375,5535,15840,1.963,7.581,23119,8.200,15.162,123,127,3059
2019,5613,24655,49540,6096884,5997668,4935,10.010,4452,9.031,953788,182546,771242,3.044,15.903,756385,172345,584040,2.874,12.611,197403,3.291,25.223,2255,2289,63207
2019,5614,20880,28158,795489,803009,2587,9.164,2729,9.667,109879,38749,71130,4.825,13.683,126734,36490,90244,4.544,15.782,-16855,-2.099,27.367,1942,1973,14484
2019,5615,12519,16179,225780,223225,1427,8.778,1582,9.731,25940,7551,18389,3.383,11.621,20889,7862,13027,3.522,9.358,5051,2.263,18.716,975,981,5291
2019,5616,18396,23663,1010613,999050,3028,12.904,2635,11.229,178463,92628,85835,9.272,17.863,154337,82951,71386,8.303,15.448,24126,2.415,30.897,1435,1478,16727
2019,5617,159931,168954,2027094,2008367,22909,13.722,18910,11.326,316866,103591,213275,5.158,15.777,279332,93459,185873,4.653,13.908,37534,1.869,27.817,13370,13418,61052
2019,5619,15839,17847,304546,300454,1810,10.210,1573,8.873,40591,11239,29352,3.741,13.510,32836,11778,21058,3.920,10.929,7755,2.581,21.858,1144,1155,7195
2019,5621,7258,11167,229891,226716,667,5.963,705,6.303,21215,4585,16630,2.022,9.358,15051,7437,7614,3.280,6.639,6164,2.719,13.277,519,532,4652
2019,5622,1220,2545,59424,59035,123,4.843,112,4.410,4708,1174,3534,1.989,7.975,3889,1442,2447,2.443,6.588,819,1.387,13.175,78,78,802
2019,5629,8935,10499,148422,145272,945,9.087,746,7.173,23331,6006,17325,4.134,16.060,17174,5175,11999,3.562,11.822,6157,4.238,23.644,534,540,3625
2019,6111,18925,21817,1097335,1089343,909,4.174,830,3.811,79171,20365,58806,1.869,7.268,63182,19718,43464,1.810,5.800,15989,1.468,11.600,600,622,14990
2019,6112,413,780,59100,60317,19,2.349,77,9.518,4304,144,4160,0.239,7.136,6856,2949,3907,4.889,11.367,-2552,-4.231,14.271,21,28,981
2019,6113,2379,3994,1899010,1890323,123,2.959,448,10.778,79693,2627,77066,0.139,4.216,62854,7056,55798,0.373,3.325,16839,0.891,6.650,79,82,1727
2019,6114,6691,7099,72010,68726,894,12.592,895,12.607,14902,4164,10738,6.059,21.683,8138,2976,5162,4.330,11.841,6764,9.842,23.683,596,608,1995
2019,6115,6184,7633,104153,104303,719,9.477,626,8.251,14975,4532,10443,4.345,14.357,15143,5174,9969,4.961,14.518,-168,-0.161,28.714,425,454,2334
2019,6116,44635,48085,466909,456390,5815,12.260,4506,9.500,83064,30612,52452,6.707,18.200,61706,21415,40291,4.692,13.520,21358,4.680,27.041,3376,3423,17009
2019,6117,7245,8062,105888,103871,1427,18.134,1041,13.229,20259,9970,10289,9.598,19.504,16736,4815,11921,4.636,16.112,3523,3.392,32.225,744,751,2960
2019,6211,150364,204553,2557742,2518399,18032,8.845,16656,8.170,364051,151114,212937,6.000,14.456,283024,114602,168422,4.551,11.238,81027,3.217,22.477,10973,11322,59237
2019,6212,117329,129694,975311,967035,8044,6.212,7640,5.900,131333,49403,81930,5.109,13.581,114269,37965,76304,3.926,11.816,17064,1.765,23.633,6445,6514,32586
2019,6213,126724,149938,956742,933235,14485,9.792,10452,7.066,155887,53142,102745,5.694,16.704,108786,40954,67832,4.388,11.657,47101,5.047,23.314,7551,7729,27190
2019,6214,18240,46531,1168813,1151616,4125,9.047,2252,4.939,147521,54594,92927,4.741,12.810,113611,32396,81215,2.813,9.865,33910,2.945,19.731,1035,1090,12163
2019,6215,6492,17186,285696,288570,1739,10.149,1638,9.559,33869,8597,25272,2.979,11.737,40121,12352,27769,4.280,13.903,-6252,-2.167,23.474,668,688,4707
2019,6216,21845,31496,1526694,1496709,3329,10.634,2945,9.408,219769,67797,151972,4.530,14.683,160580,41500,119080,2.773,10.729,59189,3.955,21.458,1896,1931,26114
2019,6219,6382,11494,343884,339481,1077,9.501,761,6.713,38661,10925,27736,3.218,11.388,29849,8651,21198,2.548,8.793,8812,2.596,17.585,477,506,5188
2019,6221,2422,5371,5537663,5522860,152,2.839,117,2.185,204830,17658,187172,0.320,3.709,181976,67126,114850,1.215,3.295,22854,0.414,6.590,30,34,11078
2019,6222,422,699,251206,248118,20,2.894,4,0.579,11659,4290,7369,1.729,4.699,5477,173,5304,0.070,2.207,6182,2.492,4.415,3,3,149
2019,6223,296,756,239170,241712,22,2.859,49,6.368,9555,919,8636,0.380,3.953,14936,7527,7409,3.114,6.179,-5381,-2.226,7.906,13,14,3780
2019,6231,8929,16512,1619513,1620664,1086,6.626,841,5.131,145942,71199,74743,4.393,9.005,147777,54863,92914,3.385,9.118,-1835,-0.113,18.010,476,499,30432
2019,6232,10402,42952,792574,794226,2656,6.247,1789,4.208,86588,25437,61151,3.203,10.902,89817,19292,70525,2.429,11.309,-3229,-0.407,21.804,464,510,5982
2019,6233,16746,24582,997980,988660,2159,8.853,1770,7.258,105634,43918,61716,4.442,10.685,88332,33538,54794,3.392,8.935,17302,1.750,17.869,1243,1255,18978
2019,6239,3036,5474,124655,123213,1003,19.374,409,7.900,15633,6122,9511,4.969,12.688,12487,3574,8913,2.901,10.134,3146,2.553,20.269,187,189,1533
2019,6241,56951,76364,1938695,1907108,9332,12.544,5393,7.249,251247,64991,186256,3.408,13.174,188952,44870,144082,2.353,9.908,62295,3.266,19.816,3462,3500,25339
2019,6242,10402,14586,213409,206412,896,6.211,578,4.006,31010,11097,19913,5.376,15.023,16303,3982,12321,1.929,7.898,14707,7.125,15.797,287,324,2215
2019,6243,3767,7157,271038,276757,456,6.409,371,5.215,28187,7507,20680,2.712,10.185,39986,7638,32348,2.760,14.448,-11799,-4.263,20.370,141,145,1317
2019,6244,56702,72783,1002674,993397,6275,8.650,5793,7.986,123879,43632,80247,4.392,12.470,104942,37718,67224,3.797,10.564,18937,1.906,21.128,4173,4340,28460
2019,7111,7631,7761,126776,124962,983,12.898,704,9.237,19934,5810,14124,4.649,15.952,16202,4646,11556,3.718,12.966,3732,2.987,25.931,495,495,3408
2019,7112,3252,3440,137817,135291,516,15.260,399,11.799,17872,4796,13076,3.545,13.210,12785,2973,9812,2.197,9.450,5087,3.760,18.900,314,314,2556
2019,7113,6635,7179,199552,197510,816,11.540,600,8.485,22237,5370,16867,2.719,11.259,18187,2553,15634,1.293,9.208,4050,2.051,18.416,442,443,1961
2019,7114,3251,3389,23096,22822,503,15.073,399,11.957,3190,1131,2059,4.956,13.978,2672,987,1685,4.325,11.708,518,2.270,23.417,291,292,721
2019,7115,18564,18611,57060,55318,3778,20.774,2928,16.100,15249,7737,7512,13.986,27.566,11785,6150,5635,11.118,21.304,3464,6.262,42.608,1828,1830,3680
2019,7121,6810,7297,160040,158904,365,5.037,265,3.657,11072,1874,9198,1.179,6.968,8869,1273,7596,0.801,5.581,2203,1.386,11.163,172,172,982
2019,7131,2853,3306,207605,206725,515,15.793,425,13.033,19921,8909,11012,4.310,9.636,18712,4628,14084,2.239,9.052,1209,0.585,18.103,361,361,4165
2019,7132,1799,2973,137318,136212,226,7.629,205,6.920,8975,3821,5154,2.805,6.589,6871,1971,4900,1.447,5.044,2104,1.545,10.089,150,157,1512
2019,7139,56606,66595,1423570,1404900,7954,12.109,6133,9.337,198984,74350,124634,5.292,14.164,160950,53713,107237,3.823,11.456,38034,2.707,22.913,4648,4717,41111
2019,7211,42976,54558,2101253,2081926,4857,8.946,4321,7.959,229792,94336,135456,4.531,11.037,190184,77927,112257,3.743,9.135,39608,1.902,18.270,3039,3097,46686
2019,7212,5551,6204,48521,48263,523,8.472,461,7.468,6860,2309,4551,4.784,14.214,6357,1593,4764,3.301,13.172,503,1.042,26.343,305,306,1170
2019,7213,1540,1720,10738,10228,146,8.319,216,12.308,3236,1957,1279,19.134,31.639,2140,976,1164,9.542,20.923,1096,10.716,41.846,161,166,794
2019,7223,17199,42670,848350,836027,5890,14.268,3112,7.539,118260,52114,66146,6.234,14.145,94395,28743,65652,3.438,11.291,23865,2.855,22.582,1966,2024,11023
2019,7224,35722,36572,381771,376455,3608,9.862,3632,9.928,68849,31317,37532,8.319,18.289,58269,23571,34698,6.261,15.478,10580,2.810,30.957,3003,3013,20262
2019,7225,388559,535871,11102138,11052086,54090,10.168,46286,8.701,1550668,748738,801930,6.775,14.031,1444506,530054,914452,4.796,13.070,106162,0.961,26.140,36171,37134,386257
2019,8111,134608,150401,932313,929196,12489,8.307,12357,8.220,125875,50960,74915,5.484,13.547,120227,45442,74785,4.890,12.939,5648,0.608,25.878,9454,9594,36036
2019,8112,9664,10967,100286,100468,1003,9.056,1220,11.015,12760,4049,8711,4.030,12.701,13342,5951,7391,5.923,13.280,-582,-0.579,25.401,902,948,3550
2019,8113,18246,20016,204748,203231,1593,7.943,1670,8.327,27954,7414,20540,3.648,13.755,24692,10457,14235,5.145,12.150,3262,1.605,24.299,1223,1227,4799
2019,8114,17754,18556,72453,72611,2233,12.102,2024,10.969,11556,5097,6459,7.020,15.915,11877,5365,6512,7.389,16.357,-321,-0.442,31.830,1514,1518,3637
2019,8121,108983,125017,762120,749651,16770,13.643,12578,10.233,134234,65806,68428,8.778,17.906,109762,47142,62620,6.289,14.642,24472,3.264,29.284,9658,9824,35475
2019,8122,13814,19759,134033,134355,635,3.204,750,3.785,10822,2282,8540,1.698,8.055,11346,3036,8310,2.260,8.445,-524,-0.390,16.110,504,512,2031
2019,8123,25633,30686,281826,282726,2101,6.790,2612,8.442,28201,10587,17614,3.745,9.975,30118,10931,19187,3.866,10.653,-1917,-0.678,19.949,2148,2202,9227
2019,8129,34207,43902,362690,353987,6231,14.509,4319,10.057,64250,25146,39104,7.104,18.150,46363,17924,28439,5.063,13.097,17887,5.053,26.195,3140,3162,12947
2019,8131,179019,179835,1687004,1691630,7421,4.126,7443,4.139,123418,21031,102387,1.243,7.296,132350,20923,111427,1.237,7.824,-8932,-0.528,14.592,5035,5035,14351
2019,8132,17638,19538,197966,196995,1551,7.998,1262,6.507,22563,6934,15629,3.520,11.454,20511,6757,13754,3.430,10.412,2052,1.042,20.824,816,817,2959
2019,8133,15076,17923,182854,183769,1558,8.821,1037,5.871,21590,5030,16560,2.737,11.748,23795,4196,19599,2.283,12.948,-2205,-1.200,23.497,684,688,2819
2019,8134,22419,24004,220700,219878,1486,6.199,1424,5.940,23756,5371,18385,2.443,10.804,22331,5148,17183,2.341,10.156,1425,0.648,20.312,1004,1013,3664
2019,8139,51553,53731,487310,490267,2246,4.143,3207,5.916,40976,8803,32173,1.796,8.358,46732,12695,34037,2.589,9.532,-5756,-1.174,16.716,2347,2349,8944
2020,1131,391,414,3608,3602,42,10.108,45,10.830,352,120,232,3.331,9.772,333,88,245,2.443,9.245,19,0.527,18.490,36,36,67
2020,1132,133,148,978,1005,21,14.533,14,9.689,128,60,68,5.973,12.743,177,46,131,4.579,17.621,-49,-4.878,25.485,9,9,40
2020,1133,6743,6814,46109,46737,569,8.247,740,10.725,5528,1588,3940,3.398,11.828,6805,2091,4714,4.474,14.560,-1277,-2.732,23.656,509,509,1513
2020,1141,1298,1311,5290,5407,198,14.831,246,18.427,890,528,362,9.765,16.460,1131,611,520,11.300,20.917,-241,-4.457,32.920,137,137,390
2020,1142,307,308,1742,1704,28,9.165,23,7.529,235,63,172,3.697,13.791,155,46,109,2.700,9.096,80,4.695,18.192,14,14,22
2020,1151,3880,4232,73275,71597,504,12.056,401,9.592,12960,4018,8942,5.612,18.101,9407,2940,6467,4.106,13.139,3553,4.962,26.278,296,296,1969
2020,1152,3990,4071,21809,21483,492,12.053,514,12.592,3793,1513,2280,7.043,17.656,3127,1248,1879,5.809,14.556,666,3.100,29.112,380,380,889
2020,1153,1363,1492,13690,13390,177,11.927,161,10.849,2487,624,1863,4.660,18.574,1917,703,1214,5.250,14.317,570,4.257,28.633,89,89,426
2020,2111,4164,5344,100927,104398,364,6.636,647,11.795,10418,3617,6801,3.465,9.979,17335,5330,12005,5.105,16.605,-6917,-6.626,19.958,394,421,2367
2020,2121,321,553,43630,46489,29,4.919,102,17.303,4184,1669,2515,3.590,9.000,9984,3856,6128,8.295,21.476,-5800,-12.476,18.000,32,32,1044
2020,2122,192,256,39270,38134,27,10.651,22,8.679,3602,193,3409,0.506,9.446,1409,107,1302,0.281,3.695,2193,5.751,7.390,15,15,39
2020,2123,2489,4738,88227,88578,320,6.790,270,5.729,9677,2933,6744,3.311,10.925,10335,2119,8216,2.392,11.668,-658,-0.743,21.850,124,128,949
2020,2131,9051,11431,307385,324166,1139,9.757,1625,13.920,44740,14807,29933,4.568,13.802,78627,26084,52543,8.047,24.255,-33887,-10.454,27.603,1013,1050,8866
2020,2211,1874,11622,500599,501903,591,5.138,353,3.069,30016,7176,22840,1.430,5.980,32487,5950,26537,1.185,6.473,-2471,-0.492,11.961,79,80,1677
2020,2212,394,2434,89882,91363,110,4.500,131,5.359,4859,1650,3209,1.806,5.318,7822,2422,5400,2.651,8.561,-2963,-3.243,10.637,17,17,213
2020,2213,3500,4627,46464,46194,226,4.860,273,5.870,4006,1188,2818,2.572,8.672,3454,1303,2151,2.821,7.477,552,1.195,14.954,146,148,469
2020,2361,152836,154523,785311,770232,27109,17.776,23074,15.130,166258,72832,93426,9.456,21.585,135731,59144,76587,7.679,17.622,30527,3.963,35.244,15680,15686,41064
2020,2362,36794,38425,714176,706730,3223,8.340,3665,9.484,104347,24177,80170,3.421,14.765,89257,20900,68357,2.957,12.630,15090,2.135,25.259,2599,2606,14020
2020,2371,16111,17856,633096,636980,1415,7.926,1408,7.887,90675,20834,69841,3.271,14.235,98367,18018,80349,2.829,15.443,-7692,-1.208,28.470,965,975,9569
2020,2372,3792,3906,21967,21748,356,9.082,384,9.796,3424,1225,2199,5.633,15.744,3030,1272,1758,5.849,13.933,394,1.812,27.865,300,301,1013
2020,2373,7758,8644,313341,308394,498,5.733,582,6.700,38919,4351,34568,1.411,12.620,28820,5222,23598,1.693,9.345,10099,3.275,18.690,370,372,2741
2020,2379,3788,3906,78946,76422,426,11.029,339,8.777,14426,3890,10536,5.090,18.877,9502,2237,7265,2.927,12.434,4924,6.443,24.867,220,220,964
2020,2381,81415,82543,915247,905989,10405,12.666,9617,11.707,160480,41892,118588,4.624,17.713,142515,39412,103103,4.350,15.730,17965,1.983,31.461,6324,6329,27102
2020,2382,166505,171878,2191364,2170066,16003,9.340,14927,8.712,298170,74472,223698,3.432,13.740,256203,70819,185384,3.263,11.806,41967,1.934,23.612,10376,10433,48994
2020,2383,103216,104681,843729,843781,13338,12.747,13248,12.661,135966,41066,94900,4.867,16.114,136115,43133,92982,5.112,16.132,-149,-0.018,32.228,8999,9002,30613
2020,2389,61492,62389,688238,674948,7645,12.377,6404,10.368,111977,28837,83140,4.272,16.590,85439,25308,60131,3.750,12.659,26538,3.932,25.317,4218,4218,16323
2020,3111,1114,1759,57407,56850,98,5.618,69,3.955,6512,3060,3452,5.383,11.455,5495,899,4596,1.581,9.666,1017,1.789,19.332,43,43,360
2020,3112,533,902,57245,57605,79,8.901,50,5.634,5146,1348,3798,2.340,8.933,5974,913,5061,1.585,10.371,-828,-1.437,17.867,33,33,343
2020,3113,1586,1763,83220,82621,116,6.526,145,8.158,8309,2293,6016,2.775,10.057,7031,1442,5589,1.745,8.510,1278,1.547,17.020,114,114,900
2020,3114,1455,1821,161611,161322,142,7.762,159,8.691,14116,3736,10380,2.316,8.750,13577,3614,9963,2.240,8.416,539,0.334,16.832,111,112,862
2020,3115,1079,1589,153506,151885,100,6.315,89,5.620,9971,1702,8269,1.121,6.565,6718,908,5810,0.598,4.423,3253,2.142,8.846,61,61,579
2020,3116,2586,3249,542908,536546,157,4.784,222,6.765,39633,4947,34686,0.922,7.387,27480,5023,22457,0.936,5.122,12153,2.265,10.243,160,162,2966
2020,3117,412,508,30204,30643,29,5.681,34,6.660,2416,706,1710,2.304,7.884,3361,491,2870,1.602,10.968,-945,-3.084,15.769,25,25,80
2020,3118,10238,11082,297908,296656,1155,10.492,1007,9.148,31118,9433,21685,3.180,10.490,28829,8093,20736,2.728,9.718,2289,0.772,19.436,777,778,5528
2020,3119,3416,3952,228784,226511,460,11.854,317,8.169,25000,6560,18440,2.896,11.037,20309,4689,15620,2.070,8.966,4691,2.071,17.932,225,226,2710
2020,3121,9328,10143,252846,246624,1217,12.311,702,7.101,38681,9142,29539,3.707,15.684,26700,6713,19987,2.722,10.826,11981,4.858,21.652,495,496,3451
2020,3122,106,128,11325,12016,6,4.580,12,9.160,514,31,483,0.258,4.278,1934,162,1772,1.348,16.096,-1420,-11.818,8.556,10,10,81
2020,3131,208,254,18918,20136,29,11.485,26,10.297,2681,1341,1340,6.660,13.315,5051,1645,3406,8.170,25.085,-2370,-11.770,26.630,13,13,326
2020,3132,694,776,43264,44312,47,6.033,53,6.804,2808,643,2165,1.451,6.337,4868,912,3956,2.058,10.986,-2060,-4.649,12.674,40,40,484
2020,3133,717,757,24540,25170,76,10.093,68,9.031,1964,674,1290,2.678,7.803,3245,644,2601,2.559,12.893,-1281,-5.089,15.606,55,55,534
2020,3141,1279,1372,49592,48665,61,4.317,143,10.120,7199,565,6634,1.161,14.793,5256,845,4411,1.736,10.800,1943,3.993,21.601,107,107,548
2020,3149,3490,3590,57925,57963,248,6.826,334,9.194,6472,1783,4689,3.076,11.166,6446,1317,5129,2.272,11.121,26,0.045,22.242,250,250,938
2020,3151,180,187,9397,9707,10,5.305,13,6.897,750,57,693,0.587,7.727,1350,330,1020,3.400,13.908,-600,-6.181,15.454,9,9,84
2020,3152,3676,3734,56444,59371,549,14.217,804,20.821,7148,2949,4199,4.967,12.040,13079,5730,7349,9.651,22.029,-5931,-9.990,24.079,672,672,4600
2020,3159,502,508,8394,8361,61,11.879,72,14.021,1560,602,958,7.200,18.658,1454,685,769,8.193,17.390,106,1.268,34.781,52,52,412
2020,3161,146,156,3250,3278,7,4.389,14,8.777,273,30,243,0.915,8.330,325,88,237,2.685,9.916,-52,-1.587,16.659,10,10,75
2020,3162,173,185,11036,11599,12,6.283,24,12.565,363,47,316,0.405,3.130,1504,232,1272,2.000,12.967,-1141,-9.837,6.259,17,17,107
2020,3169,668,678,11748,11645,56,8.169,71,10.357,1247,467,780,4.010,10.708,1044,301,743,2.585,8.965,203,1.743,17.930,56,56,150
2020,3211,2462,2916,87734,88988,157,5.338,207,7.038,6536,1878,4658,2.110,7.345,8928,2587,6341,2.907,10.033,-2392,-2.688,14.690,151,152,1340
2020,3212,1005,1386,78797,78746,56,4.024,67,4.815,7212,1416,5796,1.798,9.159,6994,1847,5147,2.346,8.882,218,0.277,17.763,38,38,573
2020,3219,7490,8710,246768,246825,614,7.000,738,8.413,25890,7150,18740,2.897,10.489,25845,7761,18084,3.144,10.471,45,0.018,20.942,520,537,4382
2020,3221,205,420,92236,95904,13,3.077,18,4.260,3951,362,3589,0.377,4.120,11256,1689,9567,1.761,11.737,-7305,-7.617,8.239,11,11,448
2020,3222,2072,3379,248958,248419,116,3.408,165,4.848,20847,3370,17477,1.357,8.392,19429,5448,13981,2.193,7.821,1418,0.571,15.642,102,105,2491
2020,3231,20748,22119,415221,422134,1197,5.308,2064,9.152,33041,6797,26244,1.610,7.827,46855,16894,29961,4.002,11.100,-13814,-3.272,15.654,1548,1555,8521
2020,3241,848,2095,113343,110795,129,6.227,82,3.958,12240,1726,10514,1.558,11.047,7025,1122,5903,1.013,6.341,5215,4.707,12.681,37,41,251
2020,3251,1209,2412,157593,156788,121,5.032,106,4.408,11959,3217,8742,2.052,7.627,10375,1354,9021,0.864,6.617,1584,1.010,13.234,48,49,648
2020,3252,1018,1373,104905,105135,50,3.614,71,5.132,8245,1853,6392,1.762,7.842,8659,1510,7149,1.436,8.236,-414,-0.394,15.685,40,40,750
2020,3253,702,965,33063,33293,79,8.255,63,6.583,3391,1096,2295,3.292,10.185,3872,1153,2719,3.463,11.630,-481,-1.445,20.371,40,40,274
2020,3254,1993,2532,282504,276543,295,11.898,190,7.663,36389,6553,29836,2.370,13.159,24633,4411,20222,1.595,8.907,11756,4.251,17.815,123,123,2096
2020,3255,1268,1620,64713,64418,69,4.241,83,5.101,6078,642,5436,0.997,9.435,5431,1212,4219,1.881,8.431,647,1.004,16.862,56,57,564
2020,3256,1987,2207,103978,104262,184,8.358,173,7.858,9229,1693,7536,1.624,8.852,9735,1538,8197,1.475,9.337,-506,-0.485,17.704,125,125,741
2020,3259,1669,2159,86776,86080,150,6.946,151,6.992,8780,2206,6574,2.563,10.200,7580,2438,5142,2.832,8.806,1200,1.394,17.612,93,93,1440
2020,3261,7273,9756,656038,656122,404,4.117,519,5.289,55228,10426,44802,1.589,8.417,55270,12279,42991,1.871,8.424,-42,-0.006,16.835,340,346,5315
2020,3262,1295,1740,138316,140319,63,3.600,83,4.743,6386,1292,5094,0.921,4.551,10383,1876,8507,1.337,7.400,-3997,-2.849,9.102,48,49,581
2020,3271,812,981,36746,36402,66,6.742,62,6.333,3975,470,3505,1.291,10.920,3217,749,2468,2.058,8.837,758,2.082,17.675,42,42,322
2020,3272,1269,1537,87459,88679,99,6.402,118,7.630,6161,1333,4828,1.503,6.948,8562,1663,6899,1.875,9.655,-2401,-2.708,13.895,95,95,1187
2020,3273,3706,8601,180306,179921,407,4.746,358,4.174,21619,5219,16400,2.901,12.016,20750,5575,15175,3.099,11.533,869,0.483,23.066,151,154,1768
2020,3274,128,288,14297,14396,16,5.536,18,6.228,1010,539,471,3.744,7.016,1150,123,1027,0.854,7.989,-140,-0.973,14.032,13,14,113
2020,3279,2564,3057,78392,80262,176,5.721,215,6.988,6303,1670,4633,2.081,7.853,9965,2326,7639,2.898,12.416,-3662,-4.563,15.706,134,135,929
2020,3311,241,386,88669,90791,20,5.195,18,4.675,3524,375,3149,0.413,3.881,7935,1980,5955,2.181,8.740,-4411,-4.858,7.763,12,12,1506
2020,3312,482,670,51453,51603,30,4.488,27,4.039,3856,449,3407,0.870,7.473,4153,384,3769,0.744,8.048,-297,-0.576,14.945,19,19,182
2020,3313,343,479,60412,61541,23,4.802,23,4.802,2825,517,2308,0.840,4.590,5169,1036,4133,1.683,8.399,-2344,-3.809,9.181,12,12,148
2020,3314,600,783,58278,58856,31,3.919,47,5.942,3314,293,3021,0.498,5.631,4534,1122,3412,1.906,7.704,-1220,-2.073,11.261,31,31,735
2020,3315,1252,1440,113370,117198,32,2.194,69,4.731,4517,640,3877,0.546,3.854,12233,1716,10517,1.464,10.438,-7716,-6.584,7.708,53,53,687
2020,3321,1900,2152,102812,105809,63,2.881,132,6.037,5359,735,4624,0.695,5.065,11434,1522,9912,1.438,10.806,-6075,-5.742,10.130,99,99,907
2020,3322,920,998,33155,33824,56,5.586,65,6.484,1879,201,1678,0.594,5.555,3179,1090,2089,3.223,9.399,-1300,-3.843,11.111,40,41,364
2020,3323,11717,12818,385930,387247,720,5.587,858,6.658,35101,7687,27414,1.985,9.064,37852,9654,28198,2.493,9.775,-2751,-0.710,18.129,588,591,5010
2020,3324,1108,1414,87077,87849,50,3.483,93,6.479,5891,1080,4811,1.229,6.706,7444,1529,5915,1.740,8.474,-1553,-1.768,13.412,59,59,785
2020,3325,501,545,29008,29107,23,4.155,40,7.227,1445,176,1269,0.605,4.965,1682,261,1421,0.897,5.779,-237,-0.814,9.929,27,27,169
2020,3326,867,1020,37153,37415,23,2.220,55,5.309,3182,755,2427,2.018,8.505,3723,721,3002,1.927,9.951,-541,-1.446,17.009,43,43,445
2020,3327,20534,21160,374842,380782,868,4.047,1446,6.742,27254,6365,20889,1.672,7.157,39175,10237,28938,2.688,10.288,-11921,-3.131,14.315,1087,1090,6845
2020,3328,4668,5239,125996,128525,220,4.171,290,5.499,8736,1970,6766,1.533,6.797,13703,3115,10588,2.424,10.662,-4967,-3.865,13.594,214,216,2322
2020,3329,5242,5792,253887,256934,381,6.559,415,7.144,18572,4411,14161,1.717,7.228,24882,5727,19155,2.229,9.684,-6310,-2.456,14.457,304,304,3056
2020,3331,2345,2738,188609,192381,142,5.151,179,6.494,10902,1833,9069,0.953,5.667,18422,3645,14777,1.895,9.576,-7520,-3.909,11.334,119,120,1459
2020,3332,2698,2882,109542,110642,166,5.724,202,6.966,7966,1535,6431,1.387,7.200,10156,2860,7296,2.585,9.179,-2190,-1.979,14.400,138,138,1452
2020,3333,1581,1723,72654,73440,87,4.979,136,7.783,5859,2127,3732,2.896,7.978,7399,2386,5013,3.249,10.075,-1540,-2.097,15.956,91,92,911
2020,3334,1344,1607,136033,135084,80,4.969,86,5.342,15451,8049,7402,5.959,11.438,13638,1453,12185,1.076,10.096,1813,1.342,20.192,60,61,657
2020,3335,5628,5920,144092,147236,221,3.678,399,6.640,9040,3039,6001,2.064,6.140,15303,3876,11427,2.633,10.394,-6263,-4.254,12.280,291,294,2282
2020,3336,733,924,96006,99084,26,2.775,52,5.550,5442,313,5129,0.316,5.492,11811,3830,7981,3.865,11.920,-6369,-6.428,10.985,32,32,594
2020,3339,4874,5626,305208,307877,256,4.525,318,5.621,19160,4506,14654,1.464,6.223,24271,4738,19533,1.539,7.883,-5111,-1.660,12.447,223,223,2866
2020,3341,758,787,38804,39434,63,7.945,75,9.458,2623,589,2034,1.494,6.652,3877,418,3459,1.060,9.832,-1254,-3.180,13.303,56,56,359
2020,3342,1024,1137,78527,78164,74,6.460,91,7.944,7784,1038,6746,1.328,9.959,7027,2125,4902,2.719,8.990,757,0.968,17.980,61,62,997
2020,3343,419,436,9523,9429,44,10.256,30,6.993,932,142,790,1.506,9.885,742,176,566,1.867,7.870,190,2.015,15.740,18,18,73
2020,3344,3034,3489,261522,262531,177,5.010,265,7.501,21559,4213,17346,1.605,8.212,23430,6306,17124,2.402,8.925,-1871,-0.713,16.424,188,189,3526
2020,3345,4120,4894,402474,398727,249,5.063,298,6.059,29371,4518,24853,1.133,7.366,22093,5644,16449,1.416,5.541,7278,1.825,11.082,177,178,1671
2020,3346,331,337,5980,6208,31,9.038,43,12.536,769,245,524,3.947,12.387,1226,401,825,6.459,19.749,-457,-7.361,24.774,33,33,376
2020,3351,902,954,38806,40221,53,5.450,90,9.254,3320,1386,1934,3.446,8.254,5900,2777,3123,6.904,14.669,-2580,-6.415,16.509,70,70,607
2020,3352,261,308,50220,50760,36,11.842,28,9.211,2743,204,2539,0.402,5.404,3900,1077,2823,2.122,7.683,-1157,-2.279,10.808,18,18,136
2020,3353,1565,1850,118463,118295,64,3.398,131,6.955,9391,1280,8111,1.082,7.939,9089,2410,6679,2.037,7.683,302,0.255,15.367,68,68,690
2020,3359,1682,1964,135207,135807,123,6.268,120,6.115,10974,2853,8121,2.101,8.081,11992,1872,10120,1.378,8.830,-1018,-0.750,16.161,89,89,1015
2020,3361,245,316,221432,226885,43,14.145,19,6.250,10822,4397,6425,1.938,4.770,22464,1872,20592,0.825,9.901,-11642,-5.131,9.540,13,13,244
2020,3362,1516,1852,161719,163125,110,5.914,126,6.774,12606,2844,9762,1.743,7.728,15506,3177,12329,1.948,9.506,-2900,-1.778,15.456,80,88,2075
2020,3363,3530,4540,595404,606326,181,3.928,317,6.879,35152,7912,27240,1.305,5.798,57109,7637,49472,1.260,9.419,-21957,-3.621,11.595,170,172,3239
2020,3364,1264,1745,395408,391649,103,5.813,157,8.860,24527,3452,21075,0.881,6.263,17704,4377,13327,1.118,4.520,6823,1.742,9.041,70,70,1192
2020,3365,135,227,28259,29454,10,4.348,16,6.957,2059,357,1702,1.212,6.991,4544,874,3670,2.967,15.428,-2485,-8.437,13.981,6,6,32
2020,3366,1170,1305,140289,137897,88,6.649,125,9.445,12626,2978,9648,2.160,9.156,7874,1767,6107,1.281,5.710,4752,3.446,11.420,93,95,1612
2020,3369,729,758,35512,34980,72,9.406,87,11.365,3517,516,3001,1.475,10.054,2435,787,1648,2.250,6.961,1082,3.093,13.922,68,68,224
2020,3371,9007,9257,215324,218579,620,6.600,894,9.517,16671,4208,12463,1.925,7.627,22875,7760,15115,3.550,10.465,-6204,-2.838,15.254,623,633,4838
2020,3372,3309,3456,113132,114056,193,5.519,275,7.864,8128,1746,6382,1.531,7.126,10040,2814,7226,2.467,8.803,-1912,-1.676,14.253,210,211,2039
2020,3379,586,691,32994,32921,35,5.043,41,5.908,2243,482,1761,1.464,6.813,2065,315,1750,0.957,6.273,178,0.541,12.545,29,29,249
2020,3391,7767,8703,292251,289823,532,5.993,880,9.913,30064,5502,24562,1.898,10.373,25245,10194,15051,3.517,8.711,4819,1.663,17.421,612,612,3348
2020,3399,13083,13701,255351,258213,1035,7.449,1421,10.227,21850,5716,16134,2.214,8.462,27442,7652,19790,2.963,10.628,-5592,-2.166,16.924,991,993,4912
2020,4231,13562,21752,417750,418036,1238,5.643,1609,7.334,37728,10119,27609,2.421,9.025,38481,10952,27529,2.620,9.205,-753,-0.180,18.050,1006,1052,5332
2020,4232,9424,11352,163603,165314,659,5.696,1096,9.472,13968,2664,11304,1.611,8.449,17278,6259,11019,3.786,10.452,-3310,-2.002,16.899,734,791,4058
2020,4233,9376,17059,265128,263495,1100,6.458,1047,6.147,30543,9255,21288,3.512,11.591,27011,9047,17964,3.433,10.251,3532,1.340,20.502,591,612,4046
2020,4234,19953,32230,663347,654257,1941,5.966,2555,7.853,76545,17576,58969,2.686,11.700,59181,18502,40679,2.828,9.046,17364,2.654,18.091,1563,1585,9015
2020,4235,6376,8833,150524,151352,342,3.827,549,6.143,11804,2661,9143,1.758,7.799,13543,3175,10368,2.098,8.948,-1739,-1.149,15.598,353,367,1940
2020,4236,16390,25933,516894,518577,1446,5.504,2122,8.077,46423,12465,33958,2.404,8.952,49727,17969,31758,3.465,9.589,-3304,-0.637,17.904,1241,1281,7130
2020,4237,9171,19178,262767,262938,895,4.673,841,4.391,21933,6015,15918,2.288,8.342,22415,8617,13798,3.277,8.525,-482,-0.183,16.683,492,514,2746
2020,4238,35880,53548,782137,783602,2500,4.641,3141,5.831,69304,21138,48166,2.698,8.844,71903,23030,48873,2.939,9.176,-2599,-0.332,17.689,1954,2014,11229
2020,4239,24762,28154,321508,323906,2305,8.095,2948,10.353,34603,10539,24064,3.254,10.683,39485,13175,26310,4.068,12.190,-4882,-1.507,21.366,2072,2116,8672
2020,4241,6048,8176,143691,145418,352,4.236,618,7.438,12603,3483,9120,2.395,8.667,16045,5393,10652,3.709,11.034,-3442,-2.367,17.333,415,422,2308
2020,4242,6413,9629,301259,301544,790,8.145,930,9.589,27867,6581,21286,2.182,9.241,28848,11693,17155,3.878,9.567,-981,-0.325,18.483,554,561,3254
2020,4243,11733,12692,182305,187243,1084,8.362,1626,12.543,18768,4919,13849,2.627,10.023,28540,8756,19784,4.676,15.242,-9772,-5.219,20.047,1218,1242,6378
2020,4244,24666,32204,828396,843565,2389,7.354,2951,9.084,86925,22828,64097,2.706,10.304,118851,51245,67606,6.075,14.089,-31926,-3.785,20.609,1828,1846,11867
2020,4245,3044,5849,61253,61834,302,5.141,352,5.993,7429,2373,5056,3.838,12.015,8454,2211,6243,3.576,13.672,-1025,-1.658,24.029,169,177,780
2020,4246,7100,11462,161185,160845,542,4.696,701,6.074,14650,3971,10679,2.469,9.108,14003,4117,9886,2.560,8.706,647,0.402,17.412,400,408,1815
2020,4247,3584,6072,101133,101476,389,6.427,351,5.799,12289,3605,8684,3.553,12.110,13122,4385,8737,4.321,12.931,-833,-0.821,24.221,168,180,910
2020,4248,3216,4318,207630,206835,317,7.350,307,7.118,17512,4719,12793,2.282,8.467,16127,3757,12370,1.816,7.797,1385,0.670,15.594,229,234,2392
2020,4249,18637,25494,335485,335201,1988,7.764,2214,8.646,39321,10015,29306,2.988,11.731,38743,11647,27096,3.475,11.558,578,0.172,23.116,1498,1529,6761
2020,4251,29025,31195,265930,268175,3077,9.735,3903,12.348,33123,12698,20425,4.735,12.351,37607,16246,21361,6.058,14.023,-4484,-1.672,24.703,2831,2838,7383
2020,4411,36465,43257,1343542,1338694,3529,8.132,3806,8.770,118157,45075,73082,3.367,8.826,108470,38050,70420,2.842,8.103,9687,0.724,16.205,2900,2947,31246
2020,4412,10536,12524,156255,154516,848,6.718,1046,8.286,18968,7384,11584,4.779,12.276,15720,5915,9805,3.828,10.174,3248,2.102,20.347,730,756,4314
2020,4413,24712,55684,543699,540161,2370,4.242,2744,4.911,58504,12726,45778,2.356,10.831,51275,14161,37114,2.622,9.493,7229,1.338,18.985,1656,1699,7319
2020,4421,11826,21422,204300,204833,2199,10.116,2829,13.015,25002,8804,16198,4.298,12.206,25669,9910,15759,4.838,12.532,-667,-0.326,24.412,1089,1213,5057
2020,4422,16225,23964,258061,262887,1269,5.217,1991,8.185,16845,6029,10816,2.293,6.408,26047,8246,17801,3.137,9.908,-9202,-3.500,12.815,1154,1209,3724
2020,4431,13427,23238,269771,280898,1038,4.353,2252,9.444,18113,5655,12458,2.013,6.448,40202,10389,29813,3.698,14.312,-22089,-7.864,12.896,1552,1622,6218
2020,4441,31383,53869,1188086,1185025,2288,4.224,2875,5.308,64571,18216,46355,1.537,5.449,57316,13743,43573,1.160,4.837,7255,0.612,9.673,1820,1891,8973
2020,4442,11469,15767,156890,155344,815,5.134,1031,6.494,17824,4637,13187,2.985,11.474,14640,4502,10138,2.898,9.424,3184,2.050,18.849,739,759,3212
2020,4451,59908,86410,2839813,2823463,7714,8.946,7355,8.529,242914,99261,143653,3.516,8.603,208201,62151,146050,2.201,7.374,34713,1.229,14.748,5248,5344,29550
2020,4452,16184,19961,165437,163833,1949,9.727,2100,10.481,27988,10548,17440,6.438,17.083,25091,9701,15390,5.921,15.315,2897,1.768,30.630,1505,1533,7024
2020,4453,28375,32531,177789,176080,2468,7.589,2449,7.530,25538,8097,17441,4.598,14.504,21903,8521,13382,4.839,12.439,3635,2.064,24.879,1785,1818,6191
2020,4461,39606,90296,1022451,1023999,8076,8.953,7895,8.752,95254,48175,47079,4.705,9.302,99981,45968,54013,4.489,9.764,-4727,-0.462,18.604,3510,3770,17932
2020,4471,60576,107575,995877,995382,6943,6.436,7547,6.996,124857,45175,79682,4.538,12.544,124953,41440,83513,4.163,12.553,-96,-0.010,25.087,4626,4914,22129
2020,4481,31190,86156,1288099,1307829,5202,5.937,8133,9.282,147280,35792,111488,2.737,11.261,186254,65574,120680,5.014,14.241,-38974,-2.980,22.523,3487,4832,31490
2020,4482,4102,21627,211582,217116,547,2.495,1139,5.195,23423,3599,19824,1.658,10.788,36347,6180,30167,2.846,16.741,-12924,-5.953,21.577,415,433,1460
2020,4483,13176,19632,116230,117717,1003,5.012,1765,8.819,12892,3447,9445,2.928,10.952,15762,6339,9423,5.385,13.390,-2870,-2.438,21.903,948,1049,3435
2020,4511,22435,32516,404268,409289,2191,6.650,3058,9.281,43458,14873,28585,3.634,10.618,53780,18391,35389,4.493,13.140,-10322,-2.522,21.236,1976,2054,7517
2020,4512,2967,6293,62780,63603,406,6.300,708,10.987,8275,2403,5872,3.778,13.010,9503,4453,5050,7.001,14.941,-1228,-1.931,26.021,297,303,977
2020,4522,16,3712,450022,435311,14,0.373,88,2.347,47599,639,46960,0.147,10.934,16719,5971,10748,1.372,3.841,30880,7.094,7.681,D,D,D
2020,4523,6843,50234,2313997,2310971,2902,5.810,2327,4.659,129541,25937,103604,1.122,5.605,120704,47335,73369,2.048,5.223,8837,0.382,10.446,770,799,2504
2020,4531,10258,10695,51825,53203,836,7.678,1223,11.232,6935,2352,4583,4.421,13.035,9604,3664,5940,6.887,18.052,-2669,-5.017,26.070,905,938,2682
2020,4532,14269,22319,185432,194444,1490,6.491,2765,12.045,19099,5947,13152,3.058,9.822,37218,14722,22496,7.571,19.141,-18119,-9.318,19.645,1649,1970,8529
2020,4533,11581,17776,206793,204491,1184,6.584,1600,8.897,28243,7428,20815,3.632,13.811,23595,7952,15643,3.889,11.538,4648,2.273,23.077,1097,1125,3917
2020,4539,35093,47516,323174,316598,5597,11.897,4654,9.893,55639,25015,30624,7.901,17.574,42669,16392,26277,5.178,13.477,12970,4.097,26.955,3320,3483,12291
2020,4541,35662,37618,659945,614767,6484,17.508,5318,14.359,161515,108357,53158,17.626,26.273,67111,32829,34282,5.340,10.917,94404,15.356,21.833,3973,4021,16250
2020,4542,2568,3224,40905,42072,384,11.803,443,13.616,4574,1689,2885,4.015,10.872,6812,2982,3830,7.088,16.191,-2238,-5.319,21.744,317,322,1405
2020,4543,20792,26169,176851,178620,2288,8.661,2784,10.539,21018,7333,13685,4.105,11.767,24421,9939,14482,5.564,13.672,-3403,-1.905,23.534,1998,2028,7742
2020,4811,404,2110,479149,473787,92,4.341,111,5.237,31820,2407,29413,0.508,6.716,20743,4813,15930,1.016,4.378,11077,2.338,8.756,24,53,356
2020,4812,1742,2010,46126,45801,206,10.272,197,9.823,5272,799,4473,1.745,11.511,4522,1404,3118,3.065,9.873,750,1.638,19.747,142,143,703
2020,4831,639,945,45099,43819,111,11.948,79,8.504,5753,944,4809,2.154,13.129,3278,1153,2125,2.631,7.481,2475,5.648,14.962,47,47,222
2020,4832,457,522,20025,20121,67,12.972,56,10.842,2877,244,2633,1.213,14.299,3024,1604,1420,7.972,15.029,-147,-0.731,28.598,31,31,110
2020,4841,63954,75663,1123207,1102514,13589,18.145,12047,16.086,175365,84775,90590,7.689,15.906,133297,50767,82530,4.605,12.090,42068,3.816,24.181,7902,7959,29169
2020,4842,39603,43460,503070,502921,5163,11.805,5711,13.058,71974,27923,44051,5.552,14.311,71193,24601,46592,4.892,14.156,781,0.155,28.312,4068,4096,16076
2020,4851,383,635,53518,54255,39,5.954,79,12.061,4158,637,3521,1.174,7.664,5461,2322,3139,4.280,10.065,-1303,-2.402,15.328,43,43,435
2020,4852,271,568,18158,18334,23,3.966,47,8.103,1570,254,1316,1.385,8.563,1914,654,1260,3.567,10.440,-344,-1.876,17.127,30,30,229
2020,4853,6108,6293,68209,70008,979,15.113,1349,20.824,9238,3260,5978,4.657,13.196,12915,5290,7625,7.556,18.448,-3677,-5.252,26.391,1029,1033,3863
2020,4854,2389,3955,240087,238000,228,5.605,453,11.137,23134,7855,15279,3.300,9.720,18898,8166,10732,3.431,7.940,4236,1.780,15.881,182,182,2613
2020,4855,951,1079,29891,30404,73,6.568,138,12.416,3053,687,2366,2.260,10.041,4029,816,3213,2.684,13.252,-976,-3.210,20.083,99,101,559
2020,4859,4613,5117,101630,100880,882,17.509,723,14.352,16659,5532,11127,5.484,16.514,15151,6929,8222,6.869,15.019,1508,1.495,30.038,540,540,5660
2020,4861,68,600,10210,10753,16,2.424,136,20.606,1062,110,952,1.023,9.877,2172,971,1201,9.030,20.200,-1110,-10.323,19.754,9,12,69
2020,4862,104,2034,26488,27102,225,11.205,173,8.616,4201,1189,3012,4.387,15.501,5435,1274,4161,4.701,20.054,-1234,-4.553,31.002,7,7,53
2020,4869,78,712,9287,8900,72,10.427,29,4.200,1456,657,799,7.382,16.360,667,136,531,1.528,7.495,789,8.866,14.990,4,4,32
2020,4871,576,619,10592,10853,72,11.294,109,17.098,1243,310,933,2.856,11.453,1742,313,1429,2.884,16.051,-499,-4.598,22.906,80,80,241
2020,4872,1374,1423,14313,14768,198,14.003,180,12.730,1751,747,1004,5.058,11.857,2687,811,1876,5.492,18.195,-936,-6.338,23.713,117,117,294
2020,4879,190,221,3333,3422,24,10.787,27,12.135,270,48,222,1.403,7.890,443,82,361,2.396,12.946,-173,-5.056,15.780,17,17,46
2020,4881,3951,5726,220689,223262,416,7.189,537,9.280,19427,3877,15550,1.737,8.701,23837,10453,13384,4.682,10.677,-4410,-1.975,17.403,259,288,4397
2020,4882,535,1625,45207,43786,358,23.646,136,8.983,8664,6279,2385,14.340,19.787,6095,1260,4835,2.878,13.920,2569,5.867,27.840,31,34,289
2020,4883,1800,2395,101877,102012,175,7.315,170,7.106,27393,22716,4677,22.268,26.853,27962,1255,26707,1.230,27.411,-569,-0.558,53.706,104,104,825
2020,4884,10238,11889,115261,114471,1665,14.173,1382,11.764,18464,6802,11662,5.942,16.130,16999,7378,9621,6.445,14.850,1465,1.280,29.700,954,969,4640
2020,4885,13647,19846,299142,297138,1497,7.524,1596,8.022,39023,12117,26906,4.078,13.133,35222,11852,23370,3.989,11.854,3801,1.279,23.708,954,968,5663
2020,4889,1572,1674,20722,19937,234,14.165,190,11.501,4081,1079,3002,5.412,20.469,2472,1005,1467,5.041,12.399,1609,8.070,24.798,139,143,696
2020,4921,3995,9532,855130,816104,868,9.161,753,7.948,106858,26412,80446,3.236,13.094,28285,14002,14283,1.716,3.466,78573,9.628,6.932,418,432,5916
2020,4922,3571,4191,104421,91630,744,18.267,508,12.472,41390,28294,13096,30.879,45.171,15219,3464,11755,3.780,16.609,26171,28.562,33.219,376,381,2705
2020,4931,7821,16938,1141470,1120083,1738,10.325,1528,9.077,165914,80916,84998,7.224,14.813,122973,60862,62111,5.434,10.979,42941,3.834,21.958,425,434,5195
2020,5111,9652,13732,308021,320019,840,6.015,1307,9.359,28292,11781,16511,3.681,8.841,51889,11857,40032,3.705,16.214,-23597,-7.374,17.681,815,836,5901
2020,5112,9857,13398,692846,673967,2039,15.529,1503,11.447,104417,30794,73623,4.569,15.493,67105,21160,45945,3.140,9.957,37312,5.536,19.913,1125,1139,13838
2020,5121,15277,18477,293477,298477,2946,16.152,2470,13.542,40292,15435,24857,5.171,13.499,49431,20609,28822,6.905,16.561,-9139,-3.062,26.998,1498,1536,10640
2020,5122,2897,3107,23924,23292,445,14.474,380,12.360,3805,1407,2398,6.041,16.336,2592,1227,1365,5.268,11.129,1213,5.208,22.257,244,244,776
2020,5151,3596,6899,220343,216502,423,6.074,553,7.941,38231,18072,20159,8.347,17.659,30757,14282,16475,6.597,14.206,7474,3.452,28.413,208,223,1715
2020,5152,344,1022,54218,53840,271,28.010,162,16.744,7996,4973,3023,9.237,14.851,7221,5914,1307,10.984,13.412,775,1.439,26.824,16,16,40
2020,5173,7359,56636,955372,980038,3911,6.919,3691,6.530,90838,23891,66947,2.438,9.269,140081,30848,109233,3.148,14.293,-49243,-5.025,18.538,898,1050,5453
2020,5174,284,396,10093,10065,38,9.453,50,12.438,994,131,863,1.302,9.876,914,308,606,3.060,9.081,80,0.795,18.163,36,36,165
2020,5179,2867,4280,58415,59383,654,15.498,534,12.654,8784,4108,4676,6.918,14.792,10529,4055,6474,6.829,17.731,-1745,-2.939,29.584,294,349,1800
2020,5182,9430,16124,557049,555523,1363,8.428,1458,9.016,68567,17504,51063,3.151,12.343,65084,22703,42381,4.087,11.716,3483,0.627,23.432,863,883,8892
2020,5191,9083,11211,329238,318303,1578,14.223,1345,12.123,52016,15376,36640,4.831,16.342,29481,11708,17773,3.678,9.262,22535,7.080,18.524,846,862,6061
2020,5211,14,61,20231,20101,3,5.042,0,0.000,357,16,341,0.080,1.776,105,0,105,0.000,0.522,252,1.254,1.045,0,0,0
2020,5221,9700,113067,1963983,1956573,3540,3.109,5103,4.482,190256,40231,150025,2.056,9.724,173022,35380,137642,1.808,8.843,17234,0.881,17.686,244,427,4509
2020,5222,12686,43570,639108,622218,4203,9.623,4414,10.106,101932,31836,70096,5.117,16.382,67811,24511,43300,3.939,10.898,34121,5.484,21.797,940,1320,6647
2020,5223,11898,25838,318371,314181,2250,8.716,2205,8.541,41607,16527,25080,5.260,13.243,33399,13748,19651,4.376,10.631,8208,2.613,21.261,842,941,5175
2020,5231,8726,25744,349739,350320,1429,5.445,2429,9.255,36875,6592,30283,1.882,10.526,37300,8068,29232,2.303,10.647,-425,-0.121,21.052,685,700,2581
2020,5232,21,43,6039,7837,10,25.641,D,D,618,311,307,3.968,7.886,4317,D,591,D,55.085,-3699,-47.199,15.771,0,0,0
2020,5239,47932,68532,582095,577426,7363,10.895,5460,8.079,74440,23245,51195,4.026,12.892,65852,21217,44635,3.674,11.404,8588,1.487,22.809,3665,3710,11611
2020,5241,4910,29775,1562169,1557190,2740,9.245,2468,8.327,163059,46537,116522,2.989,10.471,153388,40265,113123,2.586,9.850,9671,0.621,19.701,311,317,1773
2020,5242,117402,137104,1189840,1174522,11433,8.308,12463,9.056,177602,57120,120482,4.863,15.121,146132,59627,86505,5.077,12.442,31470,2.679,24.884,8112,8226,33383
2020,5259,1172,1227,7768,7373,368,32.352,189,16.615,1895,1137,758,15.421,25.702,1118,729,389,9.887,15.163,777,10.538,30.327,147,147,548
2020,5311,86642,119007,608310,604655,11385,9.580,11066,9.311,91866,37812,54054,6.253,15.193,84121,37728,46393,6.240,13.912,7745,1.281,27.824,7636,7804,23620
2020,5312,91699,108039,362642,357136,18683,17.740,13237,12.569,64685,36832,27853,10.313,18.112,54681,26216,28465,7.341,15.311,10004,2.801,30.622,7179,7254,12679
2020,5313,72342,91189,750862,739245,10127,11.225,8180,9.067,116317,48784,67533,6.599,15.735,93078,34916,58162,4.723,12.591,23239,3.144,25.182,5443,5463,21018
2020,5321,3417,15281,175953,176673,828,5.382,1037,6.740,16777,3957,12820,2.240,9.496,17955,6607,11348,3.740,10.163,-1178,-0.667,18.992,313,314,1099
2020,5322,6550,15300,123440,127521,1142,7.336,1677,10.772,14315,4475,9840,3.509,11.226,22228,7141,15087,5.600,17.431,-7913,-6.205,22.451,655,682,3329
2020,5323,1988,2653,19578,19499,110,4.007,294,10.710,2408,483,1925,2.477,12.349,2256,866,1390,4.441,11.570,152,0.780,23.140,133,143,502
2020,5324,7502,14623,201344,200606,979,6.647,1189,8.073,26923,5651,21272,2.817,13.421,25909,8842,17067,4.408,12.915,1014,0.505,25.831,538,547,2815
2020,5331,2089,2228,36398,35747,245,10.786,332,14.616,5738,914,4824,2.557,16.052,4526,1665,2861,4.658,12.661,1212,3.390,25.322,231,236,1241
2020,5411,152949,165702,1160123,1154476,12324,7.420,13091,7.882,118913,33055,85858,2.863,10.300,107767,34156,73611,2.959,9.335,11146,0.965,18.669,9674,9736,24614
2020,5412,101527,121387,1181985,1168413,11698,9.714,9764,8.108,162265,44687,117578,3.825,13.888,134786,64071,70715,5.484,11.536,27479,2.352,23.072,6336,6427,28664
2020,5413,81962,102904,1602634,1585753,9127,8.882,8842,8.604,190655,54947,135708,3.465,12.023,156347,55041,101306,3.471,9.859,34308,2.164,19.719,5495,5582,25454
2020,5414,27444,27842,122980,122824,3813,13.703,3782,13.591,19013,7683,11330,6.255,15.480,18642,8258,10384,6.723,15.178,371,0.302,30.356,2572,2575,5969
2020,5415,100317,121588,2016032,1975782,17462,14.497,15186,12.608,334155,120607,213548,6.104,16.913,255747,75772,179975,3.835,12.944,78408,3.968,25.888,10520,10597,46724
2020,5416,139534,150647,1454794,1418706,28115,18.991,22914,15.478,305631,130237,175394,9.180,21.543,232278,105612,126666,7.444,16.373,73353,5.170,32.745,15872,15958,55129
2020,5417,14486,18099,797207,786042,2241,12.506,1883,10.508,92385,18778,73607,2.389,11.753,69893,23231,46662,2.955,8.892,22492,2.861,17.784,1227,1254,9832
2020,5418,28522,32414,464472,467630,3562,10.965,3702,11.396,46797,14854,31943,3.176,10.007,52923,21379,31544,4.572,11.317,-6126,-1.310,20.015,2620,2659,12784
2020,5419,56568,64912,701392,700724,7449,11.556,6540,10.146,97846,30378,67468,4.335,13.964,95911,36367,59544,5.190,13.687,1935,0.276,27.375,4606,4636,27766
2020,5511,25062,50968,3537057,3513104,2787,5.439,3331,6.501,466491,124750,341741,3.551,13.279,417010,113579,303431,3.233,11.870,49481,1.408,23.740,681,728,13744
2020,5611,26919,30236,544926,534689,3464,11.472,3380,11.194,92373,39154,53219,7.323,17.276,72666,26877,45789,5.027,13.590,19707,3.686,27.181,2385,2393,17775
2020,5612,1995,8008,287275,290529,1211,15.544,777,9.973,36740,17105,19635,5.888,12.646,42873,9069,33804,3.122,14.757,-6133,-2.111,25.292,139,145,2439
2020,5613,24492,49313,5997339,6054342,4505,9.115,4723,9.556,961586,296117,665469,4.891,15.883,1086573,253701,832872,4.190,17.947,-124987,-2.064,31.765,2361,2422,87143
2020,5614,20483,30775,782220,788146,5413,18.364,2814,9.547,131002,50219,80783,6.372,16.622,144173,45615,98558,5.788,18.293,-13171,-1.671,33.243,1835,1867,12647
2020,5615,12072,15784,220544,223044,1367,8.560,1737,10.877,21253,6560,14693,2.941,9.529,26294,8444,17850,3.786,11.789,-5041,-2.260,19.057,1198,1210,4678
2020,5616,18324,23922,998849,1004932,2667,11.202,2440,10.248,117097,41275,75822,4.107,11.652,130112,36507,93605,3.633,12.947,-13015,-1.295,23.304,1531,1540,19867
2020,5617,162304,171531,2067658,2054120,23636,13.888,20959,12.315,345971,133563,212408,6.502,16.843,317640,120838,196802,5.883,15.464,28331,1.379,30.927,14077,14089,59898
2020,5619,15883,17980,307774,306244,1978,11.046,1833,10.236,40516,12436,28080,4.061,13.230,37083,10607,26476,3.464,12.109,3433,1.121,24.218,1305,1310,6732
2020,5621,7245,11210,234966,232412,774,6.913,745,6.654,23913,9373,14540,4.033,10.289,18876,7584,11292,3.263,8.122,5037,2.167,16.244,505,510,4409
2020,5622,1223,2557,61062,60226,176,6.898,165,6.467,6351,2788,3563,4.629,10.545,4857,1736,3121,2.882,8.065,1494,2.481,16.129,93,93,774
2020,5629,9048,10698,152511,150413,1020,9.610,852,8.027,22726,6632,16094,4.409,15.109,18643,5069,13574,3.370,12.395,4083,2.715,24.789,572,580,3365
2020,6111,18690,21677,1108003,1102340,821,3.775,960,4.415,77821,14809,63012,1.343,7.060,66832,18249,48583,1.655,6.063,10989,0.997,12.125,668,676,13458
2020,6112,397,739,56404,57471,17,2.246,53,7.001,3118,266,2852,0.463,5.425,5193,628,4565,1.093,9.036,-2075,-3.611,10.851,17,22,190
2020,6113,2365,4054,1815654,1827206,266,6.607,210,5.216,63026,11939,51087,0.653,3.449,85917,7161,78756,0.392,4.702,-22891,-1.253,6.899,72,72,3477
2020,6114,6652,7091,74750,73340,899,12.721,851,12.042,12941,4477,8464,6.104,17.645,10025,3632,6393,4.952,13.669,2916,3.976,27.339,601,602,2116
2020,6115,6257,7766,107838,106085,776,10.060,672,8.711,16002,5261,10741,4.959,15.084,12635,2930,9705,2.762,11.910,3367,3.174,23.821,441,470,2067
2020,6116,45790,49506,477292,472363,6287,12.876,4930,10.097,83023,32390,50633,6.857,17.576,72867,22352,50515,4.732,15.426,10156,2.150,30.852,3493,3512,15157
2020,6117,7638,8528,116702,112168,1439,17.296,1023,12.296,22757,7378,15379,6.578,20.288,13986,4934,9052,4.399,12.469,8771,7.820,24.938,739,742,3479
2020,6211,148753,205918,2637254,2595902,18641,9.086,17132,8.350,384021,158347,225674,6.100,14.793,301939,105801,196138,4.076,11.631,82082,3.162,23.263,10914,11223,51571
2020,6212,116002,129137,974887,975465,7673,5.928,8261,6.383,118935,44536,74399,4.566,12.193,119946,41469,78477,4.251,12.296,-1011,-0.104,24.385,6503,6582,33822
2020,6213,128655,153491,998657,985712,15460,10.184,12084,7.960,161914,60325,101589,6.120,16.426,134826,45899,88927,4.656,13.678,27088,2.748,27.356,8032,8211,31834
2020,6214,18693,47337,1196933,1181610,3634,7.734,2934,6.244,130833,42229,88604,3.574,11.072,101092,31431,69661,2.660,8.555,29741,2.517,17.111,1123,1231,12638
2020,6215,6402,16658,289632,287863,1122,6.631,1646,9.728,46208,11708,34500,4.067,16.052,42405,14971,27434,5.201,14.731,3803,1.321,29.462,599,631,6998
2020,6216,22329,32472,1585357,1560726,4415,13.833,3306,10.358,231140,67938,163202,4.353,14.810,183266,56371,126895,3.612,11.742,47874,3.067,23.485,1958,1982,25181
2020,6219,6418,11708,347880,345856,1352,11.647,1152,9.924,51728,17610,34118,5.092,14.957,47894,17053,30841,4.931,13.848,3834,1.109,27.696,438,476,4888
2020,6221,2398,5458,5632150,5599224,166,3.058,108,1.989,225965,14950,211015,0.267,4.036,158712,26851,131861,0.480,2.835,67253,1.201,5.669,29,33,6631
2020,6222,425,724,251189,251135,39,5.489,12,1.689,7572,1889,5683,0.752,3.015,7432,1498,5934,0.596,2.959,140,0.056,5.919,4,5,571
2020,6223,291,756,252747,247022,26,3.448,22,2.918,23170,5438,17732,2.201,9.380,11647,2426,9221,0.982,4.715,11523,4.665,9.430,8,8,1024
2020,6231,9041,16633,1588561,1602973,1200,7.242,1074,6.482,138302,68308,69994,4.261,8.628,167152,68609,98543,4.280,10.428,-28850,-1.800,17.256,649,687,45261
2020,6232,10363,43152,795932,794497,2018,4.688,1799,4.180,87055,24471,62584,3.080,10.957,84375,22579,61796,2.842,10.620,2680,0.337,21.240,525,640,9427
2020,6233,16811,24891,1029193,1014972,2128,8.588,1906,7.692,114416,48455,65961,4.774,11.273,85818,34652,51166,3.414,8.455,28598,2.818,16.910,1307,1353,20571
2020,6239,3105,5740,128335,127201,575,10.231,335,5.961,14973,4030,10943,3.168,11.771,12402,3259,9143,2.562,9.750,2571,2.021,19.500,199,205,1571
2020,6241,58770,78393,1991807,1958538,9190,11.960,6082,7.915,260141,64014,196127,3.268,13.282,193065,53818,139247,2.748,9.858,67076,3.425,19.715,3839,3920,31126
2020,6242,10500,14767,218997,217052,760,5.177,585,3.985,23390,5379,18011,2.478,10.776,19638,4989,14649,2.299,9.048,3752,1.729,18.095,292,298,1822
2020,6243,3738,7101,268424,271911,376,5.277,424,5.951,29501,5973,23528,2.197,10.850,36176,7136,29040,2.624,13.304,-6675,-2.455,21.699,160,163,1468
2020,6244,56668,73106,1017123,1010309,6741,9.242,6410,8.788,133509,49862,83647,4.935,13.215,120097,44682,75415,4.423,11.887,13412,1.328,23.774,4341,4398,28906
2020,7111,7733,7859,124336,125655,991,12.655,935,11.940,16824,4700,12124,3.740,13.389,19708,5508,14200,4.383,15.684,-2884,-2.295,26.778,579,579,3862
2020,7112,3363,3565,137678,137708,505,14.353,412,11.710,16598,2893,13705,2.101,12.053,16488,3690,12798,2.680,11.973,110,0.080,23.946,309,310,1736
2020,7113,6562,7129,195183,197537,670,9.354,738,10.303,20422,3468,16954,1.756,10.338,25278,5131,20147,2.597,12.797,-4856,-2.458,20.677,521,525,3393
2020,7114,3348,3496,25143,24081,541,15.718,433,12.580,5008,2906,2102,12.068,20.797,2732,1231,1501,5.112,11.345,2276,9.452,22.691,307,307,970
2020,7115,19603,19651,56774,56794,4289,22.416,3255,17.012,14654,8300,6354,14.614,25.802,14787,6729,8058,11.848,26.036,-133,-0.234,51.604,2022,2025,4475
2020,7121,6836,7302,160494,160303,370,5.066,374,5.120,10880,1435,9445,0.895,6.787,10434,1921,8513,1.198,6.509,446,0.278,13.018,195,195,1138
2020,7131,2908,3452,200352,204391,585,17.236,469,13.819,23492,12748,10744,6.237,11.494,31057,4861,26196,2.378,15.195,-7565,-3.701,22.987,397,397,4032
2020,7132,1820,2985,139187,138880,215,7.233,190,6.392,9114,2841,6273,2.046,6.563,8472,2173,6299,1.565,6.100,642,0.462,12.200,117,121,1460
2020,7139,57369,67940,1435679,1428699,8366,12.435,7043,10.468,208655,86778,121877,6.074,14.605,194722,60148,134574,4.210,13.629,13933,0.975,27.259,5101,5189,43202
2020,7211,43390,55389,2100635,2101134,5182,9.421,4419,8.033,224288,113015,111273,5.379,10.675,223358,80513,142845,3.832,10.630,930,0.044,21.261,3078,3156,43882
2020,7212,5581,6230,47904,48170,537,8.627,527,8.466,7015,2143,4872,4.449,14.563,7465,1862,5603,3.865,15.497,-450,-0.934,29.126,345,345,1317
2020,7213,1488,1661,10206,10487,117,6.935,169,10.018,1675,569,1106,5.426,15.973,2240,467,1773,4.453,21.361,-565,-5.388,31.946,124,125,334
2020,7223,17907,43772,797375,814943,5614,12.983,4552,10.527,112507,44717,67790,5.487,13.806,143289,39804,103485,4.884,17.583,-30782,-3.777,27.611,2233,2293,11693
2020,7224,35370,36305,375973,380816,3557,9.710,4209,11.490,61944,30095,31849,7.903,16.266,71694,26594,45100,6.983,18.826,-9750,-2.560,32.532,3042,3047,19319
2020,7225,387774,537284,11054994,11079838,52333,9.757,50453,9.407,1523508,693263,830245,6.257,13.750,1580347,538183,1042164,4.857,14.263,-56839,-0.513,27.501,37591,39022,393464
2020,8111,133181,149551,926348,929644,12438,8.291,13383,8.921,118969,46555,72414,5.008,12.797,126167,47897,78270,5.152,13.572,-7198,-0.774,25.595,9540,9664,35873
2020,8112,9370,10664,102658,101307,945,8.715,1303,12.017,14119,3714,10405,3.666,13.937,11179,4929,6250,4.865,11.035,2940,2.902,22.070,897,909,2893
2020,8113,18002,19829,207191,206723,1486,7.446,1743,8.734,26307,8784,17523,4.249,12.726,25415,8562,16853,4.142,12.294,892,0.431,24.589,1248,1248,4699
2020,8114,17562,18361,73130,72710,2150,11.658,2314,12.547,11996,5801,6195,7.978,16.499,11210,5245,5965,7.214,15.418,786,1.081,30.835,1648,1652,3767
2020,8121,110519,125736,750623,756933,17639,14.067,16950,13.518,137318,71979,65339,9.509,18.141,148000,68998,79002,9.115,19.553,-10682,-1.411,36.283,10742,10890,41829
2020,8122,13569,19586,133995,134413,673,3.420,857,4.355,12602,3177,9425,2.364,9.376,13368,3363,10005,2.502,9.946,-766,-0.570,18.751,507,525,2150
2020,8123,24730,29855,280528,281307,2312,7.639,3134,10.355,41760,16087,25673,5.719,14.845,42993,19448,23545,6.913,15.283,-1233,-0.438,29.690,2250,2308,9272
2020,8129,35705,46414,385633,373798,8460,18.748,5884,13.039,87373,40498,46875,10.834,23.374,63275,24306,38969,6.502,16.928,24098,6.447,33.855,3480,3507,14269
2020,8131,176838,177787,1654173,1669628,7223,4.041,9109,5.097,119412,20444,98968,1.224,7.152,150988,34441,116547,2.063,9.043,-31576,-1.891,14.304,5632,5632,21665
2020,8132,17974,20016,204973,202336,1567,7.883,1289,6.485,22085,6036,16049,2.983,10.915,16881,5583,11298,2.759,8.343,5204,2.572,16.686,869,869,3257
2020,8133,15513,18360,190750,186987,1534,8.438,1174,6.458,23878,5724,18154,3.061,12.770,16425,3994,12431,2.136,8.784,7453,3.986,17.568,732,735,2550
2020,8134,22003,23516,220314,222078,1390,5.861,1790,7.548,22975,5632,17343,2.536,10.345,26223,6916,19307,3.114,11.808,-3248,-1.463,20.691,1048,1057,3911
2020,8139,51186,53398,487838,487479,2593,4.840,2955,5.515,46998,10601,36397,2.175,9.641,46132,12084,34048,2.479,9.463,866,0.178,18.927,2045,2047,8144
2021,1131,400,420,3556,3577,30,7.143,30,7.143,326,71,255,1.985,9.115,366,59,307,1.650,10.233,-40,-1.118,18.230,18,18,22
2021,1132,134,149,907,936,25,16.949,22,14.915,165,77,88,8.226,17.628,212,59,153,6.303,22.650,-47,-5.021,35.256,15,15,36
2021,1133,6767,6835,45254,45725,612,8.955,610,8.926,5636,1704,3932,3.727,12.326,6492,1701,4791,3.720,14.198,-856,-1.872,24.652,470,470,1326
2021,1141,1409,1418,5041,5172,306,22.352,208,15.194,1038,656,382,12.685,20.072,1306,588,718,11.370,25.254,-268,-5.182,40.143,132,132,337
2021,1142,327,328,1842,1793,45,14.085,28,8.764,290,102,188,5.689,16.174,205,93,112,5.187,11.433,85,4.741,22.867,23,23,69
2021,1151,4012,4388,73003,73316,562,13.021,418,9.685,11682,4834,6848,6.593,15.934,12326,2670,9656,3.642,16.812,-644,-0.878,31.868,304,304,1881
2021,1152,4097,4183,21199,21251,585,14.228,442,10.750,3565,1645,1920,7.741,16.776,3665,1307,2358,6.150,17.247,-100,-0.471,33.552,344,344,1063
2021,1153,1448,1582,13733,13794,221,14.332,141,9.144,2732,1175,1557,8.518,19.806,2781,1018,1763,7.380,20.161,-49,-0.355,39.611,103,103,887
2021,2111,3806,4904,87277,93782,297,5.840,660,12.978,9483,3092,6391,3.297,10.112,22579,8794,13785,9.377,24.076,-13096,-13.964,20.223,401,409,2613
2021,2121,286,477,37127,40313,26,5.073,97,18.927,3814,2650,1164,6.574,9.461,10042,4775,5267,11.845,24.910,-6228,-15.449,18.922,48,65,2323
2021,2122,212,278,40540,39891,43,16.135,20,7.505,3429,378,3051,0.948,8.596,2083,82,2001,0.206,5.222,1346,3.374,10.444,15,15,54
2021,2123,2517,4771,82925,84070,285,5.981,273,5.729,7882,2867,5015,3.410,9.376,10113,2500,7613,2.974,12.029,-2231,-2.654,18.751,127,135,1067
2021,2131,8379,10658,226328,266817,879,7.950,1675,15.150,17313,7564,9749,2.835,6.489,98061,14128,83933,5.295,36.752,-80748,-30.263,12.977,1054,1104,8259
2021,2211,1990,12066,495209,497204,882,7.436,473,3.988,28883,7309,21574,1.470,5.809,32846,7071,25775,1.422,6.606,-3963,-0.797,11.618,100,104,611
2021,2212,397,2404,89994,89911,88,3.639,116,4.797,7466,1735,5731,1.930,8.304,7140,2073,5067,2.306,7.941,326,0.363,15.882,16,16,449
2021,2213,3578,4656,46616,46622,288,6.166,318,6.808,5037,1555,3482,3.335,10.804,4962,2072,2890,4.444,10.643,75,0.161,21.286,158,158,706
2021,2361,162789,164570,829020,808199,31145,19.434,22530,14.058,180857,83584,97273,10.342,22.378,138888,57579,81309,7.124,17.185,41969,5.193,34.370,15705,15714,39789
2021,2362,36043,37775,671536,690677,3512,9.295,3532,9.348,78528,23116,55412,3.347,11.370,117069,16977,100092,2.458,16.950,-38541,-5.580,22.739,2529,2535,11192
2021,2371,16157,18049,583158,606289,1544,8.605,1333,7.429,65632,14324,51308,2.363,10.825,111208,15225,95983,2.511,18.342,-45576,-7.517,21.650,922,925,8476
2021,2372,3714,3816,21652,21923,371,9.679,405,10.566,3074,1253,1821,5.716,14.022,3571,1140,2431,5.200,16.289,-497,-2.267,28.044,297,303,731
2021,2373,7597,8491,302579,307436,540,6.338,597,7.007,28988,4515,24473,1.469,9.429,38762,5513,33249,1.793,12.608,-9774,-3.179,18.858,375,375,2693
2021,2379,3803,3929,79680,79036,412,10.597,330,8.488,11632,2643,8989,3.344,14.717,10261,1801,8460,2.279,12.983,1371,1.735,25.966,257,257,1099
2021,2381,84261,85527,907369,912004,11867,14.120,8904,10.594,146678,46043,100635,5.049,16.083,155028,34450,120578,3.777,16.999,-8350,-0.916,32.166,6158,6162,23735
2021,2382,169441,175013,2178534,2185416,17586,10.139,14451,8.332,289880,83195,206685,3.807,13.264,303167,70432,232735,3.223,13.872,-13287,-0.608,26.529,10118,10156,43837
2021,2383,104740,106326,821021,832536,14221,13.481,12550,11.897,130720,46026,84694,5.528,15.701,153507,37506,116001,4.505,18.438,-22787,-2.737,31.403,8647,8654,25289
2021,2389,62795,63751,691225,688702,8360,13.370,5918,9.464,101555,30451,71104,4.422,14.746,96363,22076,74287,3.205,13.992,5192,0.754,27.984,4140,4145,15366
2021,3111,1122,1783,57276,55898,112,6.364,66,3.750,7666,1896,5770,3.392,13.714,4954,1581,3373,2.828,8.863,2712,4.852,17.725,44,46,1038
2021,3112,536,898,57642,57464,54,6.013,54,6.013,4150,631,3519,1.098,7.222,3788,611,3177,1.063,6.592,362,0.630,13.184,32,33,278
2021,3113,1586,1764,83160,83790,152,8.622,150,8.508,7748,1225,6523,1.462,9.247,9085,1434,7651,1.711,10.843,-1337,-1.596,18.494,104,106,748
2021,3114,1456,1831,163210,162047,165,9.088,134,7.381,14509,3551,10958,2.191,8.954,12188,1766,10422,1.090,7.521,2321,1.432,15.043,96,98,836
2021,3115,1056,1562,155736,154147,93,5.948,96,6.140,10798,2484,8314,1.611,7.005,7633,1547,6086,1.004,4.952,3165,2.053,9.904,64,65,681
2021,3116,2704,3383,545778,545437,286,8.612,162,4.878,37978,6220,31758,1.140,6.963,37384,3060,34324,0.561,6.854,594,0.109,13.708,118,118,1861
2021,3117,400,499,28145,28841,28,5.567,36,7.157,2384,143,2241,0.496,8.266,3724,435,3289,1.508,12.912,-1340,-4.646,16.532,27,27,213
2021,3118,10418,11292,286678,292356,1445,12.953,1173,10.515,29397,10265,19132,3.511,10.055,40602,8565,32037,2.930,13.888,-11205,-3.833,20.110,886,901,5843
2021,3119,3606,4171,227721,229587,500,12.253,319,7.818,22882,5850,17032,2.548,9.967,26652,6683,19969,2.911,11.609,-3770,-1.642,19.933,221,221,3122
2021,3121,9660,10541,235590,244043,1181,11.418,786,7.599,27312,9363,17949,3.837,11.191,43825,6088,37737,2.495,17.958,-16513,-6.766,22.383,531,537,4029
2021,3122,100,122,11447,11357,11,8.835,16,12.851,613,49,564,0.431,5.398,416,88,328,0.775,3.663,197,1.735,7.326,12,12,53
2021,3131,199,242,19003,18823,20,8.065,32,12.903,3644,683,2961,3.629,19.359,3335,1330,2005,7.066,17.718,309,1.642,35.435,20,20,593
2021,3132,659,751,41221,41897,56,7.422,63,8.350,3918,1447,2471,3.454,9.352,5273,837,4436,1.998,12.586,-1355,-3.234,18.703,47,47,451
2021,3133,675,714,22426,23422,53,7.300,77,10.606,1279,247,1032,1.055,5.461,3288,694,2594,2.963,14.038,-2009,-8.578,10.922,58,58,479
2021,3141,1200,1287,47440,48723,70,5.311,132,10.015,5048,437,4611,0.897,10.361,7464,1299,6165,2.666,15.319,-2416,-4.959,20.721,88,88,406
2021,3149,3434,3539,56756,57570,278,7.773,353,9.870,6145,1390,4755,2.414,10.674,7776,1308,6468,2.272,13.507,-1631,-2.833,21.348,249,249,1002
2021,3151,174,181,8203,8827,11,5.995,16,8.719,319,50,269,0.566,3.614,1575,167,1408,1.892,17.843,-1256,-14.229,7.228,10,10,136
2021,3152,3436,3503,49259,52422,459,12.671,698,19.268,7610,2718,4892,5.185,14.517,13767,3444,10323,6.570,26.262,-6157,-11.745,29.034,492,492,2534
2021,3159,494,501,7837,8050,85,17.154,74,14.934,944,220,724,2.733,11.727,1376,459,917,5.702,17.094,-432,-5.367,23.455,50,50,396
2021,3161,145,154,3056,3134,18,11.881,13,8.581,282,79,203,2.521,9.000,455,154,301,4.915,14.521,-173,-5.521,17.999,8,8,18
2021,3162,183,194,9377,10209,26,13.577,21,10.966,814,237,577,2.321,7.973,2453,619,1834,6.063,24.028,-1639,-16.054,15.947,15,15,87
2021,3169,639,647,11792,11676,54,8.176,81,12.263,1579,325,1254,2.784,13.524,1339,444,895,3.803,11.468,240,2.056,22.937,59,59,339
2021,3211,2418,2897,88024,87818,176,6.053,197,6.776,8193,2334,5859,2.658,9.330,7785,1869,5916,2.128,8.865,408,0.465,17.730,126,127,979
2021,3212,984,1387,80279,80024,65,4.680,69,4.968,7068,1883,5185,2.353,8.832,6609,1444,5165,1.804,8.259,459,0.574,16.518,39,41,549
2021,3219,7538,8770,253196,250277,652,7.455,604,6.906,27948,8190,19758,3.272,11.167,22163,5647,16516,2.256,8.855,5785,2.311,17.711,408,410,2813
2021,3221,203,416,89611,90950,7,1.671,13,3.103,3522,128,3394,0.141,3.872,6029,803,5226,0.883,6.629,-2507,-2.756,7.745,8,8,86
2021,3222,2034,3341,249884,250103,105,3.122,150,4.460,19543,2068,17475,0.827,7.814,20227,4450,15777,1.779,8.087,-684,-0.273,15.628,91,94,2141
2021,3231,19540,20844,369361,392437,1226,5.712,2468,11.498,25949,7211,18738,1.837,6.612,71540,17771,53769,4.528,18.230,-45591,-11.617,13.225,1649,1666,7729
2021,3241,814,2022,100211,105925,65,3.175,116,5.665,3888,768,3120,0.725,3.671,15625,1800,13825,1.699,14.751,-11737,-11.080,7.341,32,34,485
2021,3251,1173,2374,153140,155244,103,4.356,84,3.553,8935,2179,6756,1.404,5.755,13243,1944,11299,1.252,8.530,-4308,-2.775,11.511,50,51,797
2021,3252,1058,1425,104692,105354,75,5.278,67,4.715,9281,3053,6228,2.898,8.809,10710,2123,8587,2.015,10.166,-1429,-1.356,17.619,36,36,1015
2021,3253,701,966,33043,33077,56,5.812,51,5.293,2860,505,2355,1.527,8.647,2901,674,2227,2.038,8.771,-41,-0.124,17.293,28,28,174
2021,3254,2087,2656,299989,292006,337,13.019,202,7.804,38502,7722,30780,2.644,13.185,22326,6173,16153,2.114,7.646,16176,5.540,15.291,141,141,1914
2021,3255,1250,1598,67220,65527,83,5.181,91,5.680,10656,3939,6717,6.011,16.262,7182,2002,5180,3.055,10.960,3474,5.302,21.921,47,48,364
2021,3256,2063,2309,110495,107755,269,11.882,179,7.906,14648,3395,11253,3.151,13.594,9151,2740,6411,2.543,8.492,5497,5.101,16.985,131,131,968
2021,3259,1650,2133,83463,84830,159,7.421,178,8.308,7301,2075,5226,2.446,8.607,9952,3055,6897,3.601,11.732,-2651,-3.125,17.213,114,116,917
2021,3261,6967,9458,649447,649469,377,3.956,522,5.477,61720,9988,51732,1.538,9.503,61712,14920,46792,2.297,9.502,8,0.001,19.004,317,325,5331
2021,3262,1269,1718,135670,137078,75,4.342,94,5.441,10738,1584,9154,1.156,7.834,13337,2912,10425,2.124,9.730,-2599,-1.896,15.667,52,52,628
2021,3271,769,937,34149,35319,64,6.780,78,8.263,1928,446,1482,1.263,5.459,4205,534,3671,1.512,11.906,-2277,-6.447,10.918,55,56,289
2021,3272,1189,1444,86662,89691,76,5.106,165,11.085,5113,1200,3913,1.338,5.701,11432,3762,7670,4.194,12.746,-6319,-7.045,11.401,102,103,910
2021,3273,3617,8642,181281,181425,467,5.422,409,4.749,21255,6403,14852,3.529,11.716,21535,4046,17489,2.230,11.870,-280,-0.154,23.431,169,175,1731
2021,3274,124,279,14809,14554,12,4.233,21,7.407,1577,65,1512,0.447,10.836,1012,318,694,2.185,6.954,565,3.882,13.907,9,9,25
2021,3279,2580,3101,83235,82213,215,6.948,202,6.528,9378,3295,6083,4.008,11.407,7476,2118,5358,2.576,9.094,1902,2.314,18.187,120,121,777
2021,3311,241,379,80667,82976,22,5.828,19,5.033,4255,139,4116,0.168,5.128,8901,3708,5193,4.469,10.727,-4646,-5.599,10.256,11,11,208
2021,3312,467,649,46279,49315,21,3.184,42,6.368,2537,340,2197,0.689,5.144,8638,1223,7415,2.480,17.516,-6101,-12.371,10.289,20,20,329
2021,3313,313,445,56395,58236,24,5.375,27,6.047,4880,509,4371,0.874,8.380,8568,2535,6033,4.353,14.713,-3688,-6.333,16.759,15,16,597
2021,3314,588,769,54013,56682,28,3.620,37,4.783,2391,286,2105,0.505,4.218,7701,684,7017,1.207,13.586,-5310,-9.368,8.437,26,26,128
2021,3315,1194,1382,100377,106725,39,2.778,83,5.912,4968,682,4286,0.639,4.655,17643,2060,15583,1.930,16.531,-12675,-11.876,9.310,62,64,1076
2021,3321,1856,2116,96172,99829,85,3.980,124,5.807,5541,1496,4045,1.499,5.551,12951,1867,11084,1.870,12.973,-7410,-7.423,11.101,84,84,918
2021,3322,907,996,32398,32657,74,7.501,55,5.575,2427,828,1599,2.535,7.432,2958,492,2466,1.507,9.058,-531,-1.626,14.864,40,40,188
2021,3323,11931,13080,377754,382426,833,6.367,838,6.406,35471,10706,24765,2.799,9.275,44683,10785,33898,2.820,11.684,-9212,-2.409,18.551,579,585,5023
2021,3324,1078,1379,82506,85296,51,3.670,72,5.182,4809,1014,3795,1.189,5.638,10243,2261,7982,2.651,12.009,-5434,-6.371,11.276,41,41,573
2021,3325,470,519,29662,30278,28,5.416,24,4.642,1616,180,1436,0.595,5.337,2894,233,2661,0.770,9.558,-1278,-4.221,10.675,19,19,131
2021,3326,854,1005,35139,35889,28,2.771,39,3.859,2328,418,1910,1.165,6.487,3815,446,3369,1.243,10.630,-1487,-4.143,12.974,22,22,136
2021,3327,20037,20686,345442,358794,947,4.518,1499,7.151,23790,6781,17009,1.890,6.631,50368,10192,40176,2.841,14.038,-26578,-7.408,13.261,1071,1082,6533
2021,3328,4609,5191,116754,121912,243,4.651,310,5.934,8411,3358,5053,2.754,6.899,18665,3496,15169,2.868,15.310,-10254,-8.411,13.799,217,219,1977
2021,3329,5239,5803,244731,250961,455,7.872,409,7.076,20774,6035,14739,2.405,8.278,32898,6044,26854,2.408,13.109,-12124,-4.831,16.556,282,282,2214
2021,3331,2288,2675,180313,183787,148,5.488,192,7.119,13868,2687,11181,1.462,7.546,20802,4003,16799,2.178,11.319,-6934,-3.773,15.091,116,118,962
2021,3332,2619,2820,107935,108994,177,6.261,191,6.756,9401,2599,6802,2.385,8.625,11522,3039,8483,2.788,10.571,-2121,-1.946,17.251,135,136,1275
2021,3333,1510,1653,69509,71205,104,6.237,133,7.976,5828,1803,4025,2.532,8.185,9287,1692,7595,2.376,13.043,-3459,-4.858,16.370,91,91,777
2021,3334,1309,1608,132331,133550,113,7.080,89,5.576,11029,3370,7659,2.523,8.258,13754,1977,11777,1.480,10.299,-2725,-2.040,16.517,61,61,635
2021,3335,5504,5803,134967,139973,203,3.427,444,7.496,8044,2333,5711,1.667,5.747,18114,4045,14069,2.890,12.941,-10070,-7.194,11.494,330,332,2778
2021,3336,687,868,90578,92526,25,2.822,61,6.885,6534,285,6249,0.308,7.062,10364,2111,8253,2.282,11.201,-3830,-4.139,14.124,33,33,242
2021,3339,4798,5563,296338,300856,272,4.871,313,5.606,20028,4225,15803,1.404,6.657,29342,4576,24766,1.521,9.753,-9314,-3.096,13.314,212,212,2148
2021,3341,728,751,37652,37854,57,7.575,60,7.973,4997,3247,1750,8.578,13.201,5153,720,4433,1.902,13.613,-156,-0.412,26.401,45,45,360
2021,3342,966,1068,75998,76940,58,5.370,82,7.593,5568,369,5199,0.480,7.237,7664,2553,5111,3.318,9.961,-2096,-2.724,14.474,48,48,870
2021,3343,420,436,8774,8938,35,8.092,28,6.474,698,106,592,1.186,7.810,1012,62,950,0.694,11.323,-314,-3.513,15.620,22,22,50
2021,3344,3031,3496,252756,257434,195,5.573,201,5.744,15627,4491,11136,1.745,6.070,24974,4970,20004,1.931,9.701,-9347,-3.631,12.141,138,138,1791
2021,3345,4049,4808,400199,403469,252,5.229,275,5.706,28713,5172,23541,1.282,7.117,35131,8610,26521,2.134,8.707,-6418,-1.591,14.233,192,194,2532
2021,3346,289,291,5337,5419,32,10.579,55,18.182,613,297,316,5.481,11.313,767,295,472,5.444,14.155,-154,-2.842,22.626,34,34,160
2021,3351,884,945,35686,37284,71,7.446,88,9.229,2418,637,1781,1.709,6.485,5563,1102,4461,2.956,14.921,-3145,-8.435,12.971,66,66,936
2021,3352,259,317,55444,53339,37,11.821,29,9.265,6532,747,5785,1.400,12.246,2453,835,1618,1.565,4.599,4079,7.647,9.198,21,21,119
2021,3353,1495,1760,117476,117552,70,3.930,112,6.289,10210,3460,6750,2.943,8.686,10321,1597,8724,1.359,8.780,-111,-0.094,17.371,56,59,472
2021,3359,1680,1968,129190,131054,118,5.996,118,5.996,10904,1462,9442,1.116,8.320,14497,3948,10549,3.012,11.062,-3593,-2.742,16.640,90,93,1216
2021,3361,250,319,240477,230267,41,13.078,30,9.569,26081,2174,23907,0.944,11.326,5773,325,5448,0.141,2.507,20308,8.819,5.014,24,24,280
2021,3362,1531,1908,169471,165185,158,8.442,85,4.542,25913,7385,18528,4.471,15.687,17218,1740,15478,1.053,10.423,8695,5.264,20.847,57,57,726
2021,3363,3445,4448,567136,578075,225,5.054,232,5.212,38756,7306,31450,1.264,6.704,60078,9217,50861,1.594,10.393,-21322,-3.688,13.409,137,141,2850
2021,3364,1261,1735,367627,382071,103,5.904,122,6.993,16198,2523,13675,0.660,4.240,45341,2324,43017,0.608,11.867,-29143,-7.628,8.479,72,73,954
2021,3365,129,216,24303,25828,5,2.283,11,5.023,548,136,412,0.527,2.122,3686,588,3098,2.277,14.271,-3138,-12.150,4.243,3,3,30
2021,3366,1152,1289,143882,142523,104,8.062,106,8.217,11273,1556,9717,1.092,7.910,8523,2086,6437,1.464,5.980,2750,1.930,11.960,73,73,719
2021,3369,746,774,36741,35816,91,11.857,78,10.163,3989,1055,2934,2.946,11.137,2110,622,1488,1.737,5.891,1879,5.246,11.782,48,48,209
2021,3371,8921,9180,212827,213803,763,8.297,795,8.645,20817,4907,15910,2.295,9.737,22595,5994,16601,2.804,10.568,-1778,-0.832,19.473,562,563,3388
2021,3372,3302,3449,102047,108573,224,6.416,309,8.850,6285,2025,4260,1.865,5.789,19136,4636,14500,4.270,17.625,-12851,-11.836,11.577,209,212,2891
2021,3379,565,674,36068,34072,46,6.790,53,7.823,7412,4432,2980,13.008,21.754,3749,1052,2697,3.088,11.003,3663,10.751,22.006,38,38,202
2021,3391,7568,8536,294015,295358,687,7.977,839,9.742,23839,7617,16222,2.579,8.071,26737,6228,20509,2.109,9.052,-2898,-0.981,16.142,599,600,3535
2021,3399,12807,13365,238607,245521,1138,8.424,1425,10.549,24844,5687,19157,2.316,10.119,38740,8438,30302,3.437,15.779,-13896,-5.660,20.238,958,968,5697
2021,4231,13384,21614,405277,411427,1383,6.375,1542,7.108,35796,9573,26223,2.327,8.700,47914,12456,35458,3.028,11.646,-12118,-2.945,17.401,897,945,5821
2021,4232,9330,11330,155435,159349,867,7.626,946,8.321,15643,4925,10718,3.091,9.817,23429,4287,19142,2.690,14.703,-7786,-4.886,19.634,635,640,2578
2021,4233,9488,17328,265671,265701,1294,7.518,1061,6.164,28511,8919,19592,3.357,10.730,28811,9483,19328,3.569,10.843,-300,-0.113,21.461,494,517,3617
2021,4234,19987,32110,650548,664736,2199,6.825,2422,7.517,55187,15906,39281,2.393,8.302,82798,20331,62467,3.059,12.456,-27611,-4.154,16.604,1488,1531,9906
2021,4235,6257,8715,139962,145263,409,4.659,535,6.095,9546,2847,6699,1.960,6.572,20089,3984,16105,2.743,13.829,-10543,-7.258,13.143,304,310,2146
2021,4236,16082,25604,502092,508423,1553,6.017,1965,7.613,60602,17841,42761,3.509,11.920,73563,31066,42497,6.110,14.469,-12961,-2.549,23.839,1109,1168,6460
2021,4237,8970,19258,266838,265578,867,4.491,964,4.993,29863,11452,18411,4.312,11.245,26908,8323,18585,3.134,10.132,2955,1.113,20.264,473,500,3195
2021,4238,35212,53181,749894,765677,2855,5.344,3342,6.256,65508,21936,43572,2.865,8.556,97121,25264,71857,3.300,12.684,-31613,-4.129,17.111,1939,2040,11667
2021,4239,24661,28196,315189,318603,2856,10.112,2952,10.452,40235,12554,27681,3.940,12.629,47352,14182,33170,4.451,14.862,-7117,-2.234,25.257,1944,1968,8454
2021,4241,5740,7767,133041,138544,322,4.036,745,9.338,8013,1583,6430,1.143,5.784,18942,4284,14658,3.092,13.672,-10929,-7.888,11.567,453,461,2031
2021,4242,6409,9598,305324,303118,812,8.441,856,8.898,42811,12400,30411,4.091,14.124,38127,11234,26893,3.706,12.578,4684,1.545,25.157,517,561,3304
2021,4243,11096,12041,162558,172719,1154,9.320,1835,14.820,18545,4418,14127,2.558,10.737,38816,8001,30815,4.632,22.474,-20271,-11.736,21.474,1178,1190,5821
2021,4244,24599,31719,784531,804968,2711,8.467,3308,10.332,68493,21300,47193,2.646,8.509,109210,26900,82310,3.342,13.567,-40717,-5.058,17.018,1889,1998,12747
2021,4245,3068,5891,61191,61223,329,5.604,289,4.923,7120,2039,5081,3.330,11.630,7130,2024,5106,3.306,11.646,-10,-0.016,23.259,168,180,1095
2021,4246,6982,11436,157857,159587,632,5.512,692,6.035,13888,4030,9858,2.525,8.702,17300,4247,13053,2.661,10.841,-3412,-2.138,17.405,444,464,2349
2021,4247,3504,5958,97254,99134,211,3.506,332,5.516,10675,1729,8946,1.744,10.768,14712,3480,11232,3.510,14.841,-4037,-4.072,21.537,174,195,1371
2021,4248,3233,4393,201177,204617,397,9.106,331,7.592,12075,4865,7210,2.378,5.901,18904,4972,13932,2.430,9.239,-6829,-3.337,11.803,224,231,2121
2021,4249,18494,25379,320625,327607,1972,7.736,2194,8.607,34591,9639,24952,2.942,10.559,48336,10755,37581,3.283,14.754,-13745,-4.196,21.117,1429,1444,5568
2021,4251,28711,30973,240520,252570,3584,11.573,3575,11.544,24355,11299,13056,4.474,9.643,49239,9247,39992,3.661,19.495,-24884,-9.852,19.286,2596,2616,6442
2021,4411,36430,43661,1264548,1303304,4092,9.423,3617,8.330,95490,47701,47789,3.660,7.327,173444,39733,133711,3.049,13.308,-77954,-5.981,14.654,2625,2661,27473
2021,4412,10663,12888,162211,159639,1208,9.501,860,6.764,22286,8817,13469,5.523,13.960,17323,5847,11476,3.663,10.851,4963,3.109,21.703,614,635,4029
2021,4413,24649,57217,539562,541566,3980,7.051,2434,4.312,56641,24466,32175,4.518,10.459,59657,11120,48537,2.053,11.016,-3016,-0.557,20.917,1453,1519,5929
2021,4421,11677,21060,196170,200058,1664,7.845,1966,9.269,23663,8039,15624,4.018,11.828,32224,11900,20324,5.948,16.107,-8561,-4.279,23.656,881,1153,6870
2021,4422,15797,22307,233192,245331,1396,6.046,2958,12.812,21108,6604,14504,2.692,8.604,43314,24617,18697,10.034,17.655,-22206,-9.051,17.208,1149,2116,19263
2021,4431,12774,22034,222988,246981,1229,5.437,2366,10.468,14745,5110,9635,2.069,5.970,63758,11458,52300,4.639,25.815,-49013,-19.845,11.940,1135,1238,4209
2021,4441,30971,53377,1208362,1197550,2360,4.407,2708,5.057,82671,15352,67319,1.282,6.903,63545,12797,50748,1.069,5.306,19126,1.597,10.613,1559,1626,7766
2021,4442,11499,15998,169212,163136,1097,6.904,881,5.544,26627,6583,20044,4.035,16.322,13984,4180,9804,2.562,8.572,12643,7.750,17.144,652,669,2974
2021,4451,61537,87842,2983529,2912299,8116,9.303,6914,7.925,320564,82520,238044,2.834,11.007,177022,54685,122337,1.878,6.078,143542,4.929,12.157,4762,4937,28615
2021,4452,16355,19619,159944,162734,2311,11.699,2580,13.061,30802,11926,18876,7.329,18.928,36177,17488,18689,10.746,22.231,-5375,-3.303,37.856,1421,1574,7685
2021,4453,28746,32939,184828,181131,2758,8.424,2363,7.217,30391,9996,20395,5.519,16.779,23108,8148,14960,4.498,12.758,7283,4.021,25.515,1691,1755,6142
2021,4461,39460,88822,993428,1008317,5843,6.529,7175,8.018,88600,32996,55604,3.272,8.787,117862,31622,86240,3.136,11.689,-29262,-2.902,17.574,3370,3915,16742
2021,4471,60048,106806,981688,986757,6544,6.122,6730,6.296,117752,43378,74374,4.396,11.933,128006,38728,89278,3.925,12.972,-10254,-1.039,23.866,4009,4205,19839
2021,4481,30195,79346,1055561,1170311,6109,7.387,12814,15.495,97463,39304,58159,3.358,8.328,332700,108150,224550,9.241,28.428,-235237,-20.100,16.656,3831,5923,28262
2021,4482,3939,18441,202622,207511,601,3.000,3788,18.907,30057,3309,26748,1.595,14.485,38552,11982,26570,5.774,18.578,-8495,-4.094,28.969,363,376,1420
2021,4483,12612,18624,102789,109568,1265,6.612,2282,11.927,11314,3685,7629,3.363,10.326,25322,8317,17005,7.591,23.111,-14008,-12.785,20.652,1087,1110,3018
2021,4511,22167,32137,410604,407218,2787,8.625,3138,9.711,62548,21573,40975,5.298,15.360,54782,20938,33844,5.142,13.453,7766,1.907,26.906,1841,2258,15988
2021,4512,2819,6002,46798,54866,367,5.966,667,10.842,4910,1469,3441,2.677,8.949,21066,2554,18512,4.655,38.396,-16156,-29.447,17.898,311,317,909
2021,4522,22,3639,329957,390011,21,0.571,100,2.718,973,637,336,0.163,0.249,126225,6073,120152,1.557,32.365,-125252,-32.115,0.499,4,61,2576
2021,4523,7264,51417,2437859,2376059,2690,5.281,1738,3.412,181990,24499,157491,1.031,7.659,56247,19087,37160,0.803,2.367,125743,5.292,4.734,645,1257,2800
2021,4531,9945,10391,50247,51080,1045,9.900,1375,13.026,8740,3193,5547,6.251,17.111,10430,3704,6726,7.251,20.419,-1690,-3.309,34.221,955,964,2617
2021,4532,13259,20655,160155,172448,1585,7.398,3124,14.581,17219,5968,11251,3.461,9.985,42214,13556,28658,7.861,24.479,-24995,-14.494,19.970,1715,1960,6548
2021,4533,10947,17126,190846,198758,1268,7.285,1826,10.491,20249,6858,13391,3.450,10.188,35869,9115,26754,4.586,18.047,-15620,-7.859,20.376,1209,1231,3865
2021,4539,35962,48150,327730,325541,6259,13.112,5426,11.367,61838,29029,32809,8.917,18.995,58382,23195,35187,7.125,17.934,3456,1.062,35.868,3261,3734,15326
2021,4541,40966,42935,726647,692483,10201,25.273,5056,12.526,125041,47264,77777,6.825,18.057,59540,20766,38774,2.999,8.598,65501,9.459,17.196,3770,3802,13781
2021,4542,2287,2915,35372,37993,350,11.500,607,19.944,5751,2614,3137,6.880,15.137,11033,3656,7377,9.623,29.040,-5282,-13.903,30.274,344,349,1239
2021,4543,21185,26466,174437,175425,3204,12.176,2900,11.021,26223,9379,16844,5.346,14.948,28298,11243,17055,6.409,16.131,-2075,-1.183,29.897,1921,1958,6905
2021,4811,421,2094,416999,448467,137,6.494,168,7.964,14392,4326,10066,0.965,3.209,77107,5961,71146,1.329,17.193,-62715,-13.984,6.418,36,56,287
2021,4812,1792,2067,48313,47313,244,11.929,201,9.826,6525,1579,4946,3.337,13.791,4482,1099,3383,2.323,9.473,2043,4.318,18.946,138,138,420
2021,4831,648,951,38250,41598,107,11.305,98,10.354,2650,555,2095,1.334,6.371,9642,683,8959,1.642,23.179,-6992,-16.809,12.741,53,53,199
2021,4832,470,536,18763,19349,65,12.276,52,9.821,1216,431,785,2.228,6.285,2386,734,1652,3.793,12.331,-1170,-6.047,12.569,28,28,280
2021,4841,74314,86690,1169360,1142133,20924,25.788,9818,12.101,204452,100677,103775,8.815,17.901,148943,41254,107689,3.612,13.041,55509,4.860,26.082,6714,6795,23654
2021,4842,41346,45188,497072,500502,6642,14.954,5100,11.482,72089,31113,40976,6.216,14.403,79344,23793,55551,4.754,15.853,-7255,-1.450,28.807,3628,3665,14981
2021,4851,343,571,44692,49447,30,4.955,99,16.350,1001,189,812,0.382,2.024,10397,2072,8325,4.190,21.027,-9396,-19.002,4.049,42,50,593
2021,4852,222,511,13326,15756,23,4.283,75,13.966,305,79,226,0.501,1.936,5060,326,4734,2.069,32.115,-4755,-30.179,3.872,39,39,154
2021,4853,4740,4924,44453,56192,1020,18.253,2348,42.019,5977,3964,2013,7.054,10.637,29578,7401,22177,13.171,52.638,-23601,-42.001,21.274,1424,1428,4893
2021,4854,2219,3779,195820,218030,165,4.270,336,8.695,8309,3902,4407,1.790,3.811,53062,5194,47868,2.382,24.337,-44753,-20.526,7.622,207,220,3188
2021,4855,784,913,17345,23654,88,8.769,269,26.806,984,679,305,2.871,4.160,13648,2074,11574,8.768,57.698,-12664,-53.539,8.320,134,136,889
2021,4859,4475,4978,79526,90858,852,16.820,1027,20.274,9049,4596,4453,5.058,9.960,31689,7029,24660,7.736,34.878,-22640,-24.918,19.919,699,700,4266
2021,4861,72,648,10323,10258,86,13.804,36,5.778,1493,1104,389,10.762,14.554,1378,278,1100,2.710,13.433,115,1.121,26.867,3,3,26
2021,4862,110,2050,26220,26562,138,6.756,123,6.022,2284,799,1485,3.008,8.599,2985,664,2321,2.500,11.238,-701,-2.639,17.198,6,6,40
2021,4869,83,691,8999,9102,32,4.571,50,7.143,631,71,560,0.780,6.933,845,401,444,4.406,9.284,-214,-2.351,13.866,3,3,7
2021,4871,442,476,5875,8250,67,12.226,211,38.504,515,226,289,2.740,6.243,5346,1233,4113,14.946,64.804,-4831,-58.561,12.486,114,114,404
2021,4872,1448,1503,9831,12752,280,19.087,208,14.179,1655,967,688,7.583,12.978,7538,1935,5603,15.174,59.112,-5883,-46.134,25.957,120,120,306
2021,4879,174,206,2119,2693,25,11.628,43,20.000,183,58,125,2.154,6.797,1324,125,1199,4.643,49.174,-1141,-42.377,13.593,23,23,79
2021,4881,3929,5898,191000,205856,632,10.882,451,7.766,23227,15362,7865,7.462,11.283,51906,9447,42459,4.589,25.215,-28679,-13.932,22.566,250,250,2149
2021,4882,537,1603,42044,44051,106,6.531,146,8.996,4065,1443,2622,3.276,9.228,8213,1890,6323,4.290,18.644,-4148,-9.416,18.456,43,43,835
2021,4883,1810,2404,95661,98731,180,7.481,184,7.648,5776,1077,4699,1.091,5.850,11869,824,11045,0.835,12.022,-6093,-6.171,11.701,124,124,453
2021,4884,10745,12426,115093,114973,2062,17.031,1424,11.762,21668,9141,12527,7.951,18.846,21436,5514,15922,4.796,18.644,232,0.202,37.289,943,952,3415
2021,4885,13644,19961,300512,300991,1865,9.385,1688,8.494,39627,13958,25669,4.637,13.166,40721,13573,27148,4.509,13.529,-1094,-0.363,26.331,945,977,6875
2021,4889,1695,1838,23878,23067,292,16.322,194,10.844,5035,1622,3413,7.032,21.828,3405,655,2750,2.840,14.762,1630,7.067,29.523,140,140,488
2021,4921,4608,10159,955102,905343,1272,12.889,692,7.012,142646,49152,93494,5.429,15.756,38003,14283,23720,1.578,4.198,104643,11.558,8.395,352,401,4456
2021,4922,4048,4666,137681,120920,1009,22.810,524,11.846,59400,34373,25027,28.426,49.123,25149,8483,16666,7.015,20.798,34251,28.325,41.596,365,370,6613
2021,4931,8096,17602,1197999,1169190,1899,10.986,1265,7.318,168350,58674,109676,5.018,14.399,108969,33134,75835,2.834,9.320,59381,5.079,18.640,447,487,7786
2021,5111,9360,13198,274881,290519,1219,9.017,1861,13.766,25950,10837,15113,3.730,8.932,57328,15685,41643,5.399,19.733,-31378,-10.801,17.865,915,1042,6856
2021,5112,10605,14408,728668,710078,2396,17.087,1625,11.589,114840,27547,87293,3.879,16.173,78019,28793,49226,4.055,10.987,36821,5.185,21.975,999,1023,11107
2021,5121,15561,18573,218083,254662,3257,17.610,3102,16.772,35056,11676,23380,4.585,13.766,108958,21782,87176,8.553,42.785,-73902,-29.020,27.531,1725,1752,8822
2021,5122,3090,3330,23426,23822,677,20.902,495,15.282,4178,2784,1394,11.687,17.539,4917,1238,3679,5.197,20.641,-739,-3.102,35.078,303,305,738
2021,5151,3543,7199,214262,217477,862,12.221,571,8.095,29208,14010,15198,6.442,13.430,36052,10162,25890,4.673,16.577,-6844,-3.147,26.861,217,234,1272
2021,5152,345,829,57242,55661,152,16.495,337,36.571,10160,2493,7667,4.479,18.254,7177,4548,2629,8.171,12.894,2983,5.359,25.788,17,17,75
2021,5173,7672,54055,875313,913687,3721,6.717,6411,11.572,89366,28495,60871,3.119,9.781,162843,40977,121866,4.485,17.823,-73477,-8.042,19.562,734,842,5000
2021,5174,289,364,8222,8173,48,13.061,55,14.966,1173,258,915,3.157,14.352,1110,524,586,6.411,13.581,63,0.771,27.163,33,35,114
2021,5179,2873,4256,59175,58858,544,12.792,537,12.628,8849,2244,6605,3.813,15.034,8248,2557,5691,4.344,14.013,601,1.021,28.027,292,294,974
2021,5182,9647,15583,548968,553599,2268,14.262,2906,18.274,99500,34578,64922,6.246,17.973,107693,40220,67473,7.265,19.453,-8193,-1.480,35.947,835,864,9369
2021,5191,9544,11700,318636,324205,1797,15.741,1229,10.766,30651,10713,19938,3.304,9.454,41882,10319,31563,3.183,12.918,-11231,-3.464,18.908,840,842,4898
2021,5211,16,67,20728,20480,6,9.375,0,0.000,682,15,667,0.073,3.330,179,0,179,0.000,0.874,503,2.456,1.748,0,0,0
2021,5221,9491,110613,1948564,1957853,4507,4.030,6967,6.229,203620,54818,148802,2.800,10.400,222697,57260,165437,2.925,11.375,-19077,-0.974,20.800,228,309,4156
2021,5222,12727,44116,692923,666449,5171,11.793,4638,10.577,159632,53341,106291,8.004,23.953,105002,35792,69210,5.371,15.755,54630,8.197,31.511,1020,1210,5511
2021,5223,12965,26075,322366,319853,3048,11.736,2842,10.943,63145,21843,41302,6.829,19.742,58188,31180,27008,9.748,18.192,4957,1.550,36.384,881,1047,4109
2021,5231,8419,26321,356285,352781,3325,12.828,2522,9.730,55731,26341,29390,7.467,15.798,48411,18813,29598,5.333,13.723,7320,2.075,27.445,671,691,2375
2021,5232,20,43,5999,6020,3,6.977,3,6.977,368,41,327,0.681,6.113,429,4,425,0.066,7.126,-61,-1.013,12.226,3,3,3
2021,5239,49395,70942,578820,575911,8160,11.724,5478,7.871,80515,33219,47296,5.768,13.980,74195,29622,44573,5.144,12.883,6320,1.097,25.766,3783,3811,14212
2021,5241,5284,28511,1548740,1557428,2907,9.955,4286,14.678,145868,34539,111329,2.218,9.366,164641,46265,118376,2.971,10.571,-18773,-1.205,18.732,309,316,3469
2021,5242,118004,137979,1200223,1194015,13187,9.590,12251,8.909,180171,60675,119496,5.082,15.090,166541,70881,95660,5.936,13.948,13630,1.142,27.896,8258,8389,30542
2021,5259,1346,1404,8005,7884,391,29.825,205,15.637,1700,1195,505,15.157,21.563,1456,530,926,6.722,18.468,244,3.095,36.936,176,177,435
2021,5311,86315,119774,577788,592723,12454,10.440,11492,9.633,81395,41505,39890,7.002,13.732,111760,36958,74802,6.235,18.855,-30365,-5.123,27.465,7991,8066,22467
2021,5312,102305,116942,384064,373648,24927,22.182,15792,14.053,93141,50598,42543,13.542,24.927,73774,31312,42462,8.380,19.744,19367,5.183,39.489,7882,7952,14135
2021,5313,74661,93899,751443,751901,11511,12.432,8890,9.602,99670,44019,55651,5.854,13.256,100581,34458,66123,4.583,13.377,-911,-0.121,26.511,5670,5778,22284
2021,5321,3414,14673,142528,159406,1042,6.954,1664,11.105,9370,3546,5824,2.225,5.878,44213,6975,37238,4.376,27.736,-34843,-21.858,11.756,376,382,1530
2021,5322,6181,14240,97468,110449,1103,7.467,2168,14.676,11715,4212,7503,3.814,10.607,37176,11392,25784,10.314,33.659,-25461,-23.052,21.213,834,893,4542
2021,5323,1898,2581,17865,18698,187,7.181,233,8.948,1796,664,1132,3.551,9.606,3447,1305,2142,6.980,18.436,-1651,-8.830,19.211,135,143,830
2021,5324,7271,14702,177207,189240,1536,10.481,1443,9.846,22033,10801,11232,5.708,11.643,46175,10109,36066,5.342,24.400,-24142,-12.757,23.286,590,600,2998
2021,5331,2006,2144,37138,36711,224,10.344,267,12.330,5969,1473,4496,4.012,16.260,5120,1311,3809,3.571,13.947,849,2.313,27.894,189,189,907
2021,5411,151730,164897,1145649,1153719,13260,8.021,14084,8.520,114346,36631,77715,3.175,9.911,130761,35032,95729,3.036,11.334,-16415,-1.423,19.822,10651,10765,25628
2021,5412,104441,124241,1176044,1178179,12937,10.523,10342,8.412,169217,72987,96230,6.195,14.363,173418,59090,114328,5.015,14.719,-4201,-0.357,28.725,7099,7157,26469
2021,5413,82616,104338,1587093,1592919,10023,9.668,8689,8.381,189566,64767,124799,4.066,11.901,200775,53669,147106,3.369,12.604,-11209,-0.704,23.801,5422,5460,22180
2021,5414,28038,28430,118347,120987,4493,15.984,3853,13.707,18893,9169,9724,7.579,15.616,24189,8845,15344,7.311,19.993,-5296,-4.377,31.232,2553,2555,5673
2021,5415,103415,122766,2020386,2015739,17394,14.242,16133,13.209,296717,83250,213467,4.130,14.720,288822,114506,174316,5.681,14.328,7895,0.392,28.657,10203,10276,45855
2021,5416,148165,159189,1486246,1469549,32052,20.675,23731,15.308,288474,108427,180047,7.378,19.630,253348,92446,160902,6.291,17.240,35126,2.390,34.480,17049,17117,56510
2021,5417,15306,19155,831140,814407,2648,14.077,1959,10.414,109664,25120,84544,3.084,13.466,76350,27711,48639,3.403,9.375,33314,4.091,18.750,1255,1281,9240
2021,5418,28726,32508,432289,448882,4144,12.753,4115,12.664,45429,16596,28833,3.697,10.120,78834,20794,58040,4.632,17.562,-33405,-7.442,20.241,2746,2789,13628
2021,5419,56089,65138,697752,698090,9006,13.921,8117,12.547,120906,48758,72148,6.984,17.320,120974,50785,70189,7.275,17.329,-68,-0.010,34.639,5481,5622,35834
2021,5511,24765,50180,3462885,3508467,3821,7.574,4363,8.648,455134,102001,353133,2.907,12.972,543659,131231,412428,3.740,15.496,-88525,-2.523,25.945,818,951,18439
2021,5611,27932,31479,521795,529341,4246,13.699,3276,10.570,79920,29591,50329,5.590,15.098,95884,22903,72981,4.327,18.114,-15964,-3.016,30.196,2326,2358,15989
2021,5612,1998,8770,259575,272894,1966,23.399,1230,14.639,39457,16806,22651,6.158,14.459,65757,16200,49557,5.936,24.096,-26300,-9.637,28.917,126,139,1051
2021,5613,25085,52994,6064633,6052092,8478,16.531,5060,9.866,1012239,251077,761162,4.149,16.725,987807,191293,796514,3.161,16.322,24432,0.404,32.643,2317,2353,63497
2021,5614,20106,29472,787388,787809,2562,8.509,3835,12.737,138112,33176,104936,4.211,17.531,137170,39245,97925,4.982,17.412,942,0.120,34.823,1880,1914,14376
2021,5615,8581,12117,175323,197800,1208,8.660,4871,34.921,38283,14032,24251,7.094,19.354,81781,18445,63336,9.325,41.345,-43498,-21.991,38.709,2334,2358,7182
2021,5616,18480,24303,966949,981968,2723,11.266,2458,10.169,107836,39383,68453,4.011,10.982,136919,30315,106604,3.087,13.943,-29083,-2.962,21.963,1505,1526,13681
2021,5617,169659,178961,2035761,2057275,27537,15.702,20359,11.609,319415,129173,190242,6.279,15.526,361011,87770,273241,4.266,17.548,-41596,-2.022,31.052,14373,14400,59315
2021,5619,15049,17354,264722,286082,2072,11.793,2503,14.246,40712,18143,22569,6.342,14.231,82376,14041,68335,4.908,28.795,-41664,-14.564,28.462,1481,1498,7667
2021,5621,7525,11566,241255,237990,1027,9.010,691,6.062,24559,9411,15148,3.954,10.319,18068,6301,11767,2.648,7.592,6491,2.727,15.184,517,526,4382
2021,5622,1363,2819,61526,61784,351,12.890,159,5.839,8619,3186,5433,5.157,13.950,9087,1875,7212,3.035,14.708,-468,-0.757,27.900,77,77,653
2021,5629,9355,11075,153515,154653,1150,10.539,824,7.551,22829,9659,13170,6.246,14.761,24709,4744,19965,3.068,15.977,-1880,-1.216,29.523,587,588,3164
2021,6111,18648,21586,1045594,1074279,913,4.217,1043,4.817,62831,15988,46843,1.488,5.849,120502,16796,103706,1.563,11.217,-57671,-5.368,11.697,651,685,10794
2021,6112,403,723,51217,53851,27,3.694,43,5.882,2891,202,2689,0.375,5.369,8216,1336,6880,2.481,15.257,-5325,-9.888,10.737,10,18,553
2021,6113,2388,3996,1644358,1731013,189,4.685,265,6.569,43799,9333,34466,0.539,2.530,217537,6790,210747,0.392,12.567,-173738,-10.037,5.061,80,90,2241
2021,6114,7033,7447,74908,75274,1139,15.430,1008,13.656,12763,4642,8121,6.167,16.956,13562,5236,8326,6.956,18.017,-799,-1.061,33.911,654,655,2410
2021,6115,6395,7838,99717,103721,802,10.212,833,10.607,12932,4270,8662,4.117,12.468,20989,5716,15273,5.511,20.236,-8057,-7.768,24.936,526,580,3783
2021,6116,44501,48210,407535,445321,6168,12.631,7414,15.182,64752,25296,39456,5.680,14.541,139396,35079,104317,7.877,31.302,-74644,-16.762,29.081,4968,5029,22892
2021,6117,7776,8763,108910,112220,1658,19.409,1217,14.246,19106,7833,11273,6.980,17.026,25288,4945,20343,4.407,22.534,-6182,-5.509,34.051,835,837,2907
2021,6211,136175,196539,2616839,2583582,19479,9.955,17726,9.059,402793,168305,234488,6.514,15.590,337615,118221,219394,4.576,13.068,65178,2.523,26.135,11682,12041,56692
2021,6212,114507,128362,994459,984989,7897,6.135,8616,6.694,138705,44249,94456,4.492,14.082,120190,40048,80142,4.066,12.202,18515,1.880,24.404,6875,7009,33358
2021,6213,135855,163207,1046124,1029235,20017,12.520,13368,8.361,190085,74057,116028,7.195,18.469,156859,50897,105962,4.945,15.240,33226,3.228,30.481,8965,9201,30841
2021,6214,23428,52982,1230660,1226823,4398,8.436,2702,5.183,139463,50980,88483,4.155,11.368,131141,29812,101329,2.430,10.689,8322,0.678,21.379,1102,1174,10612
2021,6215,7737,18450,318389,308646,2319,12.778,1717,9.461,61658,25486,36172,8.257,19.977,42330,12645,29685,4.097,13.715,19328,6.262,27.429,591,626,4270
2021,6216,23944,34530,1580271,1583807,5213,15.615,2921,8.750,206796,65511,141285,4.136,13.057,213987,47119,166868,2.975,13.511,-7191,-0.454,26.114,1745,1793,21243
2021,6219,9607,14336,357929,360217,1486,10.313,1632,11.326,51288,19008,32280,5.277,14.238,55480,20009,35471,5.555,15.402,-4192,-1.164,28.476,444,492,6943
2021,6221,2391,5655,5576835,5624195,198,3.528,114,2.031,164760,13417,151343,0.239,2.929,260847,27904,232943,0.496,4.638,-96087,-1.708,5.859,34,36,11361
2021,6222,415,786,247550,250705,60,7.838,19,2.482,7063,2304,4759,0.919,2.817,13199,1763,11436,0.703,5.265,-6136,-2.448,5.635,7,7,462
2021,6223,298,798,259695,263686,80,10.250,45,5.766,20033,12600,7433,4.778,7.597,27065,5544,21521,2.103,10.264,-7032,-2.667,15.195,4,5,853
2021,6231,9213,16724,1421830,1502554,1106,6.671,817,4.928,94044,49831,44213,3.316,6.259,255170,50583,204587,3.366,16.982,-161126,-10.723,12.518,472,543,30989
2021,6232,10607,44261,758002,776912,2589,5.919,1542,3.526,72929,27635,45294,3.557,9.387,110952,20819,90133,2.680,14.281,-38023,-4.894,18.774,462,600,6979
2021,6233,17382,25652,952639,991703,2255,8.878,1749,6.886,74322,37770,36552,3.809,7.494,152965,28297,124668,2.853,15.424,-78643,-7.930,14.989,1149,1191,15399
2021,6239,3240,5838,122295,124667,478,8.306,312,5.421,12305,4593,7712,3.684,9.870,16962,5052,11910,4.052,13.606,-4657,-3.736,19.741,161,170,1233
2021,6241,60986,81338,1898263,1945033,10012,12.585,6445,8.101,223038,80108,142930,4.119,11.467,316400,53994,262406,2.776,16.267,-93362,-4.800,22.934,4022,4080,26370
2021,6242,10942,15255,223182,222012,1032,6.848,664,4.406,31626,6747,24879,3.039,14.245,29252,4705,24547,2.119,13.176,2374,1.069,26.352,339,354,1636
2021,6243,3727,6999,216710,243601,405,5.749,497,7.055,19111,5672,13439,2.328,7.845,72977,10496,62481,4.309,29.958,-53866,-22.112,15.690,152,172,3476
2021,6244,55291,71416,878998,949283,6666,9.225,8354,11.561,88247,43280,44967,4.559,9.296,228580,53034,175546,5.587,24.079,-140333,-14.783,18.592,5208,5393,30836
2021,7111,6952,7050,65129,94481,928,12.482,1697,22.826,6681,2816,3865,2.980,7.071,65154,12585,52569,13.320,68.960,-58473,-61.889,14.143,792,803,6404
2021,7112,3556,3765,101281,119856,596,16.089,475,12.822,9589,2831,6758,2.362,8.000,47005,3905,43100,3.258,39.218,-37416,-31.218,16.001,324,328,3040
2021,7113,6159,6749,103547,150236,796,11.364,1307,18.659,10702,3765,6937,2.506,7.123,104509,8982,95527,5.979,69.563,-93807,-62.440,14.247,634,634,3921
2021,7114,3213,3358,20320,22684,581,16.983,707,20.666,2405,1344,1061,5.925,10.602,7107,1768,5339,7.794,31.331,-4702,-20.729,21.205,390,390,935
2021,7115,20180,20223,51330,53996,5040,25.240,4530,22.686,14629,9328,5301,17.275,27.093,20166,8655,11511,16.029,37.347,-5537,-10.254,54.185,2712,2714,5145
2021,7121,6797,7268,120462,140518,412,5.643,479,6.560,4929,1698,3231,1.208,3.508,44868,1871,42997,1.332,31.931,-39939,-28.423,7.015,270,270,1104
2021,7131,2580,3120,149780,174786,399,12.069,771,23.321,12797,6951,5846,3.977,7.322,62391,8669,53722,4.960,35.696,-49594,-28.374,14.643,556,577,6520
2021,7132,1847,3071,117028,127810,249,8.121,239,7.795,7734,3417,4317,2.673,6.051,29769,3708,26061,2.901,23.292,-22035,-17.240,12.102,133,139,1476
2021,7139,55889,66118,1104296,1271346,7508,11.189,9473,14.118,129686,55602,74084,4.373,10.201,462129,85779,376350,6.747,36.350,-332443,-26.149,20.401,6212,6321,47246
2021,7211,43786,55817,1463524,1783627,4621,8.294,4418,7.930,96247,53454,42793,2.997,5.396,731167,72433,658734,4.061,40.993,-634920,-35.597,10.792,2867,2960,39491
2021,7212,5697,6372,43264,45835,628,9.937,523,8.276,6090,2003,4087,4.370,13.287,11302,1830,9472,3.993,24.658,-5212,-11.371,26.574,362,367,1309
2021,7213,1371,1539,8118,9063,87,5.473,188,11.828,1054,471,583,5.197,11.630,2957,575,2382,6.344,32.627,-1903,-20.997,23.259,120,120,285
2021,7223,17683,43464,624890,710521,8854,20.360,8899,20.464,139053,94594,44459,13.313,19.571,317380,68822,248558,9.686,44.669,-178327,-25.098,39.141,2960,3047,15919
2021,7224,31158,32126,283532,330994,3185,9.300,7425,21.681,47036,21104,25932,6.376,14.211,141933,55759,86174,16.846,42.881,-94897,-28.670,28.421,3951,3966,26062
2021,7225,384698,534665,9742537,10400386,52322,9.757,55443,10.339,1238883,601232,637651,5.781,11.912,2554343,660219,1894124,6.348,24.560,-1315460,-12.648,23.824,37294,38769,392876
2021,8111,134169,151245,909810,918425,14665,9.747,13077,8.692,126604,55903,70701,6.087,13.785,143801,47820,95981,5.207,15.657,-17197,-1.872,27.570,9331,9527,35146
2021,8112,9210,10561,104663,103944,1095,10.308,1219,11.475,17115,8884,8231,8.547,16.466,15652,4318,11334,4.154,15.058,1463,1.407,30.116,848,872,2918
2021,8113,17979,19861,198731,202886,1688,8.489,1736,8.730,21853,8063,13790,3.974,10.771,30262,7250,23012,3.573,14.916,-8409,-4.145,21.542,1242,1251,4423
2021,8114,17497,18257,74193,73610,2552,13.952,2620,14.324,13234,5764,7470,7.830,17.979,12051,5291,6760,7.188,16.371,1183,1.607,32.743,1789,1801,3678
2021,8121,112338,127224,681896,717062,21640,17.095,20361,16.085,125807,74478,51329,10.387,17.545,197114,67945,129169,9.475,27.489,-71307,-9.944,35.090,12923,14119,45703
2021,8122,13588,19793,132835,133423,1009,5.123,814,4.133,12960,4492,8468,3.367,9.714,14111,3593,10518,2.693,10.576,-1151,-0.863,19.427,542,573,2456
2021,8123,22360,27413,231071,255745,1950,6.809,4402,15.371,16593,7922,8671,3.098,6.488,66283,14368,51915,5.618,25.918,-49690,-19.430,12.976,2711,2822,9798
2021,8129,36329,46197,306085,344986,7985,17.326,7765,16.849,52091,27192,24899,7.882,15.099,129895,36875,93020,10.689,37.652,-77804,-22.553,30.199,4214,4238,16072
2021,8131,176614,177585,1488735,1572857,8566,4.809,9645,5.415,90475,25251,65224,1.605,5.752,258116,30155,227961,1.917,16.411,-167641,-10.658,11.505,6233,6233,18687
2021,8132,18204,20019,193888,198721,1683,8.429,1578,7.903,21210,6408,14802,3.225,10.673,30669,7464,23205,3.756,15.433,-9459,-4.760,21.347,916,917,3144
2021,8133,15518,17971,186583,188596,1509,8.373,1613,8.950,21798,6406,15392,3.397,11.558,25774,5951,19823,3.155,13.666,-3976,-2.108,23.116,768,771,3738
2021,8134,20254,21801,167572,192420,1515,6.773,2647,11.834,15536,5986,9550,3.111,8.074,65285,11747,53538,6.105,33.928,-49749,-25.854,16.148,1322,1329,5251
2021,8139,49748,51919,451599,469345,2244,4.271,3489,6.640,36897,9967,26930,2.124,7.861,72640,16287,56353,3.470,15.477,-35743,-7.616,15.723,2416,2423,10003
2022,1131,403,422,3742,3654,49,11.598,50,11.834,568,103,465,2.819,15.547,400,180,220,4.927,10.948,168,4.598,21.897,37,37,103
2022,1132,140,155,940,917,30,20.000,20,13.333,211,104,107,11.341,23.010,160,37,123,4.035,17.448,51,5.562,34.896,17,17,33
2022,1133,6637,6733,44918,45058,628,9.268,714,10.537,6160,1784,4376,3.959,13.671,6524,2218,4306,4.923,14.479,-364,-0.808,27.343,594,594,1761
2022,1141,1392,1402,5313,5156,253,18.001,260,18.499,1197,638,559,12.375,23.218,915,494,421,9.582,17.748,282,5.470,35.496,218,218,402
2022,1142,357,358,1872,1844,55,15.988,27,7.849,258,111,147,6.021,13.995,198,61,137,3.309,10.740,60,3.255,21.481,20,20,50
2022,1151,4028,4399,71980,70989,568,13.044,479,11.000,14886,4902,9984,6.905,20.969,12900,3935,8965,5.543,18.172,1986,2.798,36.344,385,386,2054
2022,1152,4140,4202,22824,22678,546,13.072,496,11.875,3988,1573,2415,6.936,17.586,3739,1442,2297,6.359,16.488,249,1.098,32.975,393,421,1166
2022,1153,1457,1594,15221,14453,183,11.509,175,11.006,3543,821,2722,5.680,24.514,1974,563,1411,3.895,13.658,1569,10.856,27.316,133,136,447
2022,2111,3681,4723,84655,86037,366,7.611,538,11.187,10790,3367,7423,3.913,12.541,13515,5815,7700,6.759,15.708,-2725,-3.167,25.082,372,389,3205
2022,2121,279,465,39608,38717,46,9.746,60,12.712,6506,1807,4699,4.667,16.804,4602,1229,3373,3.174,11.886,1904,4.918,23.773,31,41,861
2022,2122,224,291,40134,40380,36,12.544,28,9.756,1792,202,1590,0.500,4.438,2394,172,2222,0.426,5.929,-602,-1.491,8.876,23,23,128
2022,2123,2707,4949,87043,86704,300,6.042,333,6.706,10402,2459,7943,2.836,11.997,9893,3933,5960,4.536,11.410,509,0.587,22.820,137,141,1058
2022,2131,8462,10582,254520,240628,1298,12.211,1394,13.114,58382,12413,45969,5.159,24.262,30318,14346,15972,5.962,12.600,28064,11.663,25.199,901,934,6671
2022,2211,2130,12403,505308,500957,1055,8.610,755,6.162,52368,13492,38876,2.693,10.454,43683,11315,32368,2.259,8.720,8685,1.734,17.440,119,127,769
2022,2212,410,2384,91660,91036,141,5.874,174,7.248,11695,3675,8020,4.037,12.847,10681,3522,7159,3.869,11.733,1014,1.114,23.466,18,32,269
2022,2213,3607,4754,48423,47588,322,6.820,257,5.443,6266,2127,4139,4.470,13.167,4602,1757,2845,3.692,9.671,1664,3.497,19.341,172,173,863
2022,2361,169612,171594,885580,853288,32484,19.450,23329,13.968,204394,86530,117864,10.141,23.954,139283,62250,77033,7.295,16.323,65111,7.631,32.646,19520,19538,50965
2022,2362,36129,37934,696493,684463,3561,9.380,3622,9.540,105713,20437,85276,2.986,15.445,81457,19344,62113,2.826,11.901,24256,3.544,23.802,2949,2956,13276
2022,2371,16127,18040,599711,591175,1445,7.996,1506,8.334,98123,19648,78475,3.324,16.598,81228,19365,61863,3.276,13.740,16895,2.858,27.480,1121,1136,12682
2022,2372,3745,3857,23066,22305,464,12.140,394,10.309,4561,1553,3008,6.963,20.449,2986,1565,1421,7.017,13.387,1575,7.061,26.775,329,329,889
2022,2373,7555,8304,306452,304334,548,6.531,721,8.593,43574,5657,37917,1.859,14.318,39677,12091,27586,3.973,13.037,3897,1.281,26.075,418,425,3686
2022,2379,3912,4049,82021,82640,450,11.239,360,8.991,12636,3129,9507,3.786,15.291,13571,2940,10631,3.558,16.422,-935,-1.131,30.581,272,272,1637
2022,2381,86940,88390,922247,915475,12100,13.860,9925,11.369,161883,47903,113980,5.233,17.683,148079,40895,107184,4.467,16.175,13804,1.508,32.350,8067,8070,30910
2022,2382,173198,179228,2268371,2220912,18979,10.714,14812,8.362,356615,93602,263013,4.215,16.057,261376,85993,175383,3.872,11.769,95239,4.288,23.538,12167,12224,63285
2022,2383,108191,109871,845148,833250,15253,14.072,12294,11.342,150578,45515,105063,5.462,18.071,126979,39514,87465,4.742,15.239,23599,2.832,30.478,10124,10134,31335
2022,2389,65450,66422,729194,709455,9366,14.388,6714,10.314,126581,34091,92490,4.805,17.842,87206,29986,57220,4.227,12.292,39375,5.550,24.584,5403,5412,21193
2022,3111,1143,1799,60011,58831,92,5.117,90,5.006,7866,976,6890,1.659,13.371,5681,1235,4446,2.099,9.657,2185,3.714,19.313,66,66,712
2022,3112,553,919,59357,59184,52,5.674,47,5.128,4454,554,3900,0.936,7.526,4126,928,3198,1.568,6.971,328,0.554,13.943,28,28,332
2022,3113,1609,1794,86873,85061,178,10.011,146,8.211,11151,2044,9107,2.403,13.109,7598,2134,5464,2.509,8.932,3553,4.177,17.865,110,110,1010
2022,3114,1475,1848,162686,163444,148,8.024,141,7.644,15906,4013,11893,2.455,9.732,17338,2972,14366,1.818,10.608,-1432,-0.876,19.464,99,99,1019
2022,3115,1092,1608,161760,158820,121,7.608,86,5.407,14281,2655,11626,1.672,8.992,8584,1738,6846,1.094,5.405,5697,3.587,10.810,67,68,1032
2022,3116,2796,3484,533718,539121,282,8.181,208,6.034,33353,4630,28723,0.859,6.187,44276,5001,39275,0.928,8.213,-10923,-2.026,12.373,145,145,2032
2022,3117,399,492,29137,28613,32,6.471,37,7.482,4254,435,3819,1.520,14.867,3194,1118,2076,3.907,11.163,1060,3.705,22.326,24,24,220
2022,3118,10885,11812,304097,294984,1671,14.496,1102,9.560,44677,12352,32325,4.187,15.146,26609,9690,16919,3.285,9.021,18068,6.125,18.041,949,955,6328
2022,3119,3783,4386,251351,240984,526,12.238,350,8.143,38569,5802,32767,2.408,16.005,18115,4716,13399,1.957,7.517,20454,8.488,15.034,263,266,3307
2022,3121,10341,11290,268058,251965,1384,12.682,630,5.773,49688,10296,39392,4.086,19.720,17385,5635,11750,2.236,6.900,32303,12.820,13.800,511,514,3934
2022,3122,100,123,11742,11647,14,11.245,17,13.655,921,203,718,1.743,7.908,747,57,690,0.489,6.414,174,1.494,12.828,15,15,52
2022,3131,194,243,20711,20266,22,9.035,23,9.446,2482,879,1603,4.337,12.247,1593,88,1505,0.434,7.860,889,4.387,15.721,21,21,85
2022,3132,659,752,40845,40846,45,5.964,50,6.627,3909,432,3477,1.058,9.570,3859,795,3064,1.946,9.448,50,0.122,18.896,37,37,297
2022,3133,673,708,22146,22097,68,9.639,63,8.930,2296,533,1763,2.412,10.391,2222,646,1576,2.923,10.056,74,0.335,20.111,48,48,380
2022,3141,1184,1271,47933,47853,87,6.797,105,8.203,4058,617,3441,1.289,8.480,3916,702,3214,1.467,8.183,142,0.297,16.367,82,82,472
2022,3149,3426,3534,57839,56650,321,9.090,316,8.948,8112,1762,6350,3.110,14.320,5738,1920,3818,3.389,10.129,2374,4.191,20.258,249,250,1168
2022,3151,194,202,8943,8667,19,9.620,10,5.063,1218,43,1175,0.496,14.053,657,67,590,0.773,7.580,561,6.473,15.161,10,10,67
2022,3152,3583,3651,52318,50990,611,17.055,474,13.231,10065,2817,7248,5.525,19.739,7510,2563,4947,5.026,14.728,2555,5.011,29.457,427,431,2107
2022,3159,595,607,9104,8626,130,22.688,62,10.820,1872,686,1186,7.953,21.702,900,250,650,2.898,10.434,972,11.268,20.867,56,56,202
2022,3161,143,152,3118,3030,14,9.272,12,7.947,329,28,301,0.924,10.858,151,36,115,1.188,4.983,178,5.875,9.967,10,10,32
2022,3162,189,198,9938,9666,24,12.152,23,11.646,1346,190,1156,1.966,13.925,798,301,497,3.114,8.256,548,5.669,16.511,17,17,68
2022,3169,661,669,12146,11962,60,9.036,50,7.530,1483,233,1250,1.948,12.398,1114,245,869,2.048,9.313,369,3.085,18.626,44,44,221
2022,3211,2401,2880,89590,88627,204,7.070,215,7.451,9444,1899,7545,2.143,10.656,7484,2600,4884,2.934,8.444,1960,2.212,16.889,158,158,1318
2022,3212,968,1390,85085,82950,74,5.324,74,5.324,10143,1073,9070,1.294,12.228,5914,2183,3731,2.632,7.130,4229,5.098,14.259,56,57,1352
2022,3219,7620,8792,269567,260503,760,8.653,743,8.459,41141,7325,33816,2.812,15.793,23452,10474,12978,4.021,9.003,17689,6.790,18.005,494,501,4299
2022,3221,205,405,91665,90624,11,2.699,16,3.926,6188,359,5829,0.396,6.828,4178,1152,3026,1.271,4.610,2010,2.218,9.221,4,4,30
2022,3222,1995,3324,263129,258344,120,3.590,158,4.726,25995,3599,22396,1.393,10.062,16377,4797,11580,1.857,6.339,9618,3.723,12.678,93,95,2410
2022,3231,19850,21150,388144,382176,1769,8.363,1773,8.382,51377,10505,40872,2.749,13.443,39182,15969,23213,4.178,10.252,12195,3.191,20.505,1410,1417,8291
2022,3241,814,2043,100336,99908,135,6.658,104,5.129,9283,1130,8153,1.131,9.292,8236,2105,6131,2.107,8.244,1047,1.048,16.487,18,18,265
2022,3251,1183,2567,164133,159695,365,14.688,201,8.089,21567,7461,14106,4.672,13.505,13024,4885,8139,3.059,8.156,8543,5.350,16.311,60,61,746
2022,3252,1083,1472,110492,107911,90,6.179,59,4.051,12324,2797,9527,2.592,11.421,7317,2354,4963,2.181,6.781,5007,4.640,13.561,38,39,708
2022,3253,710,986,34366,33893,74,7.547,63,6.425,3250,858,2392,2.531,9.589,2264,646,1618,1.906,6.680,986,2.909,13.360,44,46,373
2022,3254,2140,2708,314244,302794,286,10.664,234,8.725,41120,8832,32288,2.917,13.580,17807,4505,13302,1.488,5.881,23313,7.699,11.762,175,180,1944
2022,3255,1236,1602,72170,69458,105,6.571,97,6.070,10507,2435,8072,3.506,15.127,5043,1967,3076,2.832,7.261,5464,7.867,14.521,60,61,461
2022,3256,2082,2353,110726,111067,249,10.650,219,9.367,11282,2607,8675,2.347,10.158,12072,3449,8623,3.105,10.869,-790,-0.711,20.316,166,166,1358
2022,3259,1654,2124,87460,86181,155,7.246,185,8.649,9828,2451,7377,2.844,11.404,7292,2462,4830,2.857,8.461,2536,2.943,16.923,116,121,976
2022,3261,6783,9321,670990,660417,429,4.580,522,5.572,70760,10716,60044,1.623,10.714,49622,15372,34250,2.328,7.514,21138,3.201,15.027,337,342,4878
2022,3262,1269,1759,140578,137822,125,7.188,85,4.888,13371,2070,11301,1.502,9.702,7994,1134,6860,0.823,5.800,5377,3.901,11.600,48,51,502
2022,3271,782,943,35721,34902,80,8.533,69,7.360,3625,424,3201,1.215,10.386,1961,526,1435,1.507,5.619,1664,4.768,11.237,44,44,232
2022,3272,1212,1463,88574,88166,111,7.650,87,5.996,8521,1198,7323,1.359,9.665,7690,2725,4965,3.091,8.722,831,0.943,17.444,59,62,966
2022,3273,3551,8493,185247,183786,343,4.005,487,5.686,24456,3950,20506,2.149,13.307,21959,7204,14755,3.920,11.948,2497,1.359,23.896,196,214,1828
2022,3274,121,272,15759,15348,8,2.914,13,4.736,1893,31,1862,0.202,12.334,1023,95,928,0.619,6.666,870,5.669,13.331,5,5,13
2022,3279,2624,3138,81770,83194,198,6.298,210,6.679,8999,1629,7370,1.958,10.817,11644,2824,8820,3.394,13.996,-2645,-3.179,21.634,131,132,1052
2022,3311,174,287,78786,77095,13,4.452,23,7.877,5677,126,5551,0.163,7.364,2123,767,1356,0.995,2.754,3554,4.610,5.508,11,11,124
2022,3312,473,679,52454,51574,30,4.412,32,4.706,6094,763,5331,1.479,11.816,4300,528,3772,1.024,8.338,1794,3.479,16.675,20,21,296
2022,3313,296,430,58160,57174,19,4.403,22,5.098,5913,598,5315,1.046,10.342,4031,1527,2504,2.671,7.050,1882,3.292,14.101,15,15,61
2022,3314,552,743,55068,54235,38,5.132,33,4.456,5262,822,4440,1.516,9.702,3551,903,2648,1.665,6.547,1711,3.155,13.095,17,17,143
2022,3315,1142,1333,106515,103468,43,3.193,70,5.199,12066,1516,10550,1.465,11.662,6005,1683,4322,1.627,5.804,6061,5.858,11.608,50,53,1104
2022,3321,1666,1919,93576,93077,55,2.830,104,5.351,8460,868,7592,0.933,9.089,7500,2191,5309,2.354,8.058,960,1.031,16.116,77,78,1360
2022,3322,885,978,33270,32859,72,7.385,66,6.769,3236,527,2709,1.604,9.848,2422,511,1911,1.555,7.371,814,2.477,14.742,54,54,297
2022,3323,12325,13482,421862,407555,899,6.673,881,6.539,62504,26951,35553,6.613,15.336,34997,11836,23161,2.904,8.587,27507,6.749,17.174,671,677,6023
2022,3324,1038,1352,88193,85848,65,4.792,74,5.455,10898,1692,9206,1.971,12.695,6222,1426,4796,1.661,7.248,4676,5.447,14.495,50,50,659
2022,3325,456,507,30450,30144,36,7.101,36,7.101,3529,505,3024,1.675,11.707,2924,1203,1721,3.991,9.700,605,2.007,19.401,25,25,339
2022,3326,827,975,34584,34687,30,3.033,58,5.865,3324,467,2857,1.346,9.583,3530,1178,2352,3.396,10.177,-206,-0.594,19.166,41,41,423
2022,3327,20225,20889,355063,351017,1194,5.689,1390,6.623,38854,7451,31403,2.123,11.069,30749,11546,19203,3.289,8.760,8105,2.309,17.520,1116,1124,7638
2022,3328,4595,5165,117861,117154,276,5.317,328,6.319,13401,2189,11212,1.868,11.439,11931,4950,6981,4.225,10.184,1470,1.255,20.368,247,248,2523
2022,3329,5188,5758,252610,247958,446,7.771,409,7.126,27554,3975,23579,1.603,11.112,18160,5746,12414,2.317,7.324,9394,3.789,14.648,297,297,2179
2022,3331,2335,2705,190190,185940,165,6.073,189,6.956,20101,1544,18557,0.830,10.811,11555,5489,6066,2.952,6.214,8546,4.596,12.429,131,135,1532
2022,3332,2564,2761,114737,111117,181,6.541,193,6.975,15227,3219,12008,2.897,13.704,8101,3069,5032,2.762,7.291,7126,6.413,14.581,134,135,1008
2022,3333,1464,1617,77039,73651,90,5.474,144,8.759,12212,1865,10347,2.532,16.581,5326,2638,2688,3.582,7.231,6886,9.349,14.463,108,109,1160
2022,3334,1273,1574,146976,139837,65,4.085,99,6.223,20931,584,20347,0.418,14.968,6324,2194,4130,1.569,4.522,14607,10.446,9.045,75,75,925
2022,3335,5366,5666,135979,134548,269,4.706,369,6.456,14064,2651,11413,1.970,10.453,11099,4536,6563,3.371,8.249,2965,2.204,16.498,289,289,2056
2022,3336,685,871,94532,92176,45,5.187,38,4.380,9575,868,8707,0.942,10.388,5034,1150,3884,1.248,5.461,4541,4.926,10.923,24,24,138
2022,3339,4753,5539,305341,300953,291,5.240,320,5.762,32566,5548,27018,1.843,10.821,23672,7762,15910,2.579,7.866,8894,2.955,15.731,233,233,2788
2022,3341,542,560,36415,36237,44,7.652,74,12.870,3130,277,2853,0.764,8.638,2824,867,1957,2.393,7.793,306,0.844,15.586,59,59,532
2022,3342,995,1093,71511,74702,84,7.685,84,7.685,9114,2397,6717,3.209,12.201,16045,3569,12476,4.778,21.479,-6931,-9.278,24.401,57,57,599
2022,3343,470,488,10469,9954,48,10.095,23,4.837,1621,380,1241,3.818,16.285,572,283,289,2.843,5.746,1049,10.538,11.493,13,13,140
2022,3344,2983,3464,267941,261253,169,4.831,237,6.775,31741,4657,27084,1.783,12.150,18105,4902,13203,1.876,6.930,13636,5.219,13.860,176,180,2186
2022,3345,3985,4745,402562,400025,250,5.209,359,7.480,34274,6367,27907,1.592,8.568,29218,11256,17962,2.814,7.304,5056,1.264,14.608,232,232,2059
2022,3346,282,284,5503,5409,38,13.428,36,12.721,692,172,520,3.180,12.795,504,168,336,3.106,9.319,188,3.476,18.637,32,32,141
2022,3351,886,961,35034,35298,87,9.053,87,9.053,2668,588,2080,1.666,7.559,3163,1174,1989,3.326,8.961,-495,-1.402,15.117,67,68,671
2022,3352,274,333,59484,57423,41,12.615,25,7.692,7785,1781,6004,3.102,13.557,3357,556,2801,0.968,5.846,4428,7.711,11.692,16,16,174
2022,3353,1470,1740,119913,118885,90,5.136,115,6.562,10636,2022,8614,1.701,8.946,8360,2754,5606,2.317,7.032,2276,1.914,14.064,81,82,720
2022,3359,1712,2014,139793,134802,146,7.264,138,6.866,18666,2221,16445,1.648,13.847,8690,3246,5444,2.408,6.447,9976,7.401,12.893,101,102,1465
2022,3361,257,343,271873,256785,51,15.361,29,8.735,43538,12236,31302,4.765,16.955,14264,1275,12989,0.497,5.555,29274,11.400,11.110,24,24,687
2022,3362,1616,2043,177453,174736,193,9.655,105,5.253,18526,3829,14697,2.191,10.602,13206,2017,11189,1.154,7.558,5320,3.045,15.115,85,85,1382
2022,3363,3445,4461,570936,569340,260,5.833,253,5.676,53033,9811,43222,1.723,9.315,49846,10064,39782,1.768,8.755,3187,0.560,17.510,167,168,2746
2022,3364,1243,1729,385616,385704,122,7.034,133,7.668,26144,5760,20384,1.493,6.778,25828,8206,17622,2.128,6.696,316,0.082,13.393,83,85,995
2022,3365,125,205,24366,24350,6,2.864,15,7.160,2285,126,2159,0.517,9.384,2364,830,1534,3.409,9.709,-79,-0.324,18.768,4,6,157
2022,3366,1161,1301,146262,145390,108,8.327,100,7.710,11160,2055,9105,1.413,7.676,9193,1219,7974,0.838,6.323,1967,1.353,12.646,83,83,943
2022,3369,821,856,40542,38701,117,14.165,57,6.901,6555,716,5839,1.850,16.938,2783,540,2243,1.395,7.191,3772,9.747,14.382,47,47,195
2022,3371,9097,9367,229790,223457,820,8.786,751,8.047,28473,4449,24024,1.991,12.742,15576,4824,10752,2.159,6.970,12897,5.772,13.941,601,602,2809
2022,3372,3308,3448,105798,103659,248,7.179,261,7.555,12428,1426,11002,1.376,11.989,8210,2661,5549,2.567,7.920,4218,4.069,15.840,207,208,1614
2022,3379,582,682,35185,35692,48,7.007,54,7.883,4990,1336,3654,3.743,13.981,5820,2028,3792,5.682,16.306,-830,-2.325,27.962,32,35,588
2022,3391,7431,8434,304458,300632,665,7.841,759,8.949,39172,11471,27701,3.816,13.030,31307,6010,25297,1.999,10.414,7865,2.616,20.827,636,636,3482
2022,3399,13132,13674,252532,245961,1319,9.715,1125,8.286,34969,6362,28607,2.587,14.217,21895,6310,15585,2.565,8.902,13074,5.315,17.804,890,894,4259
2022,4231,13164,21569,416297,409649,1603,7.440,1559,7.235,57491,14981,42510,3.657,14.034,44524,15695,28829,3.831,10.869,12967,3.165,21.738,970,1034,7990
2022,4232,9252,11199,165625,161583,766,6.789,935,8.286,24337,5068,19269,3.136,15.062,16242,5729,10513,3.546,10.052,8095,5.010,20.104,663,705,3895
2022,4233,9499,17035,265681,263391,1193,6.974,1338,7.821,35184,10076,25108,3.825,13.358,30758,14157,16601,5.375,11.678,4426,1.680,23.355,598,641,5111
2022,4234,19744,31386,667631,661545,1971,6.197,2807,8.826,83776,17014,66762,2.572,12.664,70793,27812,42981,4.204,10.701,12983,1.963,21.402,1685,1733,10513
2022,4235,6108,8499,142854,140215,432,5.028,617,7.182,19438,4470,14968,3.188,13.863,13989,5534,8455,3.947,9.977,5449,3.886,19.954,343,379,2703
2022,4236,15702,24958,516465,507290,1585,6.281,2137,8.469,71532,10802,60730,2.129,14.101,52987,20322,32665,4.006,10.445,18545,3.656,20.890,1204,1293,7737
2022,4237,8808,19395,276712,271988,1163,6.016,1035,5.354,33970,9194,24776,3.380,12.490,24651,8116,16535,2.984,9.063,9319,3.426,18.127,558,675,4357
2022,4238,34555,52201,765494,754385,2738,5.194,3773,7.157,101957,21862,80095,2.898,13.515,79787,30632,49155,4.061,10.576,22170,2.939,21.153,2072,2223,13595
2022,4239,25505,29076,335856,326056,3201,11.138,2529,8.800,56213,15120,41093,4.637,17.240,36322,14690,21632,4.505,11.140,19891,6.100,22.280,1873,1919,9270
2022,4241,5499,7414,130895,131003,342,4.521,644,8.513,14327,1959,12368,1.495,10.936,14678,5990,8688,4.572,11.204,-351,-0.268,21.873,407,426,2795
2022,4242,6422,9362,310597,307384,730,7.674,1032,10.848,39820,7919,31901,2.576,12.954,32935,15104,17831,4.914,10.715,6885,2.240,21.429,595,601,3545
2022,4243,11594,12398,172063,167414,1506,12.263,1272,10.357,30769,5535,25234,3.306,18.379,21684,10915,10769,6.520,12.952,9085,5.427,25.905,940,963,5134
2022,4244,24938,32287,845140,813666,3091,9.652,2567,8.016,131200,50944,80256,6.261,16.125,70070,27008,43062,3.319,8.612,61130,7.513,17.223,1849,1888,12501
2022,4245,3064,5870,64982,63733,323,5.469,395,6.688,10712,2840,7872,4.456,16.808,8145,2365,5780,3.711,12.780,2567,4.028,25.560,220,239,1489
2022,4246,6771,11133,162893,160671,505,4.478,792,7.023,19776,3900,15876,2.427,12.308,15027,5604,9423,3.488,9.353,4749,2.956,18.705,425,434,2708
2022,4247,3388,6053,98576,97591,465,7.710,422,6.997,13044,2713,10331,2.780,13.366,11196,3260,7936,3.340,11.472,1848,1.894,22.945,222,238,1581
2022,4248,3293,4484,210055,205211,416,9.370,327,7.366,22324,3811,18513,1.857,10.879,12385,5067,7318,2.469,6.035,9939,4.843,12.071,223,233,1814
2022,4249,18910,25759,330645,324482,2358,9.205,2074,8.096,45586,12339,33247,3.803,14.049,33329,12295,21034,3.789,10.271,12257,3.777,20.543,1405,1497,7491
2022,4251,28946,31013,249860,249923,3608,11.626,3652,11.767,41060,16907,24153,6.765,16.429,40909,22368,18541,8.950,16.369,151,0.060,32.737,2885,2941,9569
2022,4411,36753,44135,1295524,1279450,4150,9.452,3689,8.402,156133,58991,97142,4.611,12.203,123981,47797,76184,3.736,9.690,32152,2.513,19.380,2829,2893,34074
2022,4412,10694,13037,171502,167542,1160,8.957,988,7.629,28592,10306,18286,6.151,17.066,20664,8966,11698,5.352,12.334,7928,4.732,24.667,710,757,6632
2022,4413,24275,57189,558897,549705,2936,5.127,3089,5.394,71809,18844,52965,3.428,13.063,53126,23743,29383,4.319,9.664,18683,3.399,19.329,1854,1945,8594
2022,4421,11762,21227,197033,196292,1565,7.401,1401,6.626,26321,8765,17556,4.465,13.409,24867,6983,17884,3.557,12.668,1454,0.741,25.337,842,901,4025
2022,4422,15266,21769,246139,238692,1419,6.518,1420,6.523,37008,5313,31695,2.226,15.504,23358,5943,17415,2.490,9.786,13650,5.719,19.572,998,1033,3441
2022,4431,11878,20582,220287,220877,1136,5.378,2216,10.491,21439,4102,17337,1.857,9.706,22512,13167,9345,5.961,10.192,-1073,-0.486,19.413,1160,1295,6752
2022,4441,30423,53304,1266587,1235853,3034,5.694,2991,5.613,141699,21317,120382,1.725,11.466,82086,17446,64640,1.412,6.642,59613,4.824,13.284,1835,1932,11371
2022,4442,12096,16659,179249,175057,1249,7.539,1067,6.440,26482,6646,19836,3.796,15.128,17765,6366,11399,3.637,10.148,8717,4.980,20.296,756,825,5075
2022,4451,64751,90775,2965198,2980832,8764,9.734,7276,8.082,221272,73648,147624,2.471,7.423,254600,56943,197657,1.910,8.541,-33328,-1.118,14.846,5403,5530,31462
2022,4452,17279,20429,164199,161077,3010,15.115,1981,9.948,35978,15236,20742,9.459,22.336,29371,9720,19651,6.034,18.234,6607,4.102,36.468,1390,1448,6512
2022,4453,29242,33537,193783,189218,3211,9.659,2625,7.896,35823,13016,22807,6.879,18.932,26636,9269,17367,4.899,14.077,9187,4.855,28.154,1985,2015,7033
2022,4461,38429,87240,1037059,1011080,6512,7.442,7049,8.055,162920,54621,108299,5.402,16.113,110345,56509,53836,5.589,10.914,52575,5.200,21.827,3391,3625,16074
2022,4471,57072,104230,989389,979914,7378,7.055,8068,7.715,160912,58815,102097,6.002,16.421,139553,45689,93864,4.663,14.241,21359,2.180,28.483,4973,5294,25074
2022,4481,30261,78042,1139264,1093430,7288,9.331,7413,9.491,227285,54834,172451,5.015,20.786,138098,45448,92650,4.156,12.630,89187,8.157,25.260,3015,3726,16010
2022,4482,3906,17796,202319,202154,798,4.416,1348,7.459,24979,4360,20619,2.157,12.356,25702,6791,18911,3.359,12.714,-723,-0.358,24.713,309,558,1371
2022,4483,12830,18875,108434,105030,1802,9.702,1198,6.450,20045,5722,14323,5.448,19.085,13291,4178,9113,3.978,12.655,6754,6.431,25.309,708,729,2066
2022,4511,22989,33243,422384,416985,3321,10.142,2326,7.103,53835,15412,38423,3.696,12.911,42564,10877,31687,2.608,10.208,11271,2.703,20.415,1689,1756,6518
2022,4512,2930,6119,50883,48711,622,10.322,436,7.235,8301,2592,5709,5.321,17.041,4151,1535,2616,3.151,8.522,4150,8.520,17.043,208,212,598
2022,4522,16,2970,247904,288894,35,1.060,700,21.196,22177,1416,20761,0.490,7.677,96829,68540,28289,23.725,33.517,-74652,-25.841,15.353,3,13,38
2022,4523,6807,53794,2449732,2442736,4380,8.367,1492,2.850,175104,43074,132030,1.763,7.168,160265,10915,149350,0.447,6.561,14839,0.607,13.122,690,991,2769
2022,4531,10281,10702,57007,53549,1357,12.875,1032,9.792,14174,4778,9396,8.923,26.469,7335,3244,4091,6.058,13.698,6839,12.771,27.395,809,821,2505
2022,4532,14076,21237,168848,164355,2441,11.670,1801,8.610,28912,8661,20251,5.270,17.591,20233,8940,11293,5.439,12.311,8679,5.281,24.621,1106,1154,4352
2022,4533,11639,17808,208775,200771,1696,9.644,1251,7.114,36648,9197,27451,4.581,18.254,20835,6462,14373,3.219,10.378,15813,7.876,20.755,889,917,3250
2022,4539,38648,51456,361155,343437,8217,16.602,4294,8.676,79064,36042,43022,10.495,23.021,43928,18394,25534,5.356,12.791,35136,10.231,25.581,3242,3459,14076
2022,4541,44322,46352,777820,753333,9676,21.541,6808,15.157,126668,41051,85617,5.449,16.814,78712,32757,45955,4.348,10.449,47956,6.366,20.897,5919,5942,25227
2022,4542,2252,2912,38792,37094,385,13.315,344,11.897,6965,2095,4870,5.648,18.777,3503,1629,1874,4.392,9.444,3462,9.333,18.887,293,293,940
2022,4543,21737,27864,193583,185694,3937,14.415,2831,10.366,41425,21176,20249,11.404,22.308,24882,11226,13656,6.045,13.399,16543,8.909,26.799,2246,2279,8451
2022,4811,428,2089,456417,436791,107,5.115,113,5.402,48017,996,47021,0.228,10.993,9320,3351,5969,0.767,2.134,38697,8.859,4.267,34,36,223
2022,4812,1852,2149,52912,50532,280,13.242,211,9.979,9010,1130,7880,2.236,17.830,4180,1069,3111,2.115,8.272,4830,9.558,16.544,156,157,481
2022,4831,647,897,41157,39751,117,12.717,163,17.717,6449,707,5742,1.779,16.224,3547,1182,2365,2.974,8.923,2902,7.301,17.846,66,116,420
2022,4832,502,575,19402,19083,89,16.065,47,8.484,1721,260,1461,1.363,9.019,1082,136,946,0.713,5.670,639,3.349,11.340,39,39,105
2022,4841,85440,98632,1219929,1193232,24452,26.392,12489,13.480,200785,85245,115540,7.144,16.827,148992,62509,86483,5.239,12.486,51793,4.341,24.973,10094,10230,39701
2022,4842,42902,46635,505581,502309,7224,15.721,5859,12.750,83442,30561,52881,6.084,16.612,77547,28279,49268,5.630,15.438,5895,1.174,30.876,4831,4876,20509
2022,4851,380,600,45331,44938,70,11.885,48,8.149,3191,447,2744,0.995,7.101,2350,797,1553,1.774,5.229,841,1.871,10.459,26,26,136
2022,4852,242,529,13533,13876,49,9.405,33,6.334,1358,211,1147,1.521,9.787,2157,172,1985,1.240,15.545,-799,-5.758,19.573,22,25,118
2022,4853,5709,5880,47416,45949,1894,35.123,919,17.042,16641,4954,11687,10.782,36.217,13117,10992,2125,23.922,28.547,3524,7.669,57.094,777,780,3127
2022,4854,2244,3822,210582,206251,249,6.550,208,5.472,21885,3765,18120,1.825,10.611,13266,2718,10548,1.318,6.432,8619,4.179,12.864,171,172,1564
2022,4855,900,1022,24413,20912,200,20.597,98,10.093,8109,901,7208,4.309,38.778,1092,520,572,2.487,5.222,7017,33.556,10.444,79,83,428
2022,4859,4674,5197,86980,83495,985,19.354,770,15.129,20893,8472,12421,10.147,25.023,13879,6267,7612,7.506,16.623,7014,8.401,33.245,602,608,3679
2022,4861,72,642,9714,9955,18,2.799,20,3.110,739,161,578,1.617,7.424,1224,225,999,2.260,12.296,-485,-4.872,14.848,8,8,16
2022,4862,105,2006,25867,25815,74,3.659,107,5.290,2682,429,2253,1.662,10.390,2591,687,1904,2.661,10.037,91,0.353,20.074,9,9,102
2022,4869,86,709,8964,8723,77,11.332,18,2.649,1052,466,586,5.343,12.061,541,160,381,1.834,6.202,511,5.858,12.405,4,4,61
2022,4871,534,568,8400,7212,149,28.327,65,12.357,2926,632,2294,8.764,40.574,492,224,268,3.106,6.822,2434,33.752,13.645,50,50,169
2022,4872,1560,1623,12730,11277,331,21.184,210,13.440,4167,963,3204,8.540,36.953,1210,616,594,5.463,10.730,2957,26.223,21.461,172,172,461
2022,4879,188,219,2809,2472,41,19.159,31,14.486,873,122,751,4.935,35.316,204,116,88,4.693,8.252,669,27.063,16.505,26,26,106
2022,4881,3941,6021,209333,200932,543,9.109,423,7.096,36317,9046,27271,4.502,18.074,20206,7653,12553,3.809,10.056,16111,8.018,20.112,294,300,1842
2022,4882,551,1693,44927,43566,213,12.901,129,7.813,8307,4034,4273,9.260,19.068,5269,1590,3679,3.650,12.094,3038,6.973,24.189,41,50,387
2022,4883,1793,2368,81703,77856,160,6.704,197,8.255,14283,1308,12975,1.680,18.345,6570,1439,5131,1.848,8.439,7713,9.907,16.877,121,123,716
2022,4884,11049,12811,123948,119682,1926,15.313,1459,11.600,25045,8397,16648,7.016,20.926,16593,5769,10824,4.820,13.864,8452,7.062,27.728,1139,1145,4443
2022,4885,14119,20499,322302,311128,2399,11.857,1867,9.227,64368,19608,44760,6.302,20.689,41445,14682,26763,4.719,13.321,22923,7.368,26.642,1048,1120,6549
2022,4889,1846,2016,27889,25767,353,18.233,193,9.969,7192,3371,3821,13.083,27.912,2859,1084,1775,4.207,11.096,4333,16.816,22.191,162,162,838
2022,4921,5142,10599,1047463,1000878,1301,12.525,878,8.452,202047,31235,170812,3.121,20.187,98029,17471,80558,1.746,9.794,104018,10.393,19.589,545,559,10838
2022,4922,4219,4755,149855,148612,773,16.461,655,13.948,33903,14526,19377,9.774,22.813,32043,9018,23025,6.068,21.562,1860,1.252,43.123,481,535,7209
2022,4931,8398,18870,1295175,1249484,2762,15.098,1609,8.795,183922,60510,123412,4.843,14.720,93857,31453,62404,2.517,7.512,90065,7.208,15.023,465,509,6390
2022,5111,9807,13513,277152,303751,1168,8.590,1335,9.819,30441,9250,21191,3.045,10.022,87462,26633,60829,8.768,28.794,-57021,-18.772,20.043,810,861,4359
2022,5112,11404,15116,813967,771645,2686,18.145,2060,13.916,176078,44775,131303,5.803,22.819,89453,38941,50512,5.046,11.593,86625,11.226,23.185,1400,1459,21068
2022,5121,16455,19473,282543,249954,3585,18.861,2654,13.963,90118,21036,69082,8.416,36.054,25965,10351,15614,4.141,10.388,64153,25.666,20.776,2049,2077,6772
2022,5122,3264,3496,25900,24686,699,20.400,560,16.343,6350,2055,4295,8.325,25.724,3964,2445,1519,9.905,16.058,2386,9.666,32.116,434,434,1183
2022,5151,3396,6817,217778,215843,304,4.366,596,8.560,21713,3812,17901,1.766,10.060,18004,7886,10118,3.654,8.341,3709,1.718,16.683,186,204,1807
2022,5152,299,726,54010,55457,25,3.362,60,8.070,3330,491,2839,0.885,6.005,6127,598,5529,1.078,11.048,-2797,-5.044,12.009,20,20,162
2022,5173,7479,52396,865703,869579,4657,8.757,6221,11.698,147646,26643,121003,3.064,16.979,156266,41018,115248,4.717,17.970,-8620,-0.991,33.958,989,1347,7524
2022,5174,320,395,8711,8489,74,19.525,42,11.082,1362,598,764,7.045,16.045,939,208,731,2.450,11.062,423,4.983,22.124,28,28,65
2022,5179,2916,4717,66766,62510,932,20.592,550,12.152,14913,8233,6680,13.171,23.857,6700,3583,3117,5.732,10.718,8213,13.139,21.437,355,375,2093
2022,5182,9824,15338,569300,560264,2175,13.995,2581,16.608,118625,36232,82393,6.467,21.173,98998,43189,55809,7.709,17.670,19627,3.503,35.340,1092,1171,14889
2022,5191,9203,11297,333740,324851,1683,15.096,1387,12.441,50415,10454,39961,3.218,15.519,33287,15078,18209,4.642,10.247,17128,5.273,20.494,1034,1052,8887
2022,5211,17,67,21053,20907,4,6.154,0,0.000,513,20,493,0.096,2.454,206,0,206,0.000,0.985,307,1.468,1.971,0,0,0
2022,5221,9161,107477,1926704,1938441,5883,5.395,9016,8.268,295987,94599,201388,4.880,15.269,313092,144912,168180,7.476,16.152,-17105,-0.882,30.539,311,469,5463
2022,5222,12445,43118,687737,691675,3753,8.623,4564,10.486,110102,37838,72264,5.470,15.918,121663,63588,58075,9.193,17.590,-11561,-1.671,31.836,1161,1361,8001
2022,5223,13665,25496,326689,323019,2578,9.961,3347,12.933,65033,15919,49114,4.928,20.133,58287,36411,21876,11.272,18.044,6746,2.088,36.089,1322,1409,5426
2022,5231,8170,26720,367062,361499,3138,11.870,2573,9.732,58018,24396,33622,6.749,16.049,45319,11914,33405,3.296,12.536,12699,3.513,25.073,761,844,4046
2022,5232,24,46,6272,6119,4,8.602,5,10.753,543,10,533,0.163,8.875,251,220,31,3.596,4.102,292,4.772,8.205,3,3,3
2022,5239,51610,73904,618167,597229,8619,11.870,6037,8.314,109017,42224,66793,7.070,18.254,67345,28914,38431,4.841,11.276,41672,6.978,22.552,4401,4457,15582
2022,5241,5552,29596,1546114,1545607,4360,15.023,3214,11.074,215040,73759,141281,4.772,13.913,213652,43309,170343,2.802,13.823,1388,0.090,27.646,372,496,8404
2022,5242,116350,136887,1266133,1233467,13098,9.538,13959,10.165,231287,67568,163719,5.478,18.751,166114,76910,89204,6.235,13.467,65173,5.284,26.934,10028,10254,39625
2022,5259,1443,1495,8983,8361,369,25.922,226,15.876,2366,1146,1220,13.706,28.298,1136,655,481,7.834,13.587,1230,14.711,27.174,192,192,544
2022,5311,87273,121835,600219,589180,13773,11.370,12372,10.213,113208,47012,66196,7.979,19.215,90417,45435,44982,7.712,15.346,22791,3.868,30.693,9365,9509,28057
2022,5312,110233,124757,415483,400590,22415,18.539,14710,12.167,82159,38083,44076,9.507,20.510,52358,28229,24129,7.047,13.070,29801,7.439,26.140,11370,11461,19824
2022,5313,75421,95610,782125,765028,13483,14.308,10730,11.387,137151,58015,79136,7.583,17.928,103265,48183,55082,6.298,13.498,33886,4.429,26.996,7038,7174,28538
2022,5321,3600,15522,166022,154314,1837,12.130,1082,7.145,39586,10189,29397,6.603,25.653,15752,4196,11556,2.719,10.208,23834,15.445,20.416,402,428,1890
2022,5322,6794,13850,110205,104158,1692,12.054,2066,14.718,26108,6208,19900,5.960,25.066,14054,6556,7498,6.294,13.493,12054,11.573,26.986,636,1361,4198
2022,5323,1909,2555,19005,18358,215,8.392,229,8.938,3664,910,2754,4.957,19.959,2345,1029,1316,5.605,12.774,1319,7.185,25.548,132,138,646
2022,5324,7424,14850,195905,186451,1246,8.450,1037,7.033,38936,7531,31405,4.039,20.883,19474,6559,12915,3.518,10.445,19462,10.438,20.889,620,661,4219
2022,5331,2044,2246,40145,38330,362,16.560,242,11.070,7703,2201,5502,5.742,20.097,4108,1459,2649,3.806,10.718,3595,9.379,21.435,186,188,940
2022,5411,149909,163254,1180503,1163022,12747,7.769,14396,8.774,151287,37176,114111,3.197,13.008,115820,39648,76172,3.409,9.959,35467,3.050,19.917,11737,11845,29075
2022,5412,103549,119228,1229896,1200979,12208,10.027,17255,14.172,227521,60698,166823,5.054,18.945,167224,82302,84922,6.853,13.924,60297,5.021,27.848,9840,10078,39113
2022,5413,83159,104637,1627224,1590175,9984,9.550,9805,9.379,240835,69882,170953,4.395,15.145,166662,66705,99957,4.195,10.481,74173,4.664,20.961,6292,6396,26753
2022,5414,29954,30326,128982,123489,5257,17.847,3516,11.937,27559,10725,16834,8.685,22.317,16527,9037,7490,7.318,13.383,11032,8.934,26.767,2869,2878,6767
2022,5415,104535,121633,2123734,2065298,19455,15.925,20528,16.803,464393,118798,345595,5.752,22.486,342905,192414,150491,9.317,16.603,121488,5.882,33.206,13151,13284,59509
2022,5416,155336,165882,1622666,1545486,32489,19.995,25695,15.814,378908,118636,260272,7.676,24.517,226791,115932,110859,7.501,14.674,152117,9.843,29.349,21248,21370,69716
2022,5417,15723,19840,922308,883172,2881,14.735,2306,11.794,162406,40341,122065,4.568,18.389,83774,32222,51552,3.648,9.486,78632,8.903,18.971,1561,1589,12799
2022,5418,29317,32972,465045,448808,4097,12.472,3853,11.729,80051,20602,59449,4.590,17.836,47937,20384,27553,4.542,10.681,32114,7.155,21.362,3090,3107,13511
2022,5419,57083,68141,774683,737009,10724,16.113,7554,11.350,175791,81758,94033,11.093,23.852,102050,52396,49654,7.109,13.847,73741,10.005,27.693,5989,6063,39225
2022,5511,24245,49452,3625698,3547723,3509,7.032,4407,8.831,564228,81883,482345,2.308,15.904,409999,120264,289735,3.390,11.557,154229,4.347,23.113,954,988,13219
2022,5611,28466,32098,564043,544480,4441,13.970,3824,12.029,115243,34756,80487,6.383,21.166,76594,35635,40959,6.545,14.067,38649,7.098,28.135,2815,2892,22802
2022,5612,2013,8704,251350,254925,622,7.120,687,7.864,24732,5550,19182,2.177,9.702,30900,10752,20148,4.218,12.121,-6168,-2.420,19.403,129,140,1787
2022,5613,26224,51638,6455450,6193827,6217,11.886,7553,14.440,1435248,284844,1150404,4.599,23.172,904150,244963,659187,3.955,14.598,531098,8.575,29.195,2551,2687,60194
2022,5614,19835,28280,760937,770256,2687,9.330,3728,12.944,117255,22338,94917,2.900,15.223,135412,51087,84325,6.632,17.580,-18157,-2.357,30.446,2023,2084,15547
2022,5615,9892,13296,169396,172077,2772,21.800,1611,12.670,38722,9107,29615,5.292,22.503,45648,6853,38795,3.983,26.528,-6926,-4.025,45.006,968,1014,3027
2022,5616,18809,24126,975781,970542,2649,10.936,2841,11.729,146279,26606,119673,2.741,15.072,140049,40373,99676,4.160,14.430,6230,0.642,28.860,1783,1825,24848
2022,5617,174666,184008,2104702,2069342,27432,15.113,22432,12.359,376615,111077,265538,5.368,18.200,304878,123865,181013,5.986,14.733,71737,3.467,29.466,18431,18529,93330
2022,5619,15683,17996,304270,284879,2462,13.934,1809,10.238,69051,15122,53929,5.308,24.239,30886,10956,19930,3.846,10.842,38165,13.397,21.684,1387,1408,6343
2022,5621,7818,11795,248756,244704,1121,9.581,931,7.957,35435,9168,26267,3.747,14.481,27387,14888,12499,6.084,11.192,8048,3.289,22.384,625,636,5348
2022,5622,1468,3021,62570,62475,360,12.280,181,6.174,8586,2177,6409,3.485,13.743,8388,1673,6715,2.678,13.426,198,0.317,26.853,96,98,884
2022,5629,9781,11518,166274,160371,1299,11.459,935,8.248,33627,13394,20233,8.352,20.968,21298,7446,13852,4.643,13.280,12329,7.688,26.561,687,696,5120
2022,6111,18841,21597,1114077,1078633,900,4.167,901,4.172,118524,11195,107329,1.038,10.988,47867,13840,34027,1.283,4.438,70657,6.551,8.875,552,562,7527
2022,6112,394,675,49096,49756,27,3.879,69,9.914,4790,328,4462,0.659,9.627,6211,2190,4021,4.402,12.483,-1421,-2.856,19.254,21,34,1305
2022,6113,2390,3994,1751581,1713231,178,4.447,195,4.872,130005,4801,125204,0.280,7.588,53297,6196,47101,0.362,3.111,76708,4.477,6.222,81,92,2165
2022,6114,7576,7968,81750,78900,1303,16.692,979,12.542,16669,4660,12009,5.906,21.127,10932,4382,6550,5.554,13.856,5737,7.271,27.711,754,757,2463
2022,6115,6676,8121,110840,105475,947,11.855,681,8.525,23176,5719,17457,5.422,21.973,12707,4224,8483,4.005,12.047,10469,9.926,24.095,443,455,2362
2022,6116,46858,50455,473780,440200,7435,15.098,5015,10.184,119080,32074,87006,7.286,27.051,52551,22219,30332,5.047,11.938,66529,15.113,23.876,3880,3982,17277
2022,6117,8463,9478,126609,118355,1728,18.824,1132,12.331,32864,8893,23971,7.514,27.767,16481,6473,10008,5.469,13.925,16383,13.842,27.850,909,930,4413
2022,6211,128468,191911,2641008,2608533,17905,9.337,17617,9.187,401252,127771,273481,4.898,15.382,337318,120642,216676,4.625,12.931,63934,2.451,25.863,12172,12636,62941
2022,6212,112860,128160,1030724,1013332,8666,6.745,9307,7.244,164739,53847,110892,5.314,16.257,130279,54446,75833,5.373,12.856,34460,3.401,25.713,7734,7960,46589
2022,6213,144141,173889,1140941,1099618,22085,13.018,13607,8.021,221174,77170,144004,7.018,20.114,137648,52355,85293,4.761,12.518,83526,7.596,25.036,9999,10452,36836
2022,6214,25452,56347,1304573,1277462,5164,9.339,3062,5.537,186145,59457,126688,4.654,14.571,131033,43972,87061,3.442,10.257,55112,4.314,20.515,1437,1604,20179
2022,6215,8078,18810,340786,330623,1383,7.391,1188,6.349,57999,16098,41901,4.869,17.542,38000,11224,26776,3.395,11.493,19999,6.049,22.987,607,676,6331
2022,6216,24774,35582,1568808,1570226,4587,13.082,3549,10.122,224670,60672,163998,3.864,14.308,226060,72562,153498,4.621,14.397,-1390,-0.089,28.616,2474,2528,32763
2022,6219,10225,15389,366017,362301,1643,10.900,1011,6.707,60343,21260,39083,5.868,16.655,52802,16725,36077,4.616,14.574,7541,2.081,29.148,610,620,9106
2022,6221,2475,5903,5640322,5609230,291,4.995,137,2.352,289116,47783,241333,0.852,5.154,225563,36732,188831,0.655,4.021,63553,1.133,8.043,40,40,14821
2022,6222,409,792,244801,246143,28,3.553,20,2.538,15281,1729,13552,0.702,6.208,18089,1739,16350,0.707,7.349,-2808,-1.141,12.416,9,9,848
2022,6223,317,848,259452,258897,60,7.220,26,3.129,15352,2658,12694,1.027,5.930,14172,2497,11675,0.964,5.474,1180,0.456,10.948,4,4,165
2022,6231,9499,16883,1377500,1404916,1197,7.114,1084,6.442,139525,62963,76562,4.482,9.931,194390,59690,134700,4.249,13.836,-54865,-3.905,19.862,658,701,37082
2022,6232,10875,43429,746361,752240,1590,3.618,2633,5.991,94333,20126,74207,2.675,12.540,105564,27386,78178,3.641,14.033,-11231,-1.493,25.081,598,822,8195
2022,6233,16978,25326,938053,944015,2088,8.228,2188,8.622,111396,41269,70127,4.372,11.800,123616,34550,89066,3.660,13.095,-12220,-1.294,23.600,1636,1709,21521
2022,6239,3265,5497,123098,123453,403,7.086,783,13.768,19564,4570,14994,3.702,15.847,19846,6467,13379,5.238,16.076,-282,-0.228,31.695,257,272,2497
2022,6241,63608,83902,2000376,1955507,9885,11.969,7254,8.784,336319,95556,240763,4.887,17.199,245028,76299,168729,3.902,12.530,91291,4.668,25.060,4823,4903,32399
2022,6242,11110,15346,233847,228414,985,6.442,874,5.716,36822,6133,30689,2.685,16.121,25903,6287,19616,2.752,11.340,10919,4.780,22.681,409,427,2608
2022,6243,3703,6800,217820,216777,345,5.013,509,7.396,31791,3966,27825,1.830,14.665,29839,7409,22430,3.418,13.765,1952,0.900,27.530,150,161,1347
2022,6244,57121,73723,965332,922473,8236,11.349,5935,8.178,186007,51100,134907,5.539,20.164,100311,39564,60747,4.289,10.874,85696,9.290,21.748,4439,4549,29543
2022,7111,8023,8134,116941,91064,1789,23.530,727,9.562,57729,10140,47589,11.135,63.394,6041,2124,3917,2.332,6.634,51688,56.760,13.268,556,557,1616
2022,7112,3812,4027,127426,114369,674,17.179,467,11.903,33017,3667,29350,3.206,28.869,6763,1897,4866,1.659,5.913,26254,22.956,11.827,367,371,1487
2022,7113,6993,7677,173487,138656,1508,20.836,629,8.691,79912,9606,70306,6.928,57.633,10247,4187,6060,3.020,7.390,69665,50.243,14.781,506,507,2651
2022,7114,3603,3755,24571,22452,854,23.962,472,13.244,7121,2485,4636,11.068,31.717,3033,2023,1010,9.010,13.509,4088,18.208,27.018,398,401,1066
2022,7115,22127,22169,61766,56315,5806,27.413,3828,18.074,23238,11427,11811,20.291,41.264,12274,6962,5312,12.363,21.795,10964,19.469,43.591,3116,3120,5729
2022,7121,7083,7558,142925,131766,569,7.655,320,4.305,27812,3192,24620,2.422,21.107,5508,1971,3537,1.496,4.180,22304,16.927,8.360,238,238,1380
2022,7131,2886,3486,198256,174237,692,20.875,350,10.558,57726,7725,50001,4.434,33.131,10183,2610,7573,1.498,5.844,47543,27.286,11.689,290,296,1949
2022,7132,1975,3204,130315,123319,323,10.259,212,6.733,19985,3278,16707,2.658,16.206,6181,1463,4718,1.186,5.012,13804,11.194,10.024,121,130,796
2022,7139,58309,68780,1310669,1206632,9032,13.385,6425,9.522,317920,71281,246639,5.907,26.348,111559,46022,65537,3.814,9.245,206361,17.102,18.491,5032,5101,34857
2022,7211,44335,56066,1709162,1578400,5594,9.992,5433,9.704,397137,81923,315214,5.190,25.161,137643,66226,71417,4.196,8.720,259494,16.440,17.441,3787,3947,38431
2022,7212,5813,6509,48862,46082,797,12.378,657,10.203,11946,2869,9077,6.226,25.923,6367,3030,3337,6.575,13.817,5579,12.107,27.633,492,500,2515
2022,7213,1350,1530,9461,8771,139,9.049,151,9.831,2648,913,1735,10.409,30.190,1271,494,777,5.632,14.491,1377,15.699,28.982,115,115,382
2022,7223,20648,46739,729119,676332,7820,17.355,4459,9.896,155225,46353,108872,6.854,22.951,49416,30385,19031,4.493,7.306,105809,15.645,14.613,2873,2880,13042
2022,7224,35482,36609,399322,342428,6685,19.338,2607,7.541,146854,57095,89759,16.674,42.886,32826,14336,18490,4.187,9.586,114028,33.300,19.172,2180,2184,11657
2022,7225,399175,552054,10850604,10302152,62379,11.477,45267,8.329,2367912,814574,1553338,7.907,22.985,1260732,463078,797654,4.495,12.238,1107180,10.747,24.475,33017,34804,308980
2022,8111,135205,153491,956858,933672,16364,10.742,14055,9.226,176203,68999,107204,7.390,18.872,129730,60267,69463,6.455,13.895,46473,4.977,27.789,11294,11608,48520
2022,8112,9115,10425,105591,105177,1014,9.644,1193,11.346,12705,3945,8760,3.751,12.080,11970,5571,6399,5.297,11.381,735,0.699,22.762,927,940,3616
2022,8113,18328,20270,209037,205135,1946,9.645,1757,8.709,35198,9783,25415,4.769,17.158,27291,10486,16805,5.112,13.304,7907,3.855,26.608,1313,1326,4745
2022,8114,18499,19105,77084,75861,2910,15.521,2198,11.723,16132,6811,9321,8.978,21.265,13471,7896,5575,10.409,17.758,2661,3.508,35.515,1722,1732,3930
2022,8121,120679,135752,741802,712645,23160,17.606,14744,11.208,175512,75007,100505,10.525,24.628,117595,58344,59251,8.187,16.501,57917,8.127,33.002,11828,12108,45149
2022,8122,13339,19498,142917,137977,775,3.944,1077,5.481,25698,3173,22525,2.300,18.625,15678,4975,10703,3.606,11.363,10020,7.262,22.726,677,729,3443
2022,8123,22694,27625,246795,238999,2885,10.479,2700,9.807,40317,9827,30490,4.112,16.869,24884,10030,14854,4.197,10.412,15433,6.457,20.824,2060,2153,7800
2022,8129,40137,49871,360768,327834,10157,21.196,6255,13.053,112569,36787,75782,11.221,34.337,46003,25430,20573,7.757,14.032,66566,20.305,28.065,4119,4161,14311
2022,8131,176375,177340,1536784,1511346,8982,5.064,9065,5.110,172901,26885,146016,1.779,11.440,122404,28773,93631,1.904,8.099,50497,3.341,16.198,7127,7128,21038
2022,8132,18543,20300,207681,200689,1799,8.951,1394,6.936,31704,6367,25337,3.173,15.798,17366,5614,11752,2.797,8.653,14338,7.144,17.306,991,996,3146
2022,8133,16328,18652,203640,193903,1952,10.669,1240,6.777,35769,8123,27646,4.189,18.447,16582,5721,10861,2.950,8.552,19187,9.895,17.103,776,781,2807
2022,8134,21254,22797,203759,186519,2366,10.607,1382,6.196,51161,10958,40203,5.875,27.429,16734,5562,11172,2.982,8.972,34427,18.458,17.944,991,1000,3504
2022,8139,49551,51633,470514,460692,2872,5.550,3109,6.008,60373,12317,48056,2.674,13.105,40739,12701,28038,2.757,8.843,19634,4.262,17.686,2416,2437,9376
